//MAP CONVERTED BY dmm2tgm.py THIS HEADER COMMENT PREVENTS RECONVERSION, DO NOT REMOVE
"a" = (
/turf/open/floor/holofloor/plating,
/area/centcom/tdome/arena/actual)
"l" = (
/obj/effect/turf_decal/tile/red/half/contrasted{
	dir = 8
	},
/turf/open/floor/holofloor/plating,
/area/centcom/tdome/arena/actual)
"D" = (
/obj/effect/turf_decal/tile/green/half/contrasted{
	dir = 4
	},
/turf/open/floor/holofloor/plating,
/area/centcom/tdome/arena/actual)
"I" = (
/obj/effect/turf_decal/loading_area{
	dir = 8
	},
/turf/open/floor/holofloor/plating,
/area/centcom/tdome/arena/actual)
"L" = (
/obj/effect/turf_decal/delivery,
/turf/open/floor/holofloor/plating,
/area/centcom/tdome/arena/actual)
"M" = (
/obj/machinery/camera/motion/thunderdome{
	pixel_x = 10
	},
/turf/open/floor/holofloor/plating,
/area/centcom/tdome/arena/actual)
"R" = (
/obj/effect/turf_decal/loading_area{
	dir = 4
	},
/turf/open/floor/holofloor/plating,
/area/centcom/tdome/arena/actual)

(1,1,1) = {"
L
R
R
l
l
R
R
l
l
a
"}
(2,1,1) = {"
a
a
a
a
a
a
a
a
a
a
"}
(3,1,1) = {"
a
a
a
a
a
a
a
a
a
a
"}
(4,1,1) = {"
a
a
a
a
a
a
a
a
a
a
"}
(5,1,1) = {"
a
a
a
a
a
a
a
a
a
a
"}
(6,1,1) = {"
a
a
a
a
a
a
a
a
a
a
"}
(7,1,1) = {"
a
a
a
a
a
a
a
a
a
a
"}
(8,1,1) = {"
a
a
a
a
a
a
a
a
a
a
"}
(9,1,1) = {"
a
a
a
a
a
M
a
a
a
a
"}
(10,1,1) = {"
a
a
a
a
a
a
a
a
a
a
"}
(11,1,1) = {"
a
a
a
a
a
a
a
a
a
a
"}
(12,1,1) = {"
a
a
a
a
a
a
a
a
a
a
"}
(13,1,1) = {"
a
a
a
a
a
a
a
a
a
a
"}
(14,1,1) = {"
a
a
a
a
a
a
a
a
a
a
"}
(15,1,1) = {"
a
a
a
a
a
a
a
a
a
a
"}
(16,1,1) = {"
a
a
a
a
a
a
a
a
a
a
"}
(17,1,1) = {"
L
I
I
D
D
I
I
D
D
L
"}
