"a" = (/turf/closed/mineral/volcanic/lava_land_surface/hardened,/area/template_noop)
"d" = (/obj/structure/flora/ash/stem_shroom,/turf/open/misc/asteroid/basalt/lava_land_surface,/area/template_noop)
"e" = (/obj/structure/stone_tile/block/cracked{dir = 4},/turf/open/lava/smooth/lava_land_surface,/area/template_noop)
"f" = (/obj/structure/stone_tile/block/cracked{dir = 10},/turf/open/lava/smooth/lava_land_surface,/area/template_noop)
"g" = (/obj/structure/stone_tile/block/cracked{dir = 1},/turf/open/lava/smooth/lava_land_surface,/area/template_noop)
"h" = (/turf/open/lava/smooth/lava_land_surface,/area/template_noop)
"i" = (/obj/structure/flora/ash/cacti,/turf/open/misc/asteroid/basalt/lava_land_surface,/area/template_noop)
"k" = (/obj/structure/flora/ash/leaf_shroom,/turf/open/misc/asteroid/basalt/lava_land_surface,/area/template_noop)
"q" = (/obj/structure/stone_tile/surrounding_tile/cracked{dir = 1},/turf/open/lava/smooth/lava_land_surface,/area/template_noop)
"r" = (/turf/open/misc/asteroid/basalt/lava_land_surface,/area/template_noop)
"z" = (/obj/structure/stone_tile/slab,/turf/open/lava/smooth/lava_land_surface,/area/template_noop)
"A" = (/obj/structure/stone_tile/surrounding/cracked{dir = 1},/obj/structure/stone_tile/center/cracked,/obj/structure/stone_tile/surrounding_tile{dir = 4},/turf/open/lava/smooth/lava_land_surface,/area/template_noop)
"F" = (/obj/structure/stone_tile/block/burnt{dir = 1},/turf/open/lava/smooth/lava_land_surface,/area/template_noop)
"H" = (/obj/structure/stone_tile/slab/burnt,/turf/open/lava/smooth/lava_land_surface,/area/template_noop)
"I" = (/obj/structure/flora/rock/pile,/turf/open/misc/asteroid/basalt/lava_land_surface,/area/template_noop)
"L" = (/obj/structure/stone_tile/block/cracked{dir = 6},/turf/open/lava/smooth/lava_land_surface,/area/template_noop)
"M" = (/obj/structure/flora/rock,/turf/open/misc/asteroid/basalt/lava_land_surface,/area/template_noop)
"O" = (/obj/structure/stone_tile/surrounding/cracked,/obj/structure/stone_tile/surrounding_tile,/turf/open/lava/smooth/lava_land_surface,/area/template_noop)
"P" = (/obj/structure/stone_tile/slab/cracked,/turf/open/lava/smooth/lava_land_surface,/area/template_noop)
"Q" = (/obj/structure/flora/ash/leaf_shroom,/obj/modular_map_connector,/turf/open/misc/asteroid/basalt/lava_land_surface,/area/template_noop)
"R" = (/obj/effect/decal/cleanable/ash,/turf/open/misc/asteroid/basalt/lava_land_surface,/area/template_noop)
"T" = (/obj/effect/step_trigger/teleport_fancy{entersmoke = 1; entersparks = 1; locationx = 78; locationy = 113; uses = 0},/obj/structure/fluff{desc = "You're not sure if walking into this is a great idea..."; icon = 'icons/effects/eldritch.dmi'; icon_state = "pierced_illusion"; name = "fluxating rift"},/turf/open/misc/asteroid/basalt/lava_land_surface,/area/template_noop)
"W" = (/obj/structure/stone_tile/surrounding_tile/cracked{dir = 6},/turf/open/lava/smooth/lava_land_surface,/area/template_noop)
"Y" = (/obj/structure/stone_tile/block/burnt,/turf/open/lava/smooth/lava_land_surface,/area/template_noop)

(1,1,1) = {"
rraaaaarrraaaaaaaaaaaaaaa
raaaaaaaarraaahaaaaaaaIIM
aaaaaIIkaaaaahhaaarrrrrrQ
aaaRIMrrraaaahhrrrrhrrarr
aarrrTRrraghhhhFrrhhhraaa
aairrrrrrzzAqWOPHehhhaaaa
aaaiRrMhfYLhhhhhhhrhhaaaa
raaaahhhhhhhhhhhrrrhrrkra
rraaaarrhhrhhhhhaIrhrrMIa
rrraaaararrahhhaaIMrrrrMa
rrrraaaaaaaahhaaaaaddrrra
rrrrraaaaaaaahaaaaaaddrra
"}
