"c" = (/mob/living/simple_animal/hostile/asteroid/goliath/beast,/turf/open/misc/asteroid/basalt/lava_land_surface,/area/template_noop)
"d" = (/obj/structure/flora/ash/stem_shroom,/turf/open/misc/asteroid/basalt/lava_land_surface,/area/template_noop)
"g" = (/obj/structure/flora/rock/pile,/obj/effect/decal/cleanable/blood/old,/turf/open/misc/asteroid/basalt/lava_land_surface,/area/template_noop)
"h" = (/obj/modular_map_root/caves{key = "caves_lvl3segment2"; name = "lvl3segment2"},/turf/template_noop,/area/template_noop)
"i" = (/obj/structure/flora/ash/cap_shroom,/turf/open/misc/asteroid/basalt/lava_land_surface,/area/template_noop)
"n" = (/turf/open/indestructible/necropolis,/area/template_noop)
"o" = (/mob/living/simple_animal/hostile/asteroid/goliath/beast/ancient,/turf/open/misc/asteroid/basalt/lava_land_surface,/area/template_noop)
"p" = (/obj/effect/decal/remains/human,/turf/open/indestructible/necropolis,/area/template_noop)
"q" = (/obj/item/pickaxe/diamond,/obj/effect/decal/cleanable/blood/old,/turf/open/misc/asteroid/basalt/lava_land_surface,/area/template_noop)
"t" = (/obj/modular_map_connector,/turf/open/misc/asteroid/basalt/lava_land_surface,/area/template_noop)
"v" = (/obj/structure/flora/ash/cacti,/turf/open/misc/asteroid/basalt/lava_land_surface,/area/template_noop)
"w" = (/obj/item/food/grown/banana{desc = "shh... its a secret. 3 of 6."; name = "secret banana"},/turf/open/misc/asteroid/basalt/lava_land_surface,/area/template_noop)
"A" = (/turf/closed/mineral/random/volcanic/lava_land_surface/hardened/labormineral,/area/template_noop)
"B" = (/turf/closed/mineral/volcanic/lava_land_surface/hardened,/area/template_noop)
"D" = (/obj/effect/decal/cleanable/blood/old,/turf/open/misc/asteroid/basalt/lava_land_surface,/area/template_noop)
"E" = (/obj/effect/baseturf_helper/lava_land/surface,/turf/closed/indestructible/rock,/area/template_noop)
"F" = (/obj/structure/flora/ash/tall_shroom,/turf/open/misc/asteroid/basalt/lava_land_surface,/area/template_noop)
"H" = (/obj/structure/flora/ash/seraka,/turf/open/misc/asteroid/basalt/lava_land_surface,/area/template_noop)
"I" = (/obj/effect/decal/cleanable/blood/old,/turf/open/indestructible/necropolis,/area/template_noop)
"J" = (/turf/open/chasm/lavaland,/area/template_noop)
"K" = (/turf/closed/indestructible/rock,/area/template_noop)
"L" = (/turf/closed/mineral/random/volcanic/lava_land_surface/hardened/high_chance,/area/template_noop)
"M" = (/turf/template_noop,/area/template_noop)
"N" = (/turf/open/misc/asteroid/basalt/lava_land_surface,/area/template_noop)
"Q" = (/obj/effect/mob_spawn/corpse/goliath{mob_type = /mob/living/simple_animal/hostile/asteroid/basilisk/watcher; name = "watcher"},/obj/effect/decal/cleanable/blood/old,/turf/open/misc/asteroid/basalt/lava_land_surface,/area/template_noop)
"R" = (/obj/structure/flora/rock,/turf/open/misc/asteroid/basalt/lava_land_surface,/area/template_noop)
"S" = (/turf/open/lava/smooth/lava_land_surface,/area/template_noop)
"V" = (/obj/structure/flora/rock/pile,/turf/open/misc/asteroid/basalt/lava_land_surface,/area/template_noop)
"W" = (/obj/structure/flora/ash/leaf_shroom,/turf/open/misc/asteroid/basalt/lava_land_surface,/area/template_noop)
"X" = (/obj/effect/mob_spawn/corpse/human/miner/explorer/caves{brute_damage = 0; burn_damage = 200; facial_hairstyle = "Moustache (Watson)"; hairstyle = "Pompadour"; mob_name = "Jim Joffee"},/obj/effect/decal/cleanable/blood/old,/obj/item/gun/energy/recharge/kinetic_accelerator,/turf/open/indestructible/necropolis,/area/template_noop)
"Y" = (/turf/closed/indestructible/necropolis,/area/template_noop)
"Z" = (/obj/structure/spawner/lavaland/icewatcher,/turf/open/indestructible/necropolis,/area/template_noop)

(1,1,1) = {"
EKKKKKKKKKKKKKKKKKKKKKKKKKKKKKKKKKKKKKKKKKKBBBBBBBBBBBBBBBBBBBBBKKMMMMMMMMMMMMMMMMMMMMMMMMMMMMMMMMMMMMMMMMMMMMMMMMMMMMMMMM
KBBBBBBBBBBBBBBBBBBBBBBBAAAAAAAAAAAAAAAAAABBBBAAAAABBBBBAAAAAAAABKMMMMMMMMMMMMMMMMMMMMMMMMMMMMMMMMMMMMMMMMMMMMMMMMMMMMMMMM
KBMMMMMMMMMMMMMMMMMMMBAAAAAAAAAAAAAAAAAAAABJJBBBBBJJJJBBBBBBBAAABKMMMMMMMMMMMMMMMMMMMMMMMMMMMMMMMMMMMMMMMMMMMMMMMMMMMMMMMM
KBMMMMMMMMMMMMMMMMMMMBAAAAAAAAAABBBBBBJJJJJJJJJJJJJJJJJJJJJJBAAABKMMMMMMMMMMMMMMMMMMMMMMMMMMMMMMMMMMMMMMMMMMMMMMMMMMMMMMMM
KBMMMMMMMMMMMMMMMMMMMBBBBAAAAAAABBJJJJJJJJJJJJJJJJJJJJJJJBBBBAAABKMMMMMMMMMMMMMMMMMMMMMMMMMMMMMMMMMMMMMMMMMMMMMMMMMMMMMMMM
KBMMMMMMMMMMMMMMMMMMMBBBBAAAAAAABJJJJJJJJJJJJJJJJJJJJJJJBBBBBAAABKMMMMMMMMMMMMMMMMMMMMMMMMMMMMMMMMMMMMMMMMMMMMMMMMMMMMMMMM
KBMMMMMMMMMMMMMMMMMMMMMMBAAAABBJJJJJJJJJJJJJJJJJJBBBBBBBBBBBBAAAAKMMMMMMMMMMMMMMMMMMMMMMMMMMMMMMMMMMMMMMMMMMMMMMMMMMMMMMMM
KBMMMMMMMMMMMMMMMMMMMMMMBAAAABBJJJJJJJJJJJJJJBBBBBBBBSSSSSSSBBBAAKMMMMMMMMMMMMMMMMMMMMMMMMMMMMMMMMMMMMMMMMMMMMMMMMMMMMMMMM
KBMMMMMMMMMMMMMMMMMMMMMMBAAAABBJJJJJJJJJJJJJJBBBBBBSSSSSSSSSSBBBAKMMMMMMMMMMMMMMMMMMMMMMMMMMMMMMMMMMMMMMMMMMMMMMMMMMMMMMMM
KBMMMMMMMMMMMMMMMMMMMMMMBAAAABJJJJJJJJJJJJJNNNFNBSSSSSSSSSSSSSBBAKMMMMMMMMMMMMMMMMMMMMMMMMMMMMMMMMMMMMMMMMMMMMMMMMMMMMMMMM
KBMMMMMMMMMMMMMMMMMMMMMMBAAAABJJJJJJJJJJJJNNVNNNNNNNNNNNSSSSSSSBAKMMMMMMMMMMMMMMMMMMMMMMMMMMMMMMMMMMMMMMMMMMMMMMMMMMMMMMMM
KBMMMMMMMMMMMMMMMMMMMMMMBAAAABJJJJJJJJJJJJNFNNNNNNNNNFFNNNSSSSSBAKMMMMMMMMMMMMMMMMMMMMMMMMMMMMMMMMMMMMMMMMMMMMMMMMMMMMMMMM
KBMMMMMMMMMMMMMMMMMMMMMMBAAAAJJJJJJJJJJJJJNNNoNNBBBNNNNNNNNVSSBBAKMMMMMMMMMMMMMMMMMMMMMMMMMMMMMMMMMMMMMMMMMMMMMMMMMMMMMMMM
KBMMMMMMMMMMMMMMMMMMMMMMBAAAAJJJJJJJJJJJJJNNNNNNBBBNNNNNNNVRVSBBAKMMMMMMMMMMMMMMMMMMMMMMMMMMMMMMMMMMMMMMMMMMMMMMMMMMMMMMMM
KBMMMMMMMMMMMMMMMMMMMMMMBAAAABJJJJJJJJJJJFNNNFFBBBBBBNNNNNNVVBBBAKMMMMMMMMMMMMMMMMMMMMMMMMMMMMMMMMMMMMMMMMMMMMMMMMMMMMMMMM
KBMMMMMMMMMMMMMMMMMMMMMMBAAAABBJJJJJJJJJJFNNVBBAAAAAAVVNNNNNVNBBAKMMMMMMMMMMMMMMMMMMMMMMMMMMMMMMMMMMMMMMMMMMMMMMMMMMMMMMMM
KBMMMMMMMMMMMMMMMMMMMMMMBAAABBBBBBBBJJJJJNoNBBAAAAAAABBVFNNNNNBBAKMMMMMMMMMMMMMMMMMMMMMMMMMMMMMMMMMMMMMMMMMMMMMMMMMMMMMMMM
KBMMMMMMMMMMMMMMMMMMMMMMBAAABBBJJJJJJJJJJNNNBBAANNAAABBRVFNNNNBBAKMMMMMMMMMMMMMMMMMMMMMMMMMMMMMMMMMMMMMMMMMMMMMMMMMMMMMMMM
KBMMMMMMMMMMMMMMMMMMMMMMBAAAJJJJJJJJJJJJJNNNBABNNNAAAABRVFNNNNBBAKMMMMMMMMMMMMMMMMMMMMMMMMMMMMMMMMMMMMMMMMMMMMMMMMMMMMMMMM
KBMMMMMMMMMMMMMMMMMMMBBBBAAAJJJJJJJJJJJJJNNBBABNFNNNAABBBNNNNNBBAKMMMMMMMMMMMMMMMMMMMMMMMMMMMMMMMMMMMMMMMMMMMMMMMMMMMMMMMM
KBMMMMMMMMMMMMMMMMMMMBAABBAJJJJJJJJJJJJJJNNNBABNNNNFBBBBBBNNNNNBBKMMMMMMMMMMMMMMMMMMMMMMMMMMMMMMMMMMMMMMMMMMMMMMMMMMMMMMMM
KBMMMMMMMMMMMMMMMMMMMBAABBBJJJJJJJJJJJJJJNNNBAABFNNNNNBBBBNNNNFBBKMMMMMMMMMMMMMMMMMMMMMMMMMMMMMMMMMMMMMMMMMMMMMMMMMMMMMMMM
KBMMMMMMMMMMMMMMMMMMMBAAABJJJJJJJJJJJJJJJNNNBAABBNFNNNBBBBNNNNFFFBBBBBBBBBBBBBBBBBBBBBBBBBBBBBBBBBBBBBBBBBBBBBBBBBBBBBBBBB
KBMMMMMMMMMMMMMMMMMMMBAAABBBBBJJJJJJJJJJJNNNBAABBNNNNNNNBBBNNNFNNBBBBBAABBBNNVVNNNBBBYYBBBAAAAAAAAAAAAAAAAAAABBBBBBBBBBBBB
KBMMMMMMMMMMMMMMMMMMMBAAABBBBBBBJJJJJJJJJNNNBBAANFNBBNNNBBBNNNNNVVRVBBAABNNNNNNNNNNNNYnYYYBBBBBAAAAAAAAAAAAAABBJBBBLLLLLLB
KBMMMMMMMMMMMMMMMMMMMBBBABJJJJJJJJJJJJJJJJNNJJAABBNBBBBNNNNNNNNNNNVNBBAANNNNNBBBNNnnnNnNYYYYBBBBBBBBBBBBBAAAABBJBBBLLLLLLB
KBMMMMMMMMMMMMMMMMMMMBBBJJJJJJJJJJJJJJJJJJNNJJBBBFNFBBBBBBBNNNNNNNNNNBBBNNNNBBBBBYNnZnnpnNNYYNNNNNNNNNNNBAAAABJJBBBLLLLLLB
KBMMMMMMMMMMMMMMMMMMMAAJJJJJJJJJJJJJJJJJJJNNJJJJBNFNBJJJJJJJNNNNNNNNNNBBNNNBBBYYYYYnnnnnnnnnnnNNNNNNNNNNNBABBJJJJBBLLLLLLB
KBMMMMMMMMMMMMMMMMMMMBBJJJJJJJJJJJJJJJJJJJNNJJJJBBBBBJJJJJJJVNNNNNNNNNBNNNNDQNXInnnpnnYnZnnnNNNNNNNNNNNNNNBJJJJJJJBLLLLLLB
KBMMMMMMMMMMMMMMMMMMMBBBBBBJJJJJJJJJJJJJJJNNJJJJJJBBJJJJJJJJJJJJNVVNNNNNNNDQDNqNQDNNnYYnnNNNVVBBBBBNNNNNNNNJJJJJJJBLLLLLLB
KBMMMMMMMMMMMMMMMMMMMBBBBJJJJJJJJJJJJJJJJNNNNJJJJJBBJJJJJJJJJJJJJJJJNNNNNNNgNBBDDNVNNnnnNNNVRVBBBBBBBBBNNNvJJJJJJJBLLLLLLB
KBMMMMMMMMMMMMMMMMMMMBBBBBJJJJJJJVJJJJJJJNNNNJJJJJBJJJJJBJJJJJJJJJJJJJJJNNNBBBBBBBJJJJJJJJNVBBBAAABBJJJNNNNJJJJJJJBLLLLLLB
KBMMMMMMMMMMMMMMMMMMMBJJJJJJJJJJJVBJJJJJJNNNNJJJJJJJJJJJBJJJJJJJJJJJJJJJJJJBBAABBJJJJJJJJJNNBBBAAABBJJJvNNNJJJJJJJJJBLLLBB
KBMMMMMMMMMMMMMMMMMMMBJJJJJJJJJBBwBBJJJJJNNNNJJJJJJBBBBBBBJJJJJJJJJJJJJJJJJJBAABJJJJJJJJJJJJJJBAAABJJJJNNNvJJJJJBBBBBLLLBB
BBBBBNNNtNNNBBBBBBBBBBJJJJJJJJJJJBBJJJJJJNNNNJJJJJJJJJJBBBBBBJJJJJJJJJJJJJJJBBBJJJJJJJJJJJJJJJBAAABJJJJJNNJJJJBBBLLLLLLLLB
BBBBBBVNNNNVNBBAAAAABJJJJJJJJJJJJJJJJJNNNNVNNJJJJJJJJJJJBJJJJJJJNNNNNJJJJJJJJBBJJJJJJJJJJJJJJJBBBBBJJJJJNNJJJJJJBBBBBBBLLB
BBAABBVVNNNNNNBAAAAABJJJJJJJJJJJJJJJJJNcNNVNNNNNNVJJJJJJBJJJJNWNNVVVVVNNJJJJJBJJJJJJJJJJJJJJJJJJBBJJJJJNNNVJJJJJJJJJJBBLLB
BBAABBBNNNNNVVBBBBBBBJJJJJJJJJJJJJJJJJNNVLNNNNNNNNNVNJJJJJNVNNNNWWVVVRNNNNNJJBJJJJJJJJJJJJJJJJJJBBJJJJJNNNVJJJJJJJJJJJBBBB
BBAABiiNNNNNNNBBBvVNNNNNJJJJJJJJJJJJNNNNLLLicNJJJJJJJJJJJJJJJJNNNNWWNVVVNNNNNNJJJJJJJJJJJJJJJJJJBJJJJJJvNVVJJJJJJJJJJJJBBB
BAAAABiNNNNNNNNBNNVRVNNNNNNJJJJJJJJJNNNLLLiiNNJJJJJJJJJJJJJJJJJJNNNNNJJJJJJJJJJJJJJJJJJJJJJJJJJJJJJJJJJNNVRJJJJJJJJJJJJBBB
BAAAABNNNNNNNNNBvNvVVNNNNNNNNNNNNNNNVcNNLiiVNNNNJJJJJJJJJJJJJJJJJJJJJJJJJJJJJJJJJJJJJJJJJJJJJJJJJJJJJJJNNvVJJJJJJJJJBBBBBB
BAAAABNVVNVNNNNNNNvVVNNNNNNVNNNNNNNNNNNNNNNcNNNNNNNJJJJJJJJJJJJJJJJJJJJJJJJJJJJJJJJJJJJJJJJJJJJJJJJJJJJNNNNJJJJJJBBBBLLLBB
BAAAABBVVNNNNNNNNNNVNNNNNNNNNNNNNNNNNNNNNNNNNNNNNNNJJJJJJJJJJJJJJJJJJJJJJJJJJJJJJJJJJJJJJJJJJJJJJJJJJJNNNNJJJJJJBBBBBLLLBB
BAAAAABRVVNNNNNNNNNNNNNNNNNNNNNVNNNNNNNJJJJNNNNNNNNNNNNNJJJJJJJJJJJJJJJJJJJJJJJJJBJJJJJJJJJJJJJJJJJJJJNNNNJJJJJJJJJJBBBBBB
BAAAAABBRVNNNNNNNNNNNNNNNNNNNNNNNNJJJJJJJJJJJJJNNNNNNNNNNHHHHJJJJJJJJJJJJJJJJJJJJBJJJJJJJJJJJJJJJJJJJJNNNJJJJJJJJJJJJJJLLB
BAAAAABBBVvNNNNNNVVVVVNNNNNJJJJJJJJJJJJJJJJBJJJJJJJNNNNHNVVVHJJJJJJJJJJJJJJJJJJJJBJJJJJJJJJJJJJJJJJJJJNNNJJJJJJJJJJJJJJLLB
BAAAAAAABJJJJJvvVVVVVNNNJJJJJJJJJJJJJJJJJJJBJJJJJJJJNNNNNHVHNNNJJJJJJJJJJJJJJJJJJBJJJJJJJJJJJJJJJJJJJJNNNJJJJJJJJJJJJBBLLB
BAAAAAAABBJJJJJJJJJJJJJJJJJJJJBJJJJJJJJJJJBBBJJJJJJJVVNNNNNNNNNNNJJJJJJJJJJJJJJBBBBBJJJJJJJJJJJJJJJJNNNNJJJJJJJJJJJJNNBLLB
BAAAAAAAAABBBBJJJJJJJJJJJJJJJBBBJJJJJJJJJBBBBBJJJJJJJJJJJJNNNNNNNNNNJJJJJJJJJJJBAAABJJJJJJJJJJJJJJJJNNNNJJJJJJJJJJJJNNBLLB
BAAAAAAAAAAABBJJJJJJJJJJJJJJJBBBJJJJJJJJJJJBJJJJJJJJJJJJJNNNNNNNNNNNNNNJJJJJJJJBAAABJJJJJJJJJJJJJJJJNNNNJJJJJJJJJJJJNNBLLB
BAAAAAAAAAAABBBBBJJJJJJJJJJBBAABBBJJJJJJJJJJJJJJJJJJJJVRVNNNNNNNNNNNNNNNNNNNNBBBAAABBBBBJJJJJJJJJJJNNNNNJJJJJJJJJNVVVNBLLB
BAAAAAAAAAAAAAAABBBBBBBJJJJBBAABBBJJJJJJJJJJJJJJJJJJJNVVVVNNNNNNNNNNNNVVVNNNNBAAAAAAAAAAJJJJJJJJJNNNNNNNNJJJJJJJJNVRVBBLLB
BAAAAAAAAAAAAAAABBBBBBBBBBBBBAAAABBBBBBBddNNNdNNNNNNNNNNNNNNNVVNNNNNNVRBBBBBBBAAAAAAAAAABNNNVRVVNNNNNNNNNNNWNWNNNNNNNBBLLB
BAAAAAAAAAAAAAAAAAAAAAAAAAAAAAAAAAAAAAABBBBBBBBdNNNNNNNNNNNVVRBBAAAAAAAAAAAAAAAAAAAAAAAABBWNNVVNNNNNNNNNNWNNNWNNNNBBBBBLLB
BAAAAAAAAAAAAAAAAAAAAAAAAAAAAAAAAAAAAAABBBBBBBBBBBBBBBBBBBBBBBBAAAAAAAAAAAAAAAAAAAAAAAABBBBBBBBNNNNNNNNBBLLLLLLLLLLLLLLLLB
BBBBBBBBBBBBBBBBBBBBBBBBBBBBBBBBBBBBBBBBBBBBBBBBBBBBBBBBBBBBBBBBBBBBBBBBBBBBBBBBBBBBBBBBBBBBBBBBNNNNNBBBBLLLLLLLLLLLLLLBBB
MMMMMMMMMMMMMMMMMMMMMMMMMMMMMMMMMMMMMMMMMMMMMMMMMMMMMMMMMMMMMMMMMMMMMMMMMMMMMMMMMMMMMMMMMMMMMMMMMMhMMMMMMMMMMMMMMMMMMMMMMM
"}
