//MAP CONVERTED BY dmm2tgm.py THIS HEADER COMMENT PREVENTS RECONVERSION, DO NOT REMOVE
"a" = (
/turf/open/lava/smooth/lava_land_surface,
/area/template_noop)
"c" = (
/obj/item/clothing/under/costume/skeleton,
/turf/open/misc/asteroid/basalt/wasteland,
/area/template_noop)
"d" = (
/obj/structure/fluff/clockwork/clockgolem_remains,
/turf/open/misc/asteroid/basalt/lava_land_surface,
/area/template_noop)
"e" = (
/obj/structure/stone_tile/block{
	dir = 1
	},
/obj/structure/stone_tile,
/obj/structure/stone_tile{
	dir = 8
	},
/turf/open/indestructible/boss,
/area/template_noop)
"f" = (
/obj/effect/decal/remains/human,
/turf/open/misc/asteroid/basalt/wasteland,
/area/template_noop)
"g" = (
/turf/closed/mineral/volcanic/lava_land_surface/hardened,
/area/template_noop)
"h" = (
/obj/structure/stone_tile,
/obj/structure/stone_tile{
	dir = 8
	},
/obj/structure/stone_tile/block/cracked{
	dir = 1
	},
/turf/open/indestructible/boss,
/area/template_noop)
"i" = (
/turf/closed/indestructible/necropolis,
/area/template_noop)
"j" = (
/mob/living/simple_animal/hostile/asteroid/elite/legionnaire,
/turf/open/indestructible/necropolis,
/area/template_noop)
"k" = (
/obj/structure/necropolis_arch,
/obj/structure/necropolis_gate/locked,
/obj/structure/stone_tile/slab,
/turf/open/indestructible/boss,
/area/template_noop)
"l" = (
/turf/open/indestructible/necropolis,
/area/template_noop)
"m" = (
/obj/effect/decal/remains/human,
/turf/open/indestructible/necropolis,
/area/template_noop)
"n" = (
/obj/structure/spawner/lavaland/legion,
/turf/open/indestructible/necropolis,
/area/template_noop)
"o" = (
/mob/living/simple_animal/hostile/asteroid/lobstrosity/lava,
/turf/open/indestructible/necropolis,
/area/template_noop)
"p" = (
/mob/living/simple_animal/hostile/asteroid/brimdemon{
	name = "Dunga"
	},
/turf/open/indestructible/necropolis,
/area/template_noop)
"q" = (
/obj/structure/stone_tile/slab/cracked,
/turf/open/indestructible/boss,
/area/template_noop)
"r" = (
/turf/closed/indestructible/rock,
/area/template_noop)
"s" = (
/obj/structure/spawner/lavaland/goliath,
/turf/open/indestructible/necropolis,
/area/template_noop)
"t" = (
/obj/effect/decal/remains/xeno,
/turf/open/indestructible/necropolis,
/area/template_noop)
"u" = (
/obj/structure/spawner/skeleton,
/turf/open/misc/asteroid/basalt/wasteland,
/area/template_noop)
"v" = (
/obj/structure/stone_tile/surrounding,
/obj/structure/stone_tile/center/cracked,
/turf/open/indestructible/boss,
/area/template_noop)
"x" = (
/obj/structure/stone_tile/block{
	dir = 4
	},
/obj/structure/stone_tile/block{
	dir = 8
	},
/turf/open/indestructible/boss,
/area/template_noop)
"y" = (
/obj/structure/stone_tile/block{
	dir = 8
	},
/obj/structure/stone_tile/block{
	dir = 4
	},
/turf/open/indestructible/boss,
/area/template_noop)
"z" = (
/obj/modular_map_connector,
/obj/structure/stone_tile/slab,
/turf/open/indestructible/boss,
/area/template_noop)
"A" = (
/turf/open/misc/asteroid/basalt/lava_land_surface,
/area/template_noop)
"B" = (
/obj/structure/stone_tile/block{
	dir = 8
	},
/obj/structure/stone_tile/block/burnt{
	dir = 4
	},
/turf/open/indestructible/boss,
/area/template_noop)
"C" = (
/obj/structure/stone_tile/surrounding/cracked,
/obj/structure/stone_tile/surrounding_tile/cracked{
	dir = 1
	},
/obj/structure/stone_tile/surrounding_tile/cracked,
/obj/structure/stone_tile/center/cracked,
/turf/open/indestructible/boss,
/area/template_noop)
"D" = (
/obj/structure/stone_tile/surrounding_tile{
	dir = 4
	},
/turf/open/indestructible/boss,
/area/template_noop)
"E" = (
/mob/living/simple_animal/hostile/asteroid/brimdemon,
/turf/open/indestructible/necropolis,
/area/template_noop)
"F" = (
/obj/effect/decal/remains/human,
/turf/open/misc/asteroid/basalt/lava_land_surface,
/area/template_noop)
"G" = (
/obj/structure/stone_tile/block,
/obj/structure/stone_tile{
	dir = 1
	},
/obj/structure/stone_tile{
	dir = 4
	},
/turf/open/indestructible/boss,
/area/template_noop)
"H" = (
/obj/structure/stone_tile/slab,
/turf/open/indestructible/boss,
/area/template_noop)
"I" = (
/obj/item/skeleton_key,
/turf/open/misc/asteroid/basalt/wasteland,
/area/template_noop)
"J" = (
/mob/living/simple_animal/hostile/asteroid/brimdemon{
	name = "Unga"
	},
/turf/open/indestructible/necropolis,
/area/template_noop)
"K" = (
/mob/living/simple_animal/hostile/skeleton{
	health = 200;
	name = "Bones McGee";
	speak = list("OoOoOoOh, I'm a talking skeleton! Isn't that SCARY?","I've got a BONE to pick with you!","I'll never go back to the museum!","Do you have any idea how much milk I drank before I died?!?","Laugh at MY boner will they? I'll show them! I'll show them how many BONERS McGee can make!");
	speak_chance = 25;
	speak_emote = list("rattles","plays their ribcage menacingly!")
	},
/turf/open/misc/asteroid/basalt/wasteland,
/area/template_noop)
"L" = (
/obj/structure/stone_tile/surrounding_tile{
	dir = 1
	},
/turf/open/indestructible/boss,
/area/template_noop)
"M" = (
/turf/closed/indestructible/riveted/boss,
/area/template_noop)
"N" = (
/obj/structure/spawner/lavaland/icewatcher,
/turf/open/indestructible/necropolis,
/area/template_noop)
"Q" = (
/mob/living/simple_animal/hostile/asteroid/brimdemon{
	name = "Bunga"
	},
/turf/open/indestructible/necropolis,
/area/template_noop)
"R" = (
/obj/effect/gibspawner/human/bodypartless,
/turf/open/indestructible/necropolis,
/area/template_noop)
"S" = (
/obj/structure/stone_tile/block,
/obj/structure/stone_tile{
	dir = 4
	},
/obj/structure/stone_tile{
	dir = 1
	},
/turf/open/indestructible/boss,
/area/template_noop)
"T" = (
/turf/open/misc/asteroid/basalt/wasteland,
/area/template_noop)
"U" = (
/obj/structure/legionturret,
/turf/open/indestructible/necropolis,
/area/template_noop)
"V" = (
/turf/open/indestructible/boss,
/area/template_noop)
"W" = (
/obj/structure/stone_tile/surrounding,
/obj/structure/stone_tile/center,
/turf/open/indestructible/boss,
/area/template_noop)
"X" = (
/obj/item/storage/fish_case/syndicate,
/turf/open/indestructible/necropolis,
/area/template_noop)
"Y" = (
/obj/structure/legionnaire_bonfire,
/turf/open/indestructible/necropolis,
/area/template_noop)
"Z" = (
/obj/structure/stone_tile/block{
	dir = 1
	},
/obj/structure/stone_tile{
	dir = 8
	},
/obj/structure/stone_tile,
/turf/open/indestructible/boss,
/area/template_noop)

(1,1,1) = {"
M
M
M
M
M
M
M
M
r
r
r
r
r
r
r
r
r
r
r
r
r
r
r
r
i
i
i
r
r
r
r
"}
(2,1,1) = {"
M
M
M
M
g
g
g
g
g
g
g
g
g
g
g
g
g
g
g
g
g
g
g
g
i
i
i
i
i
g
r
"}
(3,1,1) = {"
M
M
M
M
g
g
g
g
g
g
g
g
g
g
g
g
i
i
i
g
g
i
i
i
i
l
l
i
i
i
i
"}
(4,1,1) = {"
M
M
g
g
g
g
g
g
g
g
g
g
g
g
g
i
i
i
i
i
i
i
i
i
i
l
l
a
a
i
i
"}
(5,1,1) = {"
M
M
g
g
g
g
g
g
g
g
g
g
g
g
i
i
i
i
i
i
i
i
i
i
l
l
E
l
a
i
i
"}
(6,1,1) = {"
M
M
g
g
g
g
g
g
g
g
i
i
i
i
i
i
l
l
l
l
l
l
l
l
l
l
l
l
i
i
i
"}
(7,1,1) = {"
M
M
M
M
M
g
A
A
A
A
i
i
i
i
i
i
l
l
l
l
l
l
l
E
l
l
R
l
i
l
i
"}
(8,1,1) = {"
M
M
M
M
M
M
M
A
A
A
l
l
l
l
i
i
l
l
l
i
i
i
i
i
t
l
i
l
i
l
i
"}
(9,1,1) = {"
M
M
V
y
W
H
C
H
A
A
A
l
l
l
l
l
t
l
l
i
i
i
i
i
l
E
i
l
l
l
i
"}
(10,1,1) = {"
H
V
V
L
Z
H
S
H
h
q
A
A
l
l
l
l
s
l
l
R
i
i
i
i
i
i
i
l
l
l
i
"}
(11,1,1) = {"
z
H
k
y
y
y
y
y
y
y
B
A
A
l
l
l
l
l
l
l
i
i
i
i
i
l
l
l
l
l
i
"}
(12,1,1) = {"
H
V
V
D
Z
H
G
H
e
q
S
q
A
l
l
l
l
l
l
l
l
i
i
i
i
i
l
l
l
i
i
"}
(13,1,1) = {"
M
M
V
x
W
H
W
q
v
A
A
A
A
l
l
l
l
l
l
a
a
i
i
i
i
i
i
i
i
i
i
"}
(14,1,1) = {"
M
M
M
M
M
M
M
A
A
A
A
l
l
l
l
l
l
l
a
a
a
i
i
g
g
i
i
i
i
i
i
"}
(15,1,1) = {"
M
M
M
M
M
A
A
A
A
l
l
l
l
l
R
l
l
l
l
l
a
i
i
g
g
g
g
g
g
i
i
"}
(16,1,1) = {"
M
M
g
g
g
g
A
A
i
i
i
i
i
i
i
l
l
l
l
l
l
i
i
g
g
g
g
g
g
g
r
"}
(17,1,1) = {"
M
M
g
g
g
g
g
g
g
g
i
i
i
i
i
i
l
l
l
l
l
i
i
g
g
g
g
g
g
g
r
"}
(18,1,1) = {"
M
M
g
g
g
g
g
g
g
g
g
g
g
i
i
i
l
l
s
l
i
i
i
g
g
g
g
g
g
g
r
"}
(19,1,1) = {"
M
M
g
g
g
g
g
g
g
g
g
g
g
i
i
i
i
l
l
l
i
i
g
g
g
g
g
g
g
g
r
"}
(20,1,1) = {"
M
M
M
g
g
g
g
g
g
g
g
g
g
g
g
i
i
m
l
l
i
i
i
g
g
g
g
g
g
g
r
"}
(21,1,1) = {"
M
M
M
g
g
g
g
g
g
g
g
g
g
g
g
i
i
i
l
l
l
i
i
g
g
g
g
g
g
g
r
"}
(22,1,1) = {"
M
M
M
g
g
g
g
g
g
g
g
g
g
g
g
i
i
i
l
l
A
i
i
i
g
g
g
g
g
g
r
"}
(23,1,1) = {"
M
M
M
M
g
g
g
g
g
g
g
g
g
g
g
g
i
l
l
l
A
i
i
i
g
g
g
g
g
g
r
"}
(24,1,1) = {"
M
M
M
M
g
g
g
g
g
g
g
g
g
g
g
i
i
l
l
l
A
A
g
g
g
g
g
g
g
g
r
"}
(25,1,1) = {"
M
M
M
M
g
g
g
g
g
g
g
g
i
i
i
i
i
l
A
A
A
A
g
g
g
g
g
g
g
g
r
"}
(26,1,1) = {"
M
M
M
M
g
g
g
i
i
i
i
i
i
i
i
i
l
l
A
A
A
A
g
g
g
g
g
g
g
g
r
"}
(27,1,1) = {"
M
M
M
g
g
g
i
i
i
i
i
i
i
l
l
l
l
l
A
A
A
A
g
g
g
g
g
g
g
g
r
"}
(28,1,1) = {"
M
M
M
g
g
g
i
i
l
l
l
l
l
l
l
l
l
a
A
A
A
g
g
g
g
g
g
g
g
g
r
"}
(29,1,1) = {"
M
M
g
g
g
g
i
l
l
l
l
l
l
R
l
l
a
a
A
A
g
g
g
g
g
g
g
g
g
g
r
"}
(30,1,1) = {"
M
M
g
g
g
g
g
i
i
i
i
i
l
l
l
l
l
i
A
A
i
g
g
g
g
g
g
g
g
g
r
"}
(31,1,1) = {"
M
M
g
g
g
g
g
g
i
i
i
i
i
i
l
l
l
i
i
i
i
g
g
g
g
g
g
g
g
g
r
"}
(32,1,1) = {"
M
M
g
g
g
g
g
g
g
g
g
i
i
i
l
l
l
i
i
i
i
g
g
g
g
g
g
g
g
g
r
"}
(33,1,1) = {"
M
M
g
g
g
g
g
g
g
g
g
i
i
l
l
l
l
i
i
g
g
g
g
g
i
i
i
i
i
i
r
"}
(34,1,1) = {"
M
M
g
g
g
g
g
g
g
g
g
i
i
l
N
l
l
i
i
i
i
i
i
i
i
i
i
i
i
i
r
"}
(35,1,1) = {"
M
M
g
g
g
g
g
g
g
g
g
i
i
a
l
l
l
l
l
i
i
i
i
i
i
l
l
l
i
i
r
"}
(36,1,1) = {"
M
M
M
g
g
g
g
g
g
g
g
i
i
a
m
l
l
l
l
l
l
l
l
l
t
l
l
i
i
i
r
"}
(37,1,1) = {"
M
M
M
g
g
g
g
g
g
g
g
i
i
a
a
l
l
l
l
i
i
i
i
i
i
i
i
i
i
g
r
"}
(38,1,1) = {"
M
M
M
g
g
g
g
g
g
g
g
g
i
i
l
l
l
i
i
i
i
i
i
i
i
i
i
i
i
g
r
"}
(39,1,1) = {"
M
M
M
g
g
g
g
g
g
g
g
g
i
i
l
R
l
i
i
g
g
g
g
g
g
g
g
g
g
g
r
"}
(40,1,1) = {"
M
M
M
g
g
g
g
g
g
g
g
g
i
i
l
l
l
i
i
i
i
g
g
g
g
g
g
g
g
g
r
"}
(41,1,1) = {"
M
M
M
M
M
M
M
g
g
g
g
g
i
i
l
l
l
i
i
i
i
g
g
g
g
g
g
g
g
g
r
"}
(42,1,1) = {"
M
M
M
M
M
M
M
M
M
g
g
g
i
i
l
l
N
l
i
i
i
g
g
g
g
g
i
i
i
g
r
"}
(43,1,1) = {"
M
M
M
M
M
M
M
g
g
g
g
g
i
i
l
l
l
l
i
g
g
g
g
i
i
i
i
i
i
g
r
"}
(44,1,1) = {"
M
M
M
g
g
g
g
g
g
g
g
g
i
i
g
A
l
l
i
i
i
i
i
i
l
l
o
i
i
i
i
"}
(45,1,1) = {"
M
M
M
g
g
g
g
g
g
g
g
g
i
i
g
A
A
l
i
i
i
i
i
i
l
l
X
a
i
i
i
"}
(46,1,1) = {"
M
M
M
g
g
g
g
g
g
g
g
i
i
g
A
A
A
l
l
l
i
i
i
i
l
l
a
a
a
a
i
"}
(47,1,1) = {"
M
M
M
g
g
g
g
g
g
g
g
i
i
g
A
A
A
l
l
l
l
o
l
R
o
a
a
a
a
i
i
"}
(48,1,1) = {"
M
M
M
g
g
g
g
g
g
g
g
g
g
g
A
A
A
l
l
m
l
l
l
l
l
a
a
a
a
i
i
"}
(49,1,1) = {"
M
M
g
g
g
g
g
g
g
g
g
g
A
A
A
A
A
l
l
l
i
l
o
l
l
l
a
a
a
i
i
"}
(50,1,1) = {"
M
M
g
g
g
g
g
A
A
A
A
A
A
A
A
A
A
l
l
i
i
i
i
i
l
o
a
a
a
i
i
"}
(51,1,1) = {"
M
M
g
g
M
A
A
A
A
A
A
A
A
A
g
A
A
A
l
i
i
i
i
i
l
l
X
a
a
i
i
"}
(52,1,1) = {"
M
M
g
g
g
A
A
A
A
A
A
A
A
g
g
i
A
A
l
l
i
i
i
i
i
i
i
i
i
i
r
"}
(53,1,1) = {"
M
M
g
g
g
A
A
A
A
g
M
g
g
g
g
i
A
A
l
l
i
i
g
g
g
i
i
i
i
g
r
"}
(54,1,1) = {"
M
M
g
g
M
A
A
M
M
g
g
g
g
g
g
i
A
A
l
l
i
i
g
g
g
g
g
g
g
g
r
"}
(55,1,1) = {"
M
M
M
g
M
A
A
A
g
g
g
g
g
g
g
i
i
l
l
l
i
i
g
g
g
g
g
g
g
g
r
"}
(56,1,1) = {"
M
M
M
g
g
A
A
F
A
M
M
g
g
g
g
i
i
l
l
l
i
i
g
g
g
g
g
g
g
g
r
"}
(57,1,1) = {"
M
M
M
g
g
g
A
A
A
T
M
M
g
g
g
i
i
l
l
l
i
i
g
g
g
g
g
g
g
g
r
"}
(58,1,1) = {"
M
M
M
g
g
g
M
A
T
T
T
M
g
g
i
i
i
l
l
l
i
i
i
g
g
g
g
g
g
g
r
"}
(59,1,1) = {"
M
M
M
M
g
g
g
A
T
f
T
T
g
g
i
i
i
l
R
l
i
i
i
g
g
g
g
g
g
g
r
"}
(60,1,1) = {"
M
M
M
M
g
g
g
T
K
T
T
I
M
g
i
i
l
m
l
l
l
i
i
g
g
g
g
g
g
g
r
"}
(61,1,1) = {"
M
M
M
M
M
M
M
f
c
T
T
T
M
g
i
i
l
l
n
l
a
i
i
g
g
g
g
g
g
g
r
"}
(62,1,1) = {"
M
M
M
M
g
g
M
T
T
u
T
f
M
g
i
i
l
l
l
l
a
i
i
i
g
i
i
g
g
g
r
"}
(63,1,1) = {"
M
M
M
M
g
g
M
T
T
T
T
M
g
g
i
i
i
l
l
a
a
a
i
i
g
i
A
A
g
g
r
"}
(64,1,1) = {"
M
M
M
g
g
g
g
I
f
I
M
M
g
g
g
i
i
l
l
l
l
l
i
i
i
i
A
A
A
g
r
"}
(65,1,1) = {"
M
M
g
g
g
g
g
g
T
T
M
g
g
g
g
i
i
l
l
l
l
l
l
l
l
A
A
A
A
g
r
"}
(66,1,1) = {"
M
M
g
g
g
g
g
g
g
g
g
g
g
g
i
i
i
l
l
l
l
l
l
l
l
l
A
A
A
g
r
"}
(67,1,1) = {"
M
M
g
g
g
g
g
g
g
g
i
i
i
i
i
i
l
l
l
l
l
n
l
l
l
l
A
A
A
A
r
"}
(68,1,1) = {"
M
M
g
g
g
g
g
g
g
g
i
i
i
i
i
l
l
l
l
l
l
l
l
l
l
l
l
A
A
A
r
"}
(69,1,1) = {"
M
M
g
g
g
g
g
g
g
g
i
i
i
l
l
l
l
R
t
l
l
i
i
i
i
l
R
l
A
A
r
"}
(70,1,1) = {"
M
M
g
g
i
i
i
i
i
i
i
g
i
i
i
i
i
l
l
l
l
i
i
g
i
i
l
l
A
A
r
"}
(71,1,1) = {"
M
M
g
g
i
i
l
l
l
i
i
i
g
g
i
i
i
i
i
i
i
i
g
g
i
i
l
l
A
A
r
"}
(72,1,1) = {"
M
M
g
i
i
a
a
l
l
l
l
i
i
g
g
g
i
i
i
i
i
i
g
g
i
l
l
l
l
i
i
"}
(73,1,1) = {"
M
M
g
i
l
l
m
l
l
U
l
i
i
g
g
g
i
i
i
i
i
i
i
g
i
l
l
l
l
m
i
"}
(74,1,1) = {"
M
M
g
i
l
l
l
l
l
l
l
i
i
i
i
i
i
l
l
a
a
l
i
i
i
l
l
l
l
l
i
"}
(75,1,1) = {"
M
M
g
i
l
l
Y
R
j
l
l
l
l
l
i
i
l
l
l
a
l
l
l
l
l
l
l
l
l
i
i
"}
(76,1,1) = {"
M
M
M
i
i
l
l
l
l
l
m
l
l
l
l
l
R
l
l
l
l
l
l
l
l
l
l
l
l
i
i
"}
(77,1,1) = {"
M
M
M
g
i
l
l
m
l
U
l
l
l
l
l
l
l
l
l
i
i
i
i
i
i
l
l
l
l
i
r
"}
(78,1,1) = {"
M
M
M
M
i
i
l
l
l
a
l
l
i
i
i
i
i
i
i
i
g
g
g
g
i
l
l
l
i
i
r
"}
(79,1,1) = {"
M
M
M
M
i
i
i
l
a
a
i
i
i
i
g
g
g
g
g
g
g
g
g
g
i
l
l
l
i
i
r
"}
(80,1,1) = {"
M
M
M
M
g
i
i
i
i
i
i
i
i
i
i
i
i
g
g
g
g
g
i
i
i
l
l
l
i
g
r
"}
(81,1,1) = {"
M
M
g
g
g
g
g
g
i
i
i
l
l
l
i
i
i
i
g
i
i
i
i
i
i
l
R
l
i
g
r
"}
(82,1,1) = {"
M
M
g
g
g
g
g
g
i
i
l
l
l
l
l
l
a
i
i
i
i
l
l
l
l
l
l
l
i
g
r
"}
(83,1,1) = {"
M
M
g
g
g
g
g
i
i
l
l
J
l
l
l
l
a
l
l
l
l
l
l
l
l
l
i
l
i
g
r
"}
(84,1,1) = {"
M
M
g
g
g
g
g
i
l
l
l
l
l
R
l
l
l
l
m
l
l
l
l
l
l
l
i
i
i
g
r
"}
(85,1,1) = {"
M
M
g
g
g
g
g
i
l
l
t
l
l
l
l
l
l
l
l
l
l
l
l
l
l
l
i
g
g
g
r
"}
(86,1,1) = {"
M
M
g
g
g
g
g
i
l
l
l
l
l
l
Q
l
i
i
i
i
l
a
a
l
l
i
i
i
g
g
r
"}
(87,1,1) = {"
M
M
g
g
g
g
g
i
i
l
l
p
l
i
i
i
i
g
g
i
i
i
i
i
i
i
i
i
g
g
r
"}
(88,1,1) = {"
M
M
M
g
g
g
g
g
i
l
l
l
l
i
i
i
g
g
g
g
g
g
g
g
g
g
g
g
g
g
r
"}
(89,1,1) = {"
M
M
M
g
g
g
g
g
i
i
l
l
i
i
g
g
g
g
g
g
g
g
g
g
g
g
g
g
g
g
r
"}
(90,1,1) = {"
M
M
M
g
M
M
M
g
g
i
a
l
i
g
g
g
g
g
g
g
g
g
g
g
g
g
g
g
g
g
r
"}
(91,1,1) = {"
M
M
M
M
M
M
M
g
i
i
a
l
l
i
g
g
g
g
g
g
g
g
g
g
g
g
g
g
g
g
r
"}
(92,1,1) = {"
M
M
M
M
M
M
M
g
i
a
a
l
l
i
i
g
g
g
g
g
g
g
g
g
g
g
g
g
g
g
r
"}
(93,1,1) = {"
M
M
M
M
M
g
g
g
i
a
l
l
l
l
i
g
g
g
g
g
g
g
g
g
g
g
g
g
g
g
r
"}
(94,1,1) = {"
M
M
M
g
g
g
g
g
g
A
l
l
l
l
i
g
g
g
g
g
g
g
g
g
g
g
g
g
g
g
r
"}
(95,1,1) = {"
M
M
M
g
g
g
g
g
A
A
l
l
l
l
i
i
g
g
g
g
g
g
g
g
g
g
g
g
g
g
r
"}
(96,1,1) = {"
M
M
M
g
g
g
g
g
A
A
l
l
l
l
i
i
i
g
g
g
g
g
g
g
g
g
g
g
g
g
r
"}
(97,1,1) = {"
M
M
M
g
g
g
g
g
A
A
l
m
l
l
l
i
i
i
i
i
g
g
g
g
g
g
g
g
g
g
r
"}
(98,1,1) = {"
M
M
M
g
g
g
g
g
g
A
A
A
l
R
l
l
i
i
i
i
i
i
i
i
i
g
g
g
g
g
r
"}
(99,1,1) = {"
M
M
g
g
g
g
g
g
g
A
A
A
A
l
l
l
l
l
l
l
l
a
i
i
i
i
i
i
g
g
r
"}
(100,1,1) = {"
M
M
M
M
M
M
g
g
g
g
A
A
A
l
l
l
l
l
l
l
l
a
a
a
i
i
i
i
g
g
r
"}
(101,1,1) = {"
M
M
M
M
M
M
M
M
M
g
A
A
A
A
A
A
l
l
l
l
l
l
l
l
i
i
i
i
g
g
r
"}
(102,1,1) = {"
M
M
M
M
M
M
g
g
g
g
g
g
A
A
A
A
A
i
l
l
l
l
l
l
t
i
i
g
g
g
r
"}
(103,1,1) = {"
M
M
g
g
g
g
g
g
g
g
g
g
g
A
A
A
g
i
i
i
l
l
l
l
l
i
i
g
g
g
r
"}
(104,1,1) = {"
M
M
g
g
g
g
g
g
g
g
g
g
g
g
g
g
g
i
i
i
i
i
l
R
l
l
i
g
g
g
r
"}
(105,1,1) = {"
M
M
M
g
g
g
g
g
g
g
g
g
g
g
g
g
g
i
i
i
i
i
l
l
l
l
i
i
g
g
r
"}
(106,1,1) = {"
M
M
M
g
g
g
g
g
g
g
g
g
g
g
g
g
g
g
g
g
i
i
l
l
l
l
i
i
g
g
r
"}
(107,1,1) = {"
M
M
M
g
g
g
g
g
g
g
g
g
g
g
g
g
g
g
g
g
i
i
A
l
A
l
i
i
g
g
r
"}
(108,1,1) = {"
M
M
M
g
g
g
g
g
g
g
g
g
g
g
g
g
g
g
g
g
i
i
A
l
A
l
i
i
g
g
r
"}
(109,1,1) = {"
M
M
M
M
g
g
g
g
g
g
g
g
g
g
g
g
g
g
g
g
g
i
A
l
A
l
A
i
g
g
r
"}
(110,1,1) = {"
M
M
M
M
M
M
M
M
M
M
g
g
g
g
g
g
g
g
g
g
g
i
A
l
A
A
A
g
g
g
r
"}
(111,1,1) = {"
M
M
M
M
g
g
g
g
g
g
g
g
g
g
g
g
g
g
g
g
g
g
A
A
A
A
A
A
g
g
r
"}
(112,1,1) = {"
M
M
M
M
g
g
g
g
g
g
g
g
g
g
M
M
M
M
M
g
g
g
A
V
V
V
A
A
g
g
r
"}
(113,1,1) = {"
M
M
M
M
M
M
g
g
g
M
M
M
M
M
M
M
M
M
M
M
M
g
V
V
V
V
V
A
g
g
r
"}
(114,1,1) = {"
M
M
M
M
M
M
M
M
M
M
M
M
M
M
M
M
M
M
M
M
M
M
M
V
V
V
M
M
M
M
M
"}
(115,1,1) = {"
M
M
M
M
M
M
M
M
M
M
M
M
M
M
M
M
M
M
M
M
M
M
M
V
V
V
M
M
M
M
M
"}
(116,1,1) = {"
M
M
M
M
M
M
M
M
M
M
M
M
M
M
M
M
M
M
M
M
M
M
M
V
V
V
M
M
M
M
M
"}
(117,1,1) = {"
M
M
M
M
M
M
M
M
M
g
g
g
g
g
g
g
g
g
g
g
g
g
V
V
V
V
V
g
g
g
r
"}
(118,1,1) = {"
M
M
g
g
g
g
g
A
A
A
A
A
A
A
A
g
g
g
g
g
A
A
A
V
V
V
A
g
g
g
r
"}
(119,1,1) = {"
M
M
g
g
g
A
A
A
A
A
A
A
A
A
A
A
A
A
A
A
d
A
A
A
A
A
A
g
g
g
r
"}
(120,1,1) = {"
M
M
g
g
A
A
A
A
A
A
A
A
A
A
A
A
d
A
A
A
A
A
A
A
A
g
g
g
g
g
r
"}
(121,1,1) = {"
M
M
g
g
A
A
A
A
A
A
A
A
A
A
A
g
g
g
g
g
g
g
g
g
g
g
g
g
g
g
r
"}
(122,1,1) = {"
M
M
g
g
g
A
A
A
A
A
A
A
A
A
g
g
g
g
g
g
g
g
g
g
g
g
g
g
g
g
r
"}
(123,1,1) = {"
M
M
r
r
r
r
r
r
r
r
r
r
r
r
r
r
r
r
r
r
r
r
r
r
r
r
r
r
r
r
r
"}
