"a" = (/turf/closed/mineral/volcanic/lava_land_surface/hardened,/area/template_noop)
"i" = (/turf/closed/wall/vault/alien,/area/template_noop)
"t" = (/turf/open/floor/vault/rock{initial_gas_mix = "LAVALAND_ATMOS"},/area/template_noop)
"w" = (/turf/closed/indestructible/riveted,/area/template_noop)
"x" = (/turf/open/misc/asteroid/basalt/lava_land_surface,/area/template_noop)
"y" = (/turf/closed/wall/vault/rock,/area/template_noop)
"G" = (/obj/machinery/door/puzzle/keycard{open_message = "The door hums ominously and slides open."; puzzle_id = "number1victoryroyale"},/turf/open/floor/vault/rock{initial_gas_mix = "LAVALAND_ATMOS"},/area/template_noop)
"I" = (/obj/modular_map_connector,/turf/open/misc/asteroid/basalt/lava_land_surface,/area/template_noop)
"N" = (/turf/closed/indestructible/rock,/area/template_noop)
"P" = (/obj/effect/decal/cleanable/dirt,/obj/structure/railing{dir = 1},/obj/structure/railing,/turf/open/floor/plating/lavaland_atmos,/area/template_noop)
"R" = (/turf/template_noop,/area/template_noop)
"T" = (/turf/open/chasm/lavaland,/area/template_noop)
"W" = (/obj/modular_map_root/caves{key = "caves_lvl3segment3"; name = "lvl3segment3"},/turf/template_noop,/area/template_noop)

(1,1,1) = {"
wwwwwwwwwwwwwwwwwwwwwwwwwwwwwwwwwwwwwwwwwwwwwwwwwwwwwwwwwwwwwwwwwwwwwwwwwwwwwwwwwwwwwwwwwwwwwwwwxxIxxxwwwwwwwwwwwwwwwwwwwww
aaaaaaaaaaaaaaaaaaaaaaaaaaaaaaaaaaaaaaaaaaaaaaaaaaaaaaaaaaaaaaaaaaaaaaaaaaaaaaaaaaaiaaaaaaaaaaaaxxxxxxaaaaaaaaaaaaaaaaaaaaa
aaaaaaaaaaaaaaaaaaaaaaaaaaaaaaaaaaaaaaaaaaaaaaaaaaaaaaaaaaaaaaaaaaaaaaaaaaaaaaaaaaaiaaaaaaTaaaaaxxxxxaaaaaaaaaaaaaaaaaaaaaa
aaaaaaaaaaaaaaaaaaaaaaaaaaaaaaaaaaaaaaaaaaaaaaaaaaaaaaaaaaaaaaaaaaaaaaaaaaaaaaaaiiiiiaaaaTTaaaaxxxxxxaaaaaaaaaaaaaaaaaaaaaa
aaaaaaaaaaaaaaaaaaaaaaaaaaaaaaaaaaaaaaaaaaaaaaaaaaaaaaaaaaaaaaaaaaaaaaaaaaaaaaaiitttiiaxxTTTaaaxxaxxxxxxxaaaaaaaaaaaaaaaaaa
aaaaaaaaaaaaaaaaaaaaaaaaaaaaaaaaaaaaaaaaaaaaaaaaaaaaaaaaaaaaaaaaaaaaaaaaaaaaaaaitttttixxxPPPxxxxxaxxxxxxxxxaaaaaaaaaaaaaaaa
aaaaaaaaaaaaaaaaaaaaaaaaaaaaaaaaaaaaaaaaaaaaaaaaaaaaaaaaaaaaaaaaaaaaaaaaaaaaaaaitttttGxxxTTTaxaaaaxxaaaxxxxaaaaaaaaaaaaaaaa
aaaaaaaaaaaaaaaaaaaaaaaaaaaaaaaaaaaaaaaaaaaaaaaaaaaaaaaaaaaaaaaaaaaaaaaaaaaaaaaitttttixxaTTTaaaaxxxxaaaaaxxxaaaaaaaaaaaaaaa
aaaaaaaaaaaaaaaaaaaaaaaaaaaaaaaaaaaaaaaaaaaaaaaaaaaaaaaaaaaaaaaaayaaaaaaaaaaaaaiitttiiaaaaTaaaaaaaaaaaaaaxxxxaaaaaaaaaaaaaa
aaaaaaaaaaaaaaaaaaaaaaaaaaaaaaaaaaaaaaaaaaaaaaaaaaaaaaaaaaaaaaaaaaaaaaaaaaaaaaaaiitiiaaaaaTTaaaaaaaaaaaaaxxxxaaaaaaaaaaaaaa
aaaaaaaaaaaaaaaaaaaaaaaaaaaaaaaaaaaaaaaaaaaaaaaaaaaaaaaaaaaaaaaaaaaaaaaaaaaaaaaaaaaaiaaaaTTTaaaaaaaaaaaaaaaxxaaaaaaaaaaaaaa
aaaaaaaaaaaaaaaaaaaaaaaaaaaaaaaaaaaaaaaaaaaaaaaaaaaaaaaaaaaaaaaaaaaaaaaaaaaaaaaaaaaaiaaaaaTTaaaaaaaaaaaaaaaxxaaaaaxxxxaaaaa
aaaaaaaaaaaaaaaaaaaaaaaaaaaaaaaaaaaaaaaaaaaaaaaaaaaaaaaaaaaaaaaaaaaaaaaaaaaaaaaaaaaaiaaaaTTTaaaaaaaaaaaaaxxxxxaaaxxxxxxxaaa
aaaaaaaaaaaaaaaaaaaaaaaaaaaaaaaaaaaaaaaaaaaaaaaaaaaaaaaaaaaaaaaaaaaaaaaaaaaaaaaaaaaaiaaaaTTTTaaaaaaaaaaaaaxxxxaaxxxxxxxxaaa
aaaaaaaaaaaaaaaaaaaaaaaaaaaaaaaaaaaaaaaaaaaaaaaaaaaaaaaaaaaaaaaaaaaaaaaaaaaaaaaaaaaaiaaaTTTTTaaaaaaaaaaaaaxxxxxxxxxxxxxxaaa
aaaaaaaaaaaaaaaaaaaaaaaaaaaaaaaaaaaaaaaaaaaaaaaaaaaaaaaaaaaaaaaaaaaaaaaaaaaaaaaaaaaaiaaaaTTTTTTaaaaaaaaaaaxxxxxxxxxxxxxxaaa
aaaaaaaaaaaaaaaaaaaaaaaaaaaaaaaaaaaaaaaaaaaaaaaaaaaaaaaaaaaaaaaaaaaaaaaaaaaaaaaaaaaaiaaaaTTTTaaaaaaaaaaaaaaxxxxxxxxxxxxxxaa
aaaaaaaaaaaaaaaaaaaaaaaaaaaaaaaaaaaaaaaaaaaaaaaaaaaaaaaaaaaaaaaaaaaaaaaaaaaaaaaaaaaaiaaaaaTTaaaaaaaaaaaaaaaxxxxxxxxxxxxxxaa
aaaaaaaaaaaaaaaaaaaaaaaaaaaaaaaaaaaaaaaaaaaaaaaaaaaaaaaaaaaaaaaaaaaaaaaaaaaaaaaaaaaaiaaaaaTTaaaaaaaaaaaaaaaxxxxxxxxxxxxxxxa
aaaaaaaaaaaaaaaaaaaaaaaaaaaaaaaaaaaaaaaaaaaaaaaaaaaaaaaaaaaaaaaaaaaaaaaaaaaaaaaaaaaaiaaaaaTTTaaaaaaaaaaaaaaxxxxxxxxxxxxxxxa
aaaaaaaaaaaaaaaaaaaaaaaaaaaaaaaaaaaaaaaaaaaaaaaaaaaaaaaaaaaaaaaaaaaaaaaaaaaaaaaaaaaaiaaaaaaTTaaaaaaaaaaaaaaaxxxxxxxxxxxxxxa
aaaaaaaaaaaaaaaaaaaaaaaaaaaaaaaaaaaaaaaaaaaaaaaaaaaaaaaaaaaaaaaaaaaaaaaaaaaaaaaaaaaaiaaaaaaTTaaaaaaaaaaaaaaxxxxxxxxxxxxxxxa
aaaaaaaaaaaaaaaaaaaaaaaaaaaaaaaaaaaaaaaaaaaaaaaaaaaaaaaaaaaaaaaaaaaaaaaaaaaaaaaaaaaaiaaaaaaTTTaaaaaaaaaaaaaxxxxxxxxxxxxxxxa
aaaaaaaaaaaaaaaaaaaaaaaaaaaaaaaaaaaaaaaaaaaaaaaaaaaaaaaaaaaaaaaaaaaaaaaaaaaaaaaaaaaaiaaaaaTTTTTTTaaaaaaaaxTTTTTTxxxxxxxxxxa
aaaaaaaaaaaaaaaaaaaaaaaaaaaaaaaaaaaaaaaaaaaaaaaaaaaaaaaaaaaaaaaaaaaaaaaaaaaaaaaaaaaaiaaaaaaTTTaaaaaaaaaaaTTTTTTTTxxxxxxxxxa
aaaaaaaaaaaaaaaaaaaaaaaaaaaaaaaaaaaaaaaaaaaaaaaaaaaaaaaaaaaaaaaaaaaaaaaaaaaaaaaaaaaaiaaaaaaaTTaaaaaaaaaaTTTTTTTTTTxxxxxxxxa
aaaaaaaaaaaaaaaaaaaaaaaaaaaaaaaaaaaaaaaaaaaaaaaaaaaaaaaaaaaaaaaaaaaaaaaaaaaaaaaaaaaaiaaaaaaaTTTaaaaaaaaaTTTTTTTTTTxxxxxxxxa
aaaaaaaaaaaaaaaaaaaaaaaaaaaaaaaaaaaaaaaaaaaaaaaaaaaaaaaaaaaaaaaaaaaaaaaaaaaaaaaaaaaaiaaaaaaaTTTaaaaaaaaaTTTTTTTTTTxxxxxxxxa
aaaaaaaaaaaaaaaaaaaaaaaaaaaaaaaaaaaaaaaaaaaaaaaaaaaaaaaaaaaaaaaaaaaaaaaaaaaaaaaaaaaaiaaaaaaaTTTaaaaaaaaaTTTTTTTTTTxxxxxxxxa
aaaaaaaaaaaaaaaaaaaaaaaaaaaaaaaaaaaaaaaaaaaaaaaaaaaaaaaaaaaaaaaaaaaaaaaaaaaaaaaaaaaaiaaaTTTTTTTTaaaaaaaaTTTTTTTTTTxxxxxxxxa
aaaaaaaaaaaaaaaaaaaaaaaaaaaaaaaaaaaaaaaaaaaaaaaaaaaaaaaaaaaaaaaaaaaaaaaaaaaaaaaaaaaaiaaaaaaaTTTTaaaaaaaaTTTTTTTTTxxxxxxxxaa
aaaaaaaaaaaaaaaaaaaaaaaaaaaaaaaaaaaaaaaaaaaaaaaaaaaaaaaaaaaaaaaaaaaaaaaaaaaaaaaaaaaaiaaaaaaaTTTaaaaaaaaaxTTTTTTTTxxxxxxxxaa
aaaaaaaaaaaaaaaaaaaaaaaaaaaaaaaaaaaaaaaaaaaaaaaaaaaaaaaaaaaaaaaaaaaaaaaaaaaaaaaaaaaaiaaaaaaaTTTaaaaaaaaaxxTTTTTTxxxxxxxxaaa
aaaaaaaaaaaaaaaaaaaaaaaaaaaaaaaaaaaaaaaaaaaaaaaaaaaaaaaaaaaaaaaaaaaaaaaaaaaaaaaaaaaaiaaaaaaaaTaaaaaaaaaaaaaaaaaxxxxxxaaaaaa
aaaaaaaaaaaaaaaaaaaaaaaaaaaaaaaaaaaaaaaaaaaaaaaaaaaaaaaaaaaaaaaaaaaaaaaaaaaaaaaaaaaaiaaaaaaaaTaaaaaaaaaaaaaaaaaaaaaaaaaaaaa
Naaaaaaaxxxxxaaaaaaaaaaaaaaaaaaaaaaaaaaaaaaaaaaaaaaaaaaaaaaaaaaaaaaaaaaaaaaaaaaaaaaaiaaaaaaaaaaaaaaaaaaaaaaaaaaaaaaaaaaaaaa
RRRRRRRRRRWRRRRRRRRRRRRRRRRRRRRRRRRRRRRRRRRRRRRRRRRRRRRRRRRRRRRRRRRRRRRRRRRRRRRRRRRRRRRRRRRRRRRRRRRRRRRRRRRRRRRRRRRRRRRRRRR
"}
