//MAP CONVERTED BY dmm2tgm.py THIS HEADER COMMENT PREVENTS RECONVERSION, DO NOT REMOVE
"aa" = (
/turf/open/lava/smooth/lava_land_surface,
/area/template_noop)
"ag" = (
/turf/closed/mineral/volcanic/lava_land_surface/hardened,
/area/template_noop)
"aj" = (
/turf/open/chasm/lavaland,
/area/template_noop)
"ar" = (
/turf/closed/indestructible/rock,
/area/template_noop)
"aA" = (
/turf/open/misc/asteroid/basalt/lava_land_surface,
/area/template_noop)
"aD" = (
/obj/modular_map_connector,
/turf/open/misc/asteroid/basalt/lava_land_surface,
/area/template_noop)
"aI" = (
/obj/structure/fluff/clockwork/clockgolem_remains,
/turf/open/misc/asteroid/basalt/lava_land_surface,
/area/template_noop)
"aS" = (
/obj/structure/flora/rock,
/turf/open/misc/asteroid/basalt/lava_land_surface,
/area/template_noop)
"bh" = (
/obj/structure/fluff/clockwork/clockgolem_remains,
/obj/effect/decal/cleanable/dirt,
/turf/open/floor/bronze/filled/lavaland,
/area/template_noop)
"bn" = (
/obj/effect/decal/cleanable/dirt,
/obj/item/crowbar/large/heavy,
/turf/open/floor/plating/lavaland_atmos,
/area/template_noop)
"cs" = (
/obj/structure/fluff/clockwork/alloy_shards,
/turf/open/misc/asteroid/basalt/lava_land_surface,
/area/template_noop)
"em" = (
/obj/effect/gibspawner/human/bodypartless,
/turf/open/indestructible/necropolis,
/area/template_noop)
"fl" = (
/mob/living/simple_animal/hostile/clockwork,
/obj/effect/decal/cleanable/dirt,
/turf/open/floor/bronze/filled/lavaland,
/area/template_noop)
"ft" = (
/obj/effect/decal/cleanable/dirt,
/obj/structure/fluff{
	desc = "You're not sure if walking into this is a great idea...";
	icon = 'icons/effects/eldritch.dmi';
	icon_state = "pierced_illusion";
	name = "fluxating rift"
	},
/obj/effect/bump_teleporter{
	id = null;
	id_target = "lvl4spawn";
	name = "lvl4 teleport"
	},
/turf/open/floor/bronze/flat/lavaland,
/area/template_noop)
"fA" = (
/obj/structure/stone_tile/block/burnt{
	dir = 4
	},
/obj/structure/stone_tile/block/burnt{
	dir = 8
	},
/obj/structure/mineral_door/iron{
	name = "expansssive waresss emporium"
	},
/turf/open/indestructible/boss,
/area/template_noop)
"gi" = (
/obj/effect/decal/cleanable/dirt,
/obj/structure/railing{
	dir = 4
	},
/obj/structure/ore_box,
/turf/open/floor/plating/lavaland_atmos,
/area/template_noop)
"gj" = (
/obj/structure/cable,
/obj/machinery/power/apc/auto_name/directional/north{
	cell_type = null
	},
/obj/effect/decal/cleanable/dirt,
/turf/open/floor/plating/lavaland_atmos,
/area/template_noop)
"gn" = (
/obj/machinery/door/airlock/external/glass{
	name = "Mining External Airlock"
	},
/obj/effect/mapping_helpers/airlock/cyclelink_helper{
	dir = 1
	},
/obj/effect/mapping_helpers/airlock/access/all/away/general,
/obj/effect/decal/cleanable/dirt,
/turf/open/floor/plating,
/area/template_noop)
"gv" = (
/obj/structure/lattice/lava{
	base_icon_state = "lattice";
	icon = 'icons/obj/smooth_structures/lattice.dmi';
	icon_state = "lattice-255"
	},
/obj/structure/railing{
	dir = 8
	},
/turf/open/lava/smooth/lava_land_surface,
/area/template_noop)
"gw" = (
/obj/machinery/computer/pod/old/mass_driver_controller{
	id = "caveslvl3garbage";
	name = "Garbage Disposal Control";
	pixel_x = 28
	},
/obj/machinery/conveyor_switch/oneway{
	id = "caveslvl3garbage"
	},
/obj/effect/decal/cleanable/dirt,
/turf/open/floor/iron{
	initial_gas_mix = "LAVALAND_ATMOS"
	},
/area/template_noop)
"gE" = (
/obj/machinery/door/poddoor/preopen{
	id = "caveslvl3garbage";
	name = "Garbage Disposal"
	},
/obj/machinery/conveyor{
	dir = 4;
	id = "caveslvl3garbage"
	},
/obj/effect/decal/cleanable/dirt,
/turf/open/floor/plating/lavaland_atmos,
/area/template_noop)
"hh" = (
/obj/structure/girder,
/obj/effect/decal/cleanable/dirt,
/obj/item/stack/sheet/iron,
/turf/open/floor/plating/lavaland_atmos,
/area/template_noop)
"hH" = (
/obj/structure/fluff/clockwork/clockgolem_remains,
/obj/effect/decal/cleanable/dirt,
/mob/living/simple_animal/hostile/clockwork/cogscarab,
/turf/open/floor/bronze/filled/lavaland,
/area/template_noop)
"ic" = (
/obj/structure/fluff/clockwork/alloy_shards,
/obj/effect/decal/cleanable/dirt,
/turf/open/floor/bronze/filled/lavaland,
/area/template_noop)
"iC" = (
/obj/effect/decal/cleanable/dirt,
/obj/structure/railing{
	dir = 4
	},
/turf/open/floor/plating/lavaland_atmos,
/area/template_noop)
"jf" = (
/obj/structure/spawner/lavaland/goliath,
/turf/open/indestructible/necropolis,
/area/template_noop)
"jC" = (
/obj/effect/spawner/random/trash/food_packaging,
/turf/open/misc/asteroid/basalt/lava_land_surface,
/area/template_noop)
"ke" = (
/obj/structure/railing,
/turf/open/misc/asteroid/basalt/lava_land_surface,
/area/template_noop)
"la" = (
/obj/structure/sign/warning{
	name = "NEEDS AREA"
	},
/turf/open/misc/asteroid/basalt/lava_land_surface,
/area/template_noop)
"lj" = (
/obj/effect/decal/cleanable/dirt,
/turf/open/floor/iron{
	initial_gas_mix = "LAVALAND_ATMOS"
	},
/area/template_noop)
"mb" = (
/obj/structure/barricade/sandbags,
/obj/effect/decal/cleanable/dirt,
/turf/open/floor/bronze/filled/lavaland,
/area/template_noop)
"mj" = (
/obj/effect/decal/cleanable/dirt,
/mob/living/simple_animal/hostile/clockwork,
/turf/open/floor/bronze/filled/lavaland,
/area/template_noop)
"ml" = (
/turf/closed/wall/rust,
/area/template_noop)
"mr" = (
/obj/structure/marker_beacon/burgundy,
/turf/open/misc/asteroid/basalt/lava_land_surface,
/area/template_noop)
"mK" = (
/obj/effect/decal/cleanable/dirt,
/turf/open/floor/bronze/filled/lavaland,
/area/template_noop)
"os" = (
/obj/structure/spawner/lavaland/goliath,
/obj/effect/gibspawner/human/bodypartless,
/turf/open/indestructible/necropolis,
/area/template_noop)
"ow" = (
/obj/structure/stone_tile/surrounding,
/obj/structure/stone_tile/center,
/turf/open/indestructible/boss,
/area/template_noop)
"pk" = (
/turf/closed/indestructible/riveted/boss,
/area/template_noop)
"pn" = (
/obj/structure/girder,
/obj/effect/decal/cleanable/dirt,
/turf/open/floor/plating/lavaland_atmos,
/area/template_noop)
"pt" = (
/obj/structure/flora/ash/tall_shroom,
/obj/effect/decal/cleanable/dirt,
/turf/open/floor/bronze/filled/lavaland,
/area/template_noop)
"pC" = (
/obj/machinery/mass_driver{
	dir = 4;
	id = "caveslvl3garbage"
	},
/obj/item/stock_parts/cell/empty,
/obj/effect/decal/cleanable/dirt,
/turf/open/floor/plating/lavaland_atmos,
/area/template_noop)
"pF" = (
/obj/structure/flora/rock,
/obj/effect/decal/cleanable/dirt,
/turf/open/floor/bronze/filled/lavaland,
/area/template_noop)
"qu" = (
/obj/structure/fluff/clockwork/fallen_armor,
/turf/open/misc/asteroid/basalt/lava_land_surface,
/area/template_noop)
"qA" = (
/obj/machinery/power/rtg,
/obj/structure/cable,
/turf/open/floor/plating,
/area/template_noop)
"qZ" = (
/obj/structure/flora/rock/pile,
/turf/open/misc/asteroid/basalt/lava_land_surface,
/area/template_noop)
"rx" = (
/obj/effect/decal/cleanable/dirt,
/obj/structure/table,
/turf/open/floor/iron{
	initial_gas_mix = "LAVALAND_ATMOS"
	},
/area/template_noop)
"rE" = (
/obj/effect/decal/cleanable/dirt,
/turf/open/floor/plating/lavaland_atmos,
/area/template_noop)
"sA" = (
/obj/effect/decal/cleanable/dirt,
/obj/item/stack/sheet/iron,
/turf/open/floor/plating/lavaland_atmos,
/area/template_noop)
"vd" = (
/turf/closed/wall,
/area/template_noop)
"vx" = (
/obj/effect/decal/cleanable/dirt,
/obj/structure/table_frame,
/obj/item/stack/rods,
/turf/open/floor/plating/lavaland_atmos,
/area/template_noop)
"wr" = (
/obj/structure/lattice/lava{
	base_icon_state = "lattice";
	icon = 'icons/obj/smooth_structures/lattice.dmi';
	icon_state = "lattice-255"
	},
/turf/open/lava/smooth/lava_land_surface,
/area/template_noop)
"xA" = (
/obj/effect/decal/cleanable/dirt,
/mob/living/simple_animal/hostile/clockwork/cogscarab,
/turf/open/floor/bronze/filled/lavaland,
/area/template_noop)
"xX" = (
/obj/structure/lattice/lava{
	base_icon_state = "lattice";
	icon = 'icons/obj/smooth_structures/lattice.dmi';
	icon_state = "lattice-255"
	},
/obj/structure/railing{
	dir = 4
	},
/turf/open/lava/smooth/lava_land_surface,
/area/template_noop)
"yr" = (
/obj/structure/flora/rock/pile,
/obj/effect/decal/cleanable/dirt,
/turf/open/floor/bronze/filled/lavaland,
/area/template_noop)
"yv" = (
/obj/structure/railing{
	dir = 4
	},
/obj/structure/closet/crate,
/turf/open/misc/asteroid/basalt/lava_land_surface,
/area/template_noop)
"Ag" = (
/obj/structure/flora/ash/tall_shroom,
/turf/open/misc/asteroid/basalt/lava_land_surface,
/area/template_noop)
"BN" = (
/obj/structure/flora/ash/cap_shroom,
/turf/open/misc/asteroid/basalt/lava_land_surface,
/area/template_noop)
"DT" = (
/obj/structure/flora/ash/seraka,
/turf/open/misc/asteroid/basalt/lava_land_surface,
/area/template_noop)
"EW" = (
/obj/effect/decal/cleanable/dirt,
/turf/open/floor/bronze/flat/lavaland,
/area/template_noop)
"Fh" = (
/turf/closed/indestructible/necropolis,
/area/template_noop)
"FL" = (
/obj/structure/railing{
	dir = 1
	},
/obj/structure/flora/rock/pile,
/turf/open/misc/asteroid/basalt/lava_land_surface,
/area/template_noop)
"Gd" = (
/obj/effect/decal/cleanable/dirt,
/turf/open/floor/plating,
/area/template_noop)
"Gx" = (
/obj/structure/flora/ash/cacti,
/turf/open/misc/asteroid/basalt/lava_land_surface,
/area/template_noop)
"GZ" = (
/obj/effect/baseturf_helper/lava_land/surface,
/turf/closed/indestructible/rock,
/area/template_noop)
"Hq" = (
/obj/effect/turf_decal/stripes/box,
/obj/effect/decal/cleanable/dirt,
/turf/open/floor/plating/lavaland_atmos,
/area/template_noop)
"HJ" = (
/turf/closed/wall/mineral/bronze,
/area/template_noop)
"HK" = (
/obj/effect/spawner/structure/window/reinforced,
/obj/structure/cable,
/turf/open/floor/plating,
/area/template_noop)
"Iz" = (
/obj/structure/lattice/lava{
	base_icon_state = "lattice";
	icon = 'icons/obj/smooth_structures/lattice.dmi';
	icon_state = "lattice-255"
	},
/obj/structure/railing{
	dir = 1
	},
/turf/open/lava/smooth/lava_land_surface,
/area/template_noop)
"Kd" = (
/obj/structure/lattice/lava{
	base_icon_state = "lattice";
	icon = 'icons/obj/smooth_structures/lattice.dmi';
	icon_state = "lattice-255"
	},
/obj/structure/railing,
/turf/open/lava/smooth/lava_land_surface,
/area/template_noop)
"Lf" = (
/obj/structure/cable,
/obj/effect/decal/cleanable/dirt,
/turf/open/floor/plating/lavaland_atmos,
/area/template_noop)
"LQ" = (
/obj/effect/decal/cleanable/dirt,
/mob/living/simple_animal/hostile/clockwork/ocular_warden,
/turf/open/floor/bronze/flat/lavaland,
/area/template_noop)
"Nd" = (
/obj/item/food/grown/banana{
	desc = "shh... its a secret. 5 of 6.";
	name = "secret banana"
	},
/turf/open/misc/asteroid/basalt/lava_land_surface,
/area/template_noop)
"Nj" = (
/obj/machinery/conveyor{
	dir = 4;
	id = "caveslvl3garbage"
	},
/obj/effect/decal/cleanable/dirt,
/turf/open/floor/plating/lavaland_atmos,
/area/template_noop)
"Rl" = (
/turf/open/indestructible/necropolis,
/area/template_noop)
"RG" = (
/obj/structure/flora/ash/leaf_shroom,
/turf/open/misc/asteroid/basalt/lava_land_surface,
/area/template_noop)
"Sd" = (
/turf/closed/mineral/random/volcanic/lava_land_surface/hardened/high_chance,
/area/template_noop)
"Si" = (
/obj/effect/decal/cleanable/dirt,
/obj/item/stack/tile/iron,
/turf/open/floor/plating/lavaland_atmos,
/area/template_noop)
"Su" = (
/obj/structure/railing/corner,
/obj/structure/flora/ash/cacti,
/turf/open/misc/asteroid/basalt/lava_land_surface,
/area/template_noop)
"SD" = (
/obj/effect/decal/cleanable/dirt,
/obj/structure/closet/emcloset,
/obj/machinery/light/small/directional/east,
/turf/open/floor/plating,
/area/template_noop)
"Tr" = (
/mob/living/simple_animal/hostile/asteroid/brimdemon,
/turf/open/indestructible/necropolis,
/area/template_noop)
"Vt" = (
/obj/machinery/door/poddoor{
	id = "caveslvl3garbage";
	name = "Garbage Disposal"
	},
/turf/open/floor/plating/lavaland_atmos,
/area/template_noop)
"VK" = (
/obj/structure/railing/corner{
	dir = 4
	},
/obj/structure/flora/rock,
/turf/open/misc/asteroid/basalt/lava_land_surface,
/area/template_noop)
"VV" = (
/obj/effect/mine/explosive{
	range_heavy = 0
	},
/turf/open/misc/asteroid/basalt/lava_land_surface,
/area/template_noop)
"Wa" = (
/obj/effect/decal/cleanable/dirt,
/obj/structure/railing{
	dir = 4
	},
/obj/effect/turf_decal/stripes/box,
/turf/open/floor/plating/lavaland_atmos,
/area/template_noop)
"WJ" = (
/obj/effect/mine/explosive{
	range_heavy = 0
	},
/obj/effect/decal/cleanable/dirt,
/turf/open/floor/bronze/filled/lavaland,
/area/template_noop)
"Yu" = (
/obj/machinery/door/airlock/external/glass{
	name = "Mining External Airlock"
	},
/obj/effect/mapping_helpers/airlock/cyclelink_helper,
/obj/effect/mapping_helpers/airlock/access/all/away/general,
/obj/effect/decal/cleanable/dirt,
/turf/open/floor/plating,
/area/template_noop)
"YH" = (
/obj/effect/spawner/structure/window/reinforced,
/turf/open/floor/plating,
/area/template_noop)
"YT" = (
/obj/structure/railing{
	dir = 6
	},
/turf/open/misc/asteroid/basalt/lava_land_surface,
/area/template_noop)
"Zl" = (
/obj/structure/flora/rock/pile,
/obj/effect/mine/explosive{
	range_heavy = 0
	},
/obj/effect/decal/cleanable/dirt,
/turf/open/floor/bronze/filled/lavaland,
/area/template_noop)

(1,1,1) = {"
GZ
ar
ar
ar
ar
ar
ar
ar
ar
ar
ar
ar
ar
ar
ar
ar
ar
ar
ar
ar
ar
ar
ar
ar
ar
ar
ar
ar
ar
ar
ar
"}
(2,1,1) = {"
ar
Sd
Sd
Sd
Sd
Sd
Sd
Sd
Sd
Sd
Sd
Sd
Sd
Sd
Sd
Sd
Sd
Sd
Sd
aA
qZ
qZ
aS
qZ
Sd
Sd
Sd
Sd
Sd
Sd
ar
"}
(3,1,1) = {"
ar
Sd
Sd
Sd
Sd
Sd
qZ
qZ
qZ
qZ
aA
aA
aA
aA
aA
Sd
aA
aA
aA
aA
qZ
qZ
qZ
qZ
RG
aA
aA
Sd
Sd
Sd
ar
"}
(4,1,1) = {"
ar
Sd
Sd
Sd
Sd
Sd
qZ
aS
aA
aA
aA
qZ
aA
aA
aA
aA
aA
aA
aA
aA
RG
qZ
qZ
aA
aA
aA
aA
Sd
Sd
Sd
ar
"}
(5,1,1) = {"
ar
Sd
Sd
Sd
Sd
Sd
aA
aA
aA
aA
Sd
Sd
Sd
Sd
Sd
aA
aA
aA
Sd
Sd
Sd
Sd
aA
aA
aA
aA
aA
Sd
Sd
Sd
ar
"}
(6,1,1) = {"
ar
Sd
Sd
Sd
Sd
Sd
Sd
Sd
Sd
Sd
Sd
Sd
Sd
Sd
aA
aA
aA
aA
aA
qZ
qZ
Sd
Sd
Sd
aA
aA
RG
Sd
Sd
Sd
ar
"}
(7,1,1) = {"
ar
Sd
Sd
Sd
Sd
Sd
Sd
Sd
Sd
Sd
aA
qZ
aA
aA
aA
aA
aA
aA
qZ
qZ
aS
qZ
Sd
Sd
aA
qZ
RG
RG
Sd
Sd
ar
"}
(8,1,1) = {"
ar
Sd
Sd
Sd
Sd
Sd
Sd
Sd
Sd
Sd
aA
aA
aA
aA
aA
aA
aa
aa
aa
aa
Sd
Sd
Sd
Sd
Sd
aS
qZ
aA
Sd
Sd
ar
"}
(9,1,1) = {"
aA
aA
aA
qZ
qZ
Sd
Sd
Sd
Sd
aA
aA
aA
aA
aA
qZ
qZ
aa
aa
aa
aa
aa
aa
Sd
Sd
Sd
qZ
qZ
qZ
Sd
Sd
ar
"}
(10,1,1) = {"
aA
aA
aA
qZ
aS
qZ
qZ
aA
aA
aA
aA
qZ
vd
vd
ml
vd
ml
ml
aa
aa
Sd
Sd
Sd
Sd
Sd
Sd
qZ
aA
Sd
Sd
ar
"}
(11,1,1) = {"
aD
aA
aA
qZ
qZ
qZ
aA
aA
aA
aA
ml
ml
ml
lj
rx
vx
rE
ml
vd
vd
ml
aa
Sd
Sd
Sd
Sd
Sd
aA
Sd
Sd
ar
"}
(12,1,1) = {"
aA
aA
aA
aA
aA
aA
aA
aA
aA
aA
Yu
Gd
gn
lj
rE
rE
wr
pn
sA
rE
ml
vd
vd
Sd
Sd
Sd
Sd
aA
Sd
Sd
ar
"}
(13,1,1) = {"
aA
aA
aA
aA
aA
aA
aA
aA
aA
aA
ml
SD
vd
gj
Lf
wr
wr
wr
wr
wr
HK
qA
ml
Sd
Sd
Sd
Sd
aA
Sd
Sd
ar
"}
(14,1,1) = {"
aA
aA
qZ
qZ
aA
aA
aA
aA
aA
aA
ml
ml
vd
rE
Si
bn
wr
wr
aa
aa
ml
ml
ml
Sd
Sd
Sd
Sd
Sd
Sd
Sd
ar
"}
(15,1,1) = {"
ar
Sd
Sd
Sd
Sd
qZ
aA
aA
aA
aA
la
aA
hh
lj
lj
rE
rE
wr
aa
wr
pn
aa
Sd
Sd
Sd
Sd
Sd
Sd
Sd
Sd
ar
"}
(16,1,1) = {"
ar
Sd
Sd
Sd
Sd
VK
qZ
rE
aA
aA
Gx
Gx
sA
Si
lj
gw
Nj
rE
aa
aa
aa
aa
Sd
Sd
Sd
aa
aa
aa
Sd
Sd
ar
"}
(17,1,1) = {"
ar
Sd
Sd
Sd
vd
FL
qZ
rE
aA
aA
rE
Su
vd
YH
YH
vd
gE
pn
aa
aa
aa
aa
aa
aa
aa
aa
aa
aa
Sd
Sd
ar
"}
(18,1,1) = {"
ar
Sd
Sd
Sd
Hq
aA
Wa
gi
gi
yv
iC
YT
wr
wr
wr
vd
pC
vd
aa
aa
aa
aa
aa
aa
aa
aa
aa
aa
aa
Sd
ar
"}
(19,1,1) = {"
ar
Sd
Sd
Sd
mr
rE
Iz
aa
aa
aa
aa
aa
aa
wr
aa
vd
Vt
vd
aa
aa
aa
aa
Sd
Sd
aa
aa
aa
aa
aa
Sd
ar
"}
(20,1,1) = {"
ar
Sd
Sd
aA
aA
rE
Iz
aa
aa
aa
aa
aa
aa
aa
aa
aa
aa
aa
aa
aa
aA
qZ
qZ
Sd
Sd
Sd
Sd
aa
aa
Sd
ar
"}
(21,1,1) = {"
ar
Sd
Sd
aA
Ag
rE
Iz
aa
aa
aa
aa
aa
aa
aa
aa
aa
aa
aa
aa
aa
qZ
aS
qZ
aA
aA
aA
Sd
aa
aa
Sd
ar
"}
(22,1,1) = {"
ar
Sd
Sd
aA
aA
rE
Iz
aa
aa
aa
aa
aa
aa
aa
aa
aa
aa
aa
aA
aA
qZ
Sd
Sd
qZ
aA
aA
Sd
aa
aa
Sd
ar
"}
(23,1,1) = {"
ar
Sd
aA
Ag
aA
rE
Iz
aa
aa
aa
aa
aa
aa
aa
aa
aa
aa
aa
aA
Sd
Sd
Sd
Sd
aa
aA
aA
Sd
aa
aa
Sd
ar
"}
(24,1,1) = {"
ar
Sd
aA
aA
Kd
wr
aa
aa
aa
aa
aa
aa
aa
aa
aa
aa
aa
aa
aa
aa
aa
aa
aa
aa
aa
aA
Sd
aa
aa
Sd
ar
"}
(25,1,1) = {"
ar
Sd
Sd
aA
aa
aa
aa
aa
aa
aa
aa
aa
aa
aa
aa
aa
aa
aa
aa
aa
aa
aa
aa
aa
aa
aA
Sd
aa
aa
Sd
ar
"}
(26,1,1) = {"
ar
Sd
Sd
aA
aa
aa
aa
aa
aa
aa
aa
aa
aa
aa
aa
aa
aa
aa
aa
aa
aa
aa
aa
aa
aa
aA
aa
aa
aa
Sd
ar
"}
(27,1,1) = {"
ar
Sd
Sd
aA
aa
aa
aa
aa
aa
aa
aa
aa
aa
aa
aa
aa
aa
aa
aa
aa
aa
aa
aa
aa
aa
aa
aa
aa
aa
Sd
ar
"}
(28,1,1) = {"
ar
Sd
Sd
aA
aa
aa
aa
aa
aa
aa
aa
aa
aa
aa
aa
aa
aa
aa
aa
aa
aa
aa
aa
aa
aa
aa
aa
aa
aa
Sd
ar
"}
(29,1,1) = {"
ar
Sd
Sd
Sd
aa
aa
aa
aa
aa
aa
aa
aa
aa
aa
aa
aa
aa
aa
aa
aa
aa
aa
aa
aa
aa
aa
aa
Sd
Sd
Sd
ar
"}
(30,1,1) = {"
ar
Sd
Sd
Sd
aa
wr
aa
aa
aa
aa
aa
aa
aa
aa
aa
aa
aa
aa
aa
aa
aa
aa
aa
aa
aa
Sd
Sd
Sd
Sd
Sd
ar
"}
(31,1,1) = {"
ar
Sd
Sd
Sd
Kd
wr
aa
aa
aa
aa
aa
aa
aa
aa
aa
aa
aa
aa
aa
aa
aa
aa
aa
aa
aa
Sd
Sd
Sd
Sd
Sd
ar
"}
(32,1,1) = {"
ar
Sd
Sd
Sd
Kd
rE
aa
aa
aa
aa
aa
aa
aa
aa
aa
aa
aA
aA
aA
jC
aA
qZ
Sd
Sd
Sd
Sd
Sd
Sd
Sd
Sd
ar
"}
(33,1,1) = {"
ar
Sd
Sd
Sd
ke
rE
Iz
aa
aa
aa
aa
aa
aa
aa
aa
Sd
jC
jC
aA
aA
qZ
qZ
aS
qZ
qZ
Sd
Sd
Sd
Sd
Sd
ar
"}
(34,1,1) = {"
ar
Sd
Sd
Sd
ke
rE
Iz
aa
aa
aa
aa
aa
aa
aa
aa
Sd
Sd
Sd
aA
aa
aa
qZ
qZ
qZ
aA
Sd
Sd
Sd
Sd
Sd
ar
"}
(35,1,1) = {"
ar
Sd
Sd
Sd
Hq
aA
Hq
aA
xX
aa
xX
xX
Hq
aa
aa
Sd
Sd
aa
aa
aa
aa
aa
aa
aA
aA
aA
aA
Sd
Sd
Sd
ar
"}
(36,1,1) = {"
ar
Sd
Sd
Sd
mr
aA
aA
rE
aa
aa
rE
rE
aA
aA
aa
aa
aa
aa
aa
aA
aa
aa
aa
aa
aA
aA
aA
Sd
Sd
Sd
ar
"}
(37,1,1) = {"
ar
Sd
Sd
Sd
aA
aa
Hq
gv
aa
gv
gv
gv
Hq
aA
aa
aa
aa
aa
aA
aA
aa
aa
aa
aa
aa
aA
aA
Sd
Sd
Sd
ar
"}
(38,1,1) = {"
ar
Sd
Sd
Sd
Sd
aa
aa
aa
aa
aa
aa
aa
aA
aA
aa
aa
aa
aA
qZ
aA
aA
aA
aa
aa
aa
aA
aA
Sd
Sd
Sd
ar
"}
(39,1,1) = {"
ar
Sd
Sd
Sd
Sd
Sd
Sd
Sd
Sd
aa
aA
aA
qZ
mr
aa
aa
aa
aA
qZ
qZ
aa
aa
aa
aa
Sd
aA
aA
Sd
Sd
Sd
ar
"}
(40,1,1) = {"
ar
Sd
Sd
Sd
Sd
Sd
aa
aa
aa
aa
aa
aa
aA
aA
aa
aa
aa
aa
aA
aA
aa
aa
aa
aa
Sd
Sd
aA
qZ
Sd
Sd
ar
"}
(41,1,1) = {"
ar
Sd
Sd
Sd
aa
aa
aa
aa
aa
aa
aa
aa
aA
Ag
aa
aa
aa
aa
aa
aa
aa
aa
aa
aa
Sd
Sd
aA
aA
aj
Sd
ar
"}
(42,1,1) = {"
ar
Sd
Sd
Sd
aa
aa
aa
aa
aa
aa
aa
aA
aA
qZ
aA
aa
aa
aa
aa
aa
aa
aa
aa
aa
Sd
Sd
qZ
aA
aj
Sd
ar
"}
(43,1,1) = {"
ar
Sd
Sd
Sd
Sd
aa
aa
aa
aa
aa
aa
aA
Sd
qZ
qZ
aa
aa
aa
aa
aa
aa
aa
aa
aa
Sd
Sd
qZ
aA
aj
Sd
ar
"}
(44,1,1) = {"
ar
Sd
Sd
Sd
Sd
aa
aa
aa
aa
aa
aa
aA
Sd
aS
qZ
aA
aa
aa
aa
aa
aa
aa
aa
aa
Sd
aS
qZ
aj
aj
Sd
ar
"}
(45,1,1) = {"
ar
Sd
Sd
aA
Sd
Sd
aa
aa
aa
aa
aa
Ag
Sd
Sd
qZ
Ag
aa
aa
aa
aa
aa
aa
aa
aa
qZ
qZ
qZ
aj
aj
Sd
ar
"}
(46,1,1) = {"
ar
Sd
Sd
aA
Sd
Sd
aa
aa
aa
aA
aA
aA
Sd
Sd
Sd
Ag
aA
aa
aa
aa
aa
aa
aa
aa
aA
qZ
aA
aj
aj
aj
ar
"}
(47,1,1) = {"
ar
Sd
aA
qZ
aA
Sd
Sd
aa
aa
aA
aA
qZ
Sd
Sd
Sd
aA
aA
Hq
xX
aa
aa
aa
xX
Hq
aA
aA
aj
aj
aj
aj
ar
"}
(48,1,1) = {"
ar
Sd
aA
qZ
qZ
Sd
Sd
aa
aa
aa
aa
qZ
aS
Sd
Sd
Sd
aA
aA
rE
aa
aa
aa
rE
aA
Ag
aA
aj
aj
aj
aj
ar
"}
(49,1,1) = {"
ar
Sd
qZ
aS
qZ
Sd
Sd
Sd
Sd
aa
aa
qZ
qZ
Sd
Sd
aA
mr
Hq
gv
gv
aa
gv
gv
Hq
aA
aA
aj
aj
aj
aj
ar
"}
(50,1,1) = {"
ar
aA
qZ
qZ
qZ
Sd
Sd
aa
aa
aa
aa
aa
qZ
aA
qZ
aA
aa
aa
aa
aa
aa
aa
aa
aA
aA
Ag
aj
aj
aj
aj
ar
"}
(51,1,1) = {"
ar
aA
aA
BN
aA
Sd
aa
aa
aa
aa
aa
aa
aA
aA
aA
aA
aa
aa
aa
aa
aa
aa
aa
qZ
aA
aA
aA
aj
aj
Sd
ar
"}
(52,1,1) = {"
ar
aA
aA
aA
Sd
Sd
aa
aa
aa
aa
aa
aa
aa
aA
aA
aA
aa
aa
aa
aa
aa
aa
aa
qZ
mr
Ag
aA
aj
aj
Sd
ar
"}
(53,1,1) = {"
ar
BN
aA
Sd
Sd
aa
aa
aa
aa
aa
aa
aA
aA
aA
aA
aa
aa
aa
aa
aa
aa
aa
aa
aa
aA
aA
qZ
aA
Sd
Sd
ar
"}
(54,1,1) = {"
ar
aA
aA
qZ
Sd
aa
aa
aa
aa
aa
aa
aa
aa
qZ
aA
aa
aa
aa
aa
aa
aa
aa
aa
aa
Ag
aA
qZ
aA
Sd
Sd
ar
"}
(55,1,1) = {"
ar
aA
aA
aA
Sd
aa
aa
aa
aa
aA
aA
aA
aA
aA
aa
aa
aa
aa
aa
aa
aa
aa
aa
aa
aA
qZ
aS
qZ
Sd
Sd
ar
"}
(56,1,1) = {"
ar
qZ
aA
aA
Sd
aa
aa
aA
aA
aA
aA
aa
aa
aa
aa
aa
aa
aa
aa
aa
aa
aa
aa
aa
aA
qZ
qZ
qZ
Sd
Sd
ar
"}
(57,1,1) = {"
ar
qZ
BN
aA
aA
aa
aa
aA
aA
aA
aa
aa
aa
aa
aa
aa
aa
aa
aa
aA
aA
aa
aa
aa
aa
qZ
aA
aA
Sd
Sd
ar
"}
(58,1,1) = {"
ar
qZ
qZ
aA
aA
aA
aA
aA
aA
aa
aa
aa
aa
aa
aa
aa
aa
aA
aA
aA
aA
aa
aa
aa
aa
qZ
aA
aA
Sd
Sd
ar
"}
(59,1,1) = {"
ar
aS
qZ
BN
aA
aA
aA
qZ
qZ
aa
aa
aa
aa
aa
aa
aa
aA
aA
aa
qZ
aA
aa
aa
aa
aa
aA
aA
VV
Sd
Sd
ar
"}
(60,1,1) = {"
ar
qZ
qZ
BN
aA
aa
aa
aa
aa
aa
aa
aa
aa
aa
aa
aa
aa
aa
aa
aa
aa
aa
aa
aa
aa
aA
aA
qZ
Sd
Sd
ar
"}
(61,1,1) = {"
ar
qZ
BN
qZ
qZ
aa
aa
aa
aa
aa
aa
aa
aa
aa
aa
aa
aa
aa
aa
aa
aa
aa
aa
aa
aa
aA
aA
qZ
Sd
Sd
ar
"}
(62,1,1) = {"
ar
Sd
aA
qZ
aS
aa
aa
aa
aa
aa
aa
aa
aa
aa
aa
aa
aa
aa
aa
aa
aa
aa
aa
aa
aa
Sd
aA
aA
qZ
Sd
ar
"}
(63,1,1) = {"
ar
Sd
aA
qZ
qZ
aa
aa
aa
aa
aa
aa
aa
aa
aa
aa
aa
aa
aa
aa
aa
aa
aa
aa
aa
aa
Sd
VV
qZ
aS
Sd
ar
"}
(64,1,1) = {"
ar
Sd
Sd
aA
qZ
Sd
Sd
aa
aa
aa
aa
aa
aa
aA
aA
aA
aa
aa
aa
aa
aa
aa
aa
Sd
Sd
Sd
Sd
aA
qZ
Sd
ar
"}
(65,1,1) = {"
ar
Sd
Sd
aA
aA
Sd
Sd
Sd
Sd
Sd
Sd
aa
aa
aA
aA
qZ
aA
aa
aa
aa
aa
aa
aa
aa
Sd
Sd
Sd
aA
qZ
Sd
ar
"}
(66,1,1) = {"
ar
Sd
Sd
Sd
Sd
aa
aa
aa
aa
aa
aa
aa
aa
DT
Sd
Sd
aA
aa
aa
aa
Sd
Sd
Sd
Sd
Sd
Sd
Sd
aA
aA
Sd
ar
"}
(67,1,1) = {"
ar
Sd
Sd
Sd
aa
aa
aa
aa
aa
aa
aa
qZ
aA
DT
Sd
Sd
aA
aa
aa
aa
aa
aa
Sd
Sd
Sd
Sd
Sd
aA
aA
Sd
ar
"}
(68,1,1) = {"
ar
Sd
Sd
Sd
aa
aa
aa
aA
aa
aa
aA
qZ
DT
Sd
Sd
Sd
aA
aA
aa
aa
aa
aa
aa
Sd
Sd
Sd
Sd
Sd
aA
aA
ar
"}
(69,1,1) = {"
ar
Sd
Sd
Sd
aa
aa
aa
aA
aA
aa
qZ
aS
qZ
DT
Sd
DT
aA
aA
aA
aA
aa
aa
aa
aa
Sd
Sd
Sd
Sd
aA
aA
ar
"}
(70,1,1) = {"
ar
Sd
Sd
Sd
aa
aa
aa
aA
aa
aa
qZ
qZ
DT
DT
aA
aA
aA
aa
aa
aa
aa
aa
aa
aa
Sd
Sd
Sd
Sd
Ag
aA
ar
"}
(71,1,1) = {"
ar
Sd
Sd
Sd
aa
aa
aa
aa
aa
aa
aa
aA
aA
aA
aa
aa
aa
aa
aa
aa
aa
aa
aa
aa
aA
Sd
Sd
Sd
aA
aA
ar
"}
(72,1,1) = {"
ar
Sd
Sd
Sd
aa
aa
aa
aa
aa
aa
aa
aa
aa
aa
aa
aa
aa
aa
aa
aa
aa
aa
aa
aA
aA
Sd
Sd
Sd
aA
aA
ar
"}
(73,1,1) = {"
ar
Sd
Sd
Sd
aa
aa
aa
aa
aa
aa
aa
aa
aa
aa
aa
aa
aa
aa
aa
aa
aa
aa
aa
aA
aA
Sd
ag
aA
aA
aA
ar
"}
(74,1,1) = {"
ar
Sd
Sd
Sd
aa
aa
aA
aa
aa
aa
aa
aa
aa
aa
aa
aa
aA
aa
aa
aa
aa
aa
aa
aA
aA
Sd
ag
aA
aA
aA
ar
"}
(75,1,1) = {"
ar
Sd
Sd
aa
aa
aa
aA
aA
aa
aa
aa
aa
aa
aa
aA
aA
aA
aA
aa
aa
aa
aa
aa
aA
aA
Sd
aA
qZ
Ag
aA
ar
"}
(76,1,1) = {"
ar
Sd
Sd
aa
aa
aa
aA
aA
aa
aa
aa
aa
aa
aa
aa
aA
qZ
aA
aA
aa
aa
aa
aa
aA
Fh
Fh
aS
qZ
aA
Sd
ar
"}
(77,1,1) = {"
ar
Sd
Sd
aa
aa
aa
aa
aa
aa
aa
aa
aa
aa
aa
aa
aA
aA
aA
aa
aa
aa
aa
aa
aA
ag
Rl
qZ
aA
aA
Sd
ar
"}
(78,1,1) = {"
ar
Sd
Sd
aa
aa
aa
aa
aa
aa
aa
aa
aa
aa
aa
aa
aa
aA
aa
aa
aa
aa
aa
aa
aA
Rl
Rl
Rl
Fh
Sd
Sd
ar
"}
(79,1,1) = {"
ar
Sd
aA
aa
aa
aa
aa
aa
aa
aA
aa
aa
aa
aa
aa
aa
aa
aa
aa
aa
aa
aa
aA
aA
Rl
Rl
Rl
Fh
Fh
Sd
ar
"}
(80,1,1) = {"
ar
Sd
aA
aa
aa
aa
aa
aa
aa
aA
aA
aa
aa
aa
aa
aa
aa
aa
aa
aa
aa
aa
aA
Rl
Rl
Rl
Rl
em
Fh
Sd
ar
"}
(81,1,1) = {"
ar
Sd
aA
aa
aa
aa
aa
aa
aA
aA
aA
aa
aa
aa
aa
aa
aa
aa
aa
aa
aa
aa
aA
Rl
Rl
Rl
jf
Rl
Fh
Fh
Fh
"}
(82,1,1) = {"
ar
Sd
aA
aa
aa
aa
aa
aa
aA
aA
aA
Gx
aa
aa
aA
aa
aa
aA
qZ
aA
aA
aA
aA
Rl
Rl
Rl
Rl
Rl
Rl
Rl
Fh
"}
(83,1,1) = {"
ar
Sd
aA
aa
aa
aa
aa
aA
aA
aA
Gx
Gx
Gx
Gx
aA
aA
aA
aA
aA
aA
aA
Rl
Rl
Rl
Rl
Rl
Rl
Rl
Rl
Fh
Fh
"}
(84,1,1) = {"
ar
Sd
aA
aA
aa
aa
aA
aA
qZ
qZ
qZ
Gx
aA
aA
aA
aa
aa
aa
aa
aA
Fh
Rl
Rl
Rl
Rl
Tr
Rl
Rl
Rl
Rl
Fh
"}
(85,1,1) = {"
ar
Sd
aA
aA
aa
aa
aa
aA
qZ
aS
qZ
aa
aa
aa
aa
aa
aa
aa
aa
aa
Fh
Fh
Fh
jf
Rl
em
Rl
Fh
Fh
Fh
Fh
"}
(86,1,1) = {"
ar
Sd
aA
aA
aa
aa
aA
aA
qZ
qZ
aa
aa
aa
aa
aa
aa
aa
aa
aa
aa
aa
aa
aA
Rl
Rl
Fh
Rl
Fh
Sd
Sd
ar
"}
(87,1,1) = {"
ar
Sd
aA
aA
aa
aA
aA
aA
aA
qZ
aa
aa
aa
aa
aa
aa
aa
aa
aa
aa
aa
aa
aA
Rl
Rl
Fh
Rl
Fh
Sd
Sd
ar
"}
(88,1,1) = {"
ar
Sd
aA
aA
aA
aA
aA
aA
aA
aa
aa
aa
aa
aa
aa
aa
aA
aA
aa
aa
aa
aa
aa
Fh
Rl
Fh
Rl
Fh
Sd
Sd
ar
"}
(89,1,1) = {"
ar
Sd
aA
aA
qZ
qZ
aA
aA
aA
aa
aa
aa
aa
aa
aA
qZ
qZ
aA
aa
aa
aa
aa
aa
Fh
Fh
Fh
Rl
Fh
Sd
Sd
ar
"}
(90,1,1) = {"
ar
Sd
Sd
qZ
aS
qZ
qZ
aA
aa
aa
aa
aa
aa
aa
aa
aa
aA
aA
aa
aa
aa
aa
aa
Sd
Sd
Fh
Rl
Fh
Fh
Fh
ar
"}
(91,1,1) = {"
ar
Sd
Sd
aA
qZ
qZ
aA
aA
aa
aa
aa
aa
aa
aa
aa
aa
aa
aa
aa
aa
aa
aa
aa
Sd
Sd
Fh
Rl
Rl
Rl
Fh
ar
"}
(92,1,1) = {"
ar
Sd
Sd
aA
aA
qZ
aA
aA
aa
aa
aa
aa
aa
aa
aa
aa
aa
aa
aa
aa
aa
aa
aa
Sd
Sd
Fh
Rl
Tr
Rl
Fh
ar
"}
(93,1,1) = {"
ar
Sd
Sd
aA
DT
aA
aA
aA
aA
aa
aa
aa
Sd
aA
aA
aa
aa
aa
aa
aa
aa
aa
aa
Sd
Sd
Fh
Fh
Rl
Rl
Fh
ar
"}
(94,1,1) = {"
ar
Sd
Sd
DT
aA
DT
aA
aA
aA
aa
aa
aa
Sd
aA
Sd
aa
aa
aa
aa
aa
Sd
Sd
Sd
pk
pk
pk
Fh
Rl
Rl
Fh
Fh
"}
(95,1,1) = {"
ar
Sd
Sd
Sd
aA
DT
aA
aA
aA
aa
Sd
Sd
Sd
Nd
Sd
aa
aa
Sd
Sd
Sd
Sd
Sd
Sd
pk
ow
fA
Rl
Rl
em
Rl
Fh
"}
(96,1,1) = {"
ar
Sd
Sd
Sd
DT
aA
aA
aA
aa
aa
aa
aa
Sd
Sd
Sd
aa
aa
aa
aa
aa
Sd
Sd
Sd
pk
pk
pk
Fh
Rl
jf
Rl
Fh
"}
(97,1,1) = {"
ar
Sd
Sd
Sd
DT
aA
aA
aa
aa
aa
aa
aa
aa
Sd
aa
aa
aa
aa
aa
aa
aa
aa
aa
Sd
Sd
Sd
Fh
Fh
Rl
Rl
Fh
"}
(98,1,1) = {"
ar
Sd
Sd
Sd
ag
aA
aA
aA
aa
aa
aa
aa
aa
Sd
aa
aa
aa
aa
aa
aa
aa
aa
aa
Sd
Sd
Sd
Sd
Fh
Rl
Rl
Fh
"}
(99,1,1) = {"
ar
Sd
Sd
Sd
Sd
Sd
aA
aA
aa
aa
aa
aa
aa
aa
aa
aa
aa
aa
aa
aa
aa
aa
aa
Sd
Sd
Sd
Fh
Fh
Rl
Rl
Fh
"}
(100,1,1) = {"
ar
Sd
Sd
Sd
Sd
Sd
yr
qZ
aA
aa
aa
aa
aa
aa
aa
aa
aa
aa
aa
aA
aa
aa
aa
aa
aa
aa
Fh
Rl
Rl
Rl
Fh
"}
(101,1,1) = {"
ar
Sd
Sd
Sd
Sd
Sd
aS
yr
aa
aa
aa
aa
aa
aa
aa
aa
aa
aa
aa
aa
aa
aa
aa
aa
aa
aa
Fh
Rl
Rl
Rl
Fh
"}
(102,1,1) = {"
ar
Sd
Sd
Sd
Sd
HJ
qZ
yr
aa
aa
aa
aa
aa
aa
aa
aa
aa
aa
aa
aa
aa
aa
aa
aa
aa
aa
Fh
Rl
Rl
Rl
Fh
"}
(103,1,1) = {"
ar
Sd
Sd
Sd
Sd
Sd
qZ
qZ
aa
aa
aa
aa
aa
aA
aA
aA
aa
aa
aa
aa
aa
aa
aa
aa
Sd
Sd
Fh
Rl
Tr
Rl
Fh
"}
(104,1,1) = {"
ar
Sd
Sd
Sd
Sd
Sd
qZ
aA
aA
aa
aa
aa
aA
mK
aA
aA
qZ
qZ
aa
aa
aa
Sd
Sd
Sd
Sd
Sd
Fh
Rl
Rl
Fh
Fh
"}
(105,1,1) = {"
ar
Sd
Sd
Sd
Sd
Sd
Sd
aA
mK
aA
aA
aa
aa
aA
aA
qZ
qZ
aS
qZ
aa
aa
aa
aa
aa
aa
aa
Fh
Rl
Rl
Fh
ar
"}
(106,1,1) = {"
ar
Sd
Sd
ag
Sd
Sd
Sd
HJ
fl
mK
mK
mK
aA
aA
fl
aA
qZ
qZ
qZ
aa
aa
aa
aa
aa
aa
aa
Fh
os
Rl
Fh
ar
"}
(107,1,1) = {"
ar
Sd
Sd
aA
HJ
Sd
Sd
HJ
mK
mK
mK
Sd
Sd
aA
pt
VV
Ag
aA
aa
aa
aa
aa
aa
aa
Sd
Sd
Fh
Fh
Rl
Fh
ar
"}
(108,1,1) = {"
ar
Sd
HJ
qZ
Sd
Sd
Sd
Sd
HJ
Sd
aa
aa
aa
VV
mK
mK
aA
aA
aa
aa
aa
aa
aa
aa
Sd
Sd
Sd
Fh
Rl
Fh
ar
"}
(109,1,1) = {"
ar
Sd
aS
qZ
Sd
Sd
Sd
aa
aa
aa
aa
aa
aa
aA
qZ
mK
aA
aa
aa
aa
aa
aa
Sd
Sd
Sd
Sd
Sd
Fh
Rl
Fh
ar
"}
(110,1,1) = {"
ar
Sd
qZ
qZ
aA
HJ
Sd
aa
aa
aa
aa
aa
aa
aa
aA
cs
Ag
aa
aa
aa
aa
aa
aa
aa
aa
aa
Sd
Fh
aA
Fh
ar
"}
(111,1,1) = {"
ar
Sd
aA
yr
aA
HJ
Sd
Sd
aa
aa
aa
aa
aa
qu
aA
mK
aA
aa
aa
aa
aa
aa
aa
aa
aa
aa
Sd
Fh
aA
Fh
ar
"}
(112,1,1) = {"
ar
Sd
Sd
aA
aA
HJ
Sd
Sd
Sd
Sd
Sd
Sd
aa
aA
aA
WJ
aa
aa
aa
aa
Sd
aa
aa
aa
Sd
Sd
Sd
Sd
mK
Fh
ar
"}
(113,1,1) = {"
ar
Sd
Sd
aA
aA
mK
Sd
Sd
aa
aa
aa
aa
aa
qZ
mK
mK
aa
aa
aa
aa
Sd
aa
aa
aa
Sd
Sd
Sd
HJ
aA
Fh
ar
"}
(114,1,1) = {"
ar
Sd
Sd
aA
mK
mK
mK
Sd
Sd
Sd
Sd
LQ
aa
aa
mK
mK
aa
LQ
aa
aa
Sd
aa
aa
aa
Sd
Sd
HJ
aA
WJ
Sd
ar
"}
(115,1,1) = {"
ar
Sd
Sd
HJ
aA
mK
mK
mK
mK
HJ
HJ
Sd
HJ
mb
mb
mb
HJ
Sd
Sd
Sd
Sd
Sd
Sd
Sd
Sd
Sd
HJ
aA
BN
Sd
ar
"}
(116,1,1) = {"
ar
Sd
Sd
Sd
aA
aA
yr
qZ
mK
aA
aA
mK
mK
mK
ic
mK
aA
aA
HJ
HJ
HJ
Sd
Sd
Sd
Sd
aA
BN
aA
yr
Sd
ar
"}
(117,1,1) = {"
ar
Sd
Sd
Sd
Sd
HJ
qZ
aS
yr
bh
mK
mK
mK
hH
mK
bh
mK
mK
mK
aA
HJ
HJ
HJ
HJ
LQ
aA
aA
Zl
yr
Sd
ar
"}
(118,1,1) = {"
ar
Sd
Sd
Sd
Sd
Sd
aA
qZ
qZ
yr
mK
mK
mK
EW
mK
mK
mK
mK
mK
mK
mK
mK
mK
mb
aA
mK
yr
pF
qZ
HJ
ar
"}
(119,1,1) = {"
ar
Sd
Sd
Sd
Sd
Sd
Sd
HJ
HJ
aA
mK
mK
EW
ft
EW
xA
mK
mK
mK
mK
mK
mK
mj
mb
mK
mK
qZ
qZ
qZ
HJ
ar
"}
(120,1,1) = {"
ar
Sd
Sd
Sd
Sd
Sd
Sd
Sd
HJ
HJ
aA
aA
xA
EW
mK
mK
mK
mK
mK
HJ
HJ
HJ
mK
mb
BN
aA
VV
qZ
Sd
Sd
ar
"}
(121,1,1) = {"
ar
Sd
Sd
Sd
Sd
Sd
Sd
Sd
Sd
Sd
aA
aI
aA
mK
aA
aA
Sd
HJ
HJ
HJ
Sd
Sd
HJ
HJ
LQ
aA
BN
HJ
Sd
Sd
ar
"}
(122,1,1) = {"
ar
Sd
Sd
Sd
Sd
Sd
Sd
Sd
Sd
Sd
Sd
Sd
HJ
HJ
HJ
Sd
Sd
Sd
Sd
Sd
Sd
Sd
Sd
Sd
Sd
Sd
Sd
Sd
Sd
Sd
ar
"}
(123,1,1) = {"
ar
ar
ar
ar
ar
ar
ar
ar
ar
ar
ar
ar
ar
ar
ar
ar
ar
ar
ar
ar
ar
ar
ar
ar
ar
ar
ar
ar
ar
ar
ar
"}
