//MAP CONVERTED BY dmm2tgm.py THIS HEADER COMMENT PREVENTS RECONVERSION, DO NOT REMOVE
"a" = (
/turf/closed/mineral/volcanic/lava_land_surface/hardened,
/area/template_noop)
"c" = (
/obj/structure/flora/ash/stem_shroom,
/turf/open/indestructible/necropolis,
/area/template_noop)
"e" = (
/obj/structure/stone_tile/slab/cracked,
/turf/open/lava/smooth/lava_land_surface,
/area/template_noop)
"j" = (
/obj/structure/flora/rock/pile,
/turf/open/indestructible/necropolis,
/area/template_noop)
"k" = (
/obj/structure/flora/rock/pile,
/turf/open/misc/asteroid/basalt/lava_land_surface,
/area/template_noop)
"q" = (
/obj/structure/stone_tile/surrounding/burnt,
/obj/structure/stone_tile/center,
/turf/open/lava/smooth/lava_land_surface,
/area/template_noop)
"t" = (
/obj/structure/flora/ash/leaf_shroom,
/obj/modular_map_connector,
/turf/open/misc/asteroid/basalt/lava_land_surface,
/area/template_noop)
"u" = (
/obj/structure/flora/ash/stem_shroom,
/turf/open/misc/asteroid/basalt/lava_land_surface,
/area/template_noop)
"v" = (
/obj/structure/flora/ash/cap_shroom,
/turf/open/misc/asteroid/basalt/lava_land_surface,
/area/template_noop)
"D" = (
/turf/open/misc/asteroid/basalt/lava_land_surface,
/area/template_noop)
"E" = (
/obj/structure/spawner/lavaland/goliath,
/turf/open/indestructible/necropolis,
/area/template_noop)
"F" = (
/mob/living/simple_animal/hostile/asteroid/goliath/beast,
/turf/open/misc/asteroid/basalt/lava_land_surface,
/area/template_noop)
"H" = (
/obj/structure/stone_tile/block/cracked{
	dir = 10
	},
/turf/open/lava/smooth/lava_land_surface,
/area/template_noop)
"I" = (
/turf/open/lava/smooth/lava_land_surface,
/area/template_noop)
"K" = (
/obj/structure/stone_tile/slab,
/turf/open/lava/smooth/lava_land_surface,
/area/template_noop)
"L" = (
/obj/structure/flora/ash/leaf_shroom,
/turf/open/misc/asteroid/basalt/lava_land_surface,
/area/template_noop)
"O" = (
/obj/structure/stone_tile/block/burnt{
	dir = 8
	},
/turf/open/lava/smooth/lava_land_surface,
/area/template_noop)
"P" = (
/obj/structure/flora/rock,
/turf/open/misc/asteroid/basalt/lava_land_surface,
/area/template_noop)
"S" = (
/turf/open/indestructible/necropolis,
/area/template_noop)
"W" = (
/obj/structure/stone_tile/surrounding/burnt,
/obj/structure/stone_tile/center/burnt,
/turf/open/lava/smooth/lava_land_surface,
/area/template_noop)

(1,1,1) = {"
D
D
a
a
a
a
a
D
D
D
D
D
"}
(2,1,1) = {"
D
a
a
S
a
a
a
D
D
D
D
D
"}
(3,1,1) = {"
a
a
u
S
S
a
a
a
a
D
D
D
"}
(4,1,1) = {"
a
a
j
E
S
S
a
a
a
D
D
D
"}
(5,1,1) = {"
a
S
j
c
S
D
k
a
a
a
a
D
"}
(6,1,1) = {"
a
S
S
a
S
D
D
D
a
a
a
a
"}
(7,1,1) = {"
a
a
a
a
a
a
D
D
D
D
a
a
"}
(8,1,1) = {"
a
a
L
a
a
a
a
a
D
D
a
a
"}
(9,1,1) = {"
a
a
D
L
D
O
H
a
a
D
a
a
"}
(10,1,1) = {"
a
a
D
I
q
K
e
W
D
D
a
a
"}
(11,1,1) = {"
a
a
D
a
a
a
a
a
D
D
a
a
"}
(12,1,1) = {"
a
a
D
D
a
a
a
a
a
a
a
a
"}
(13,1,1) = {"
a
a
F
D
D
k
k
a
a
a
a
a
"}
(14,1,1) = {"
a
a
D
F
D
D
D
D
a
a
a
a
"}
(15,1,1) = {"
a
D
D
a
k
v
v
D
a
a
a
a
"}
(16,1,1) = {"
a
I
D
a
a
P
k
D
D
a
a
a
"}
(17,1,1) = {"
a
I
a
a
a
a
a
a
D
a
a
a
"}
(18,1,1) = {"
a
I
a
a
a
a
a
a
D
a
a
a
"}
(19,1,1) = {"
a
I
a
a
a
a
a
a
D
a
a
a
"}
(20,1,1) = {"
a
I
P
a
a
P
k
D
D
a
a
a
"}
(21,1,1) = {"
a
D
D
a
a
k
F
D
D
a
a
a
"}
(22,1,1) = {"
a
a
D
D
D
D
D
D
k
a
a
a
"}
(23,1,1) = {"
a
k
D
D
D
a
a
a
a
a
a
a
"}
(24,1,1) = {"
a
k
L
D
a
a
a
a
a
a
a
a
"}
(25,1,1) = {"
a
P
t
D
a
a
a
a
a
a
a
a
"}
