//MAP CONVERTED BY dmm2tgm.py THIS HEADER COMMENT PREVENTS RECONVERSION, DO NOT REMOVE
"a" = (
/turf/closed/wall/mineral/titanium,
/area/deathmatch/fullbright)
"c" = (
/turf/open/floor/light/colour_cycle/dancefloor_b,
/area/deathmatch/fullbright)
"e" = (
/obj/machinery/light{
	dir = 8
	},
/turf/open/floor/circuit/green,
/area/deathmatch/fullbright)
"q" = (
/obj/machinery/door/airlock/titanium/glass,
/turf/open/floor/mineral/abductor,
/area/deathmatch/fullbright)
"u" = (
/turf/template_noop,
/area/template_noop)
"v" = (
/obj/machinery/light{
	dir = 4
	},
/turf/open/floor/circuit/green,
/area/deathmatch/fullbright)
"y" = (
/obj/machinery/light{
	dir = 1
	},
/turf/open/floor/circuit/green,
/area/deathmatch/fullbright)
"A" = (
/obj/machinery/light{
	dir = 4
	},
/turf/open/floor/vault/alien,
/area/deathmatch/fullbright)
"B" = (
/obj/machinery/light{
	dir = 8
	},
/turf/open/floor/vault/alien,
/area/deathmatch/fullbright)
"C" = (
/turf/open/floor/circuit/green,
/area/deathmatch/fullbright)
"D" = (
/turf/closed/indestructible/alien,
/area/deathmatch/fullbright)
"E" = (
/obj/machinery/light{
	dir = 1
	},
/turf/open/floor/vault/alien,
/area/deathmatch/fullbright)
"F" = (
/obj/effect/landmark/deathmatch_player_spawn,
/obj/machinery/light/floor,
/turf/open/floor/vault/alien,
/area/deathmatch/fullbright)
"H" = (
/turf/open/floor/vault/alien,
/area/deathmatch/fullbright)
"I" = (
/obj/machinery/light,
/turf/open/floor/vault/alien,
/area/deathmatch/fullbright)
"L" = (
/obj/machinery/light,
/turf/open/floor/circuit/green,
/area/deathmatch/fullbright)
"N" = (
/obj/machinery/door/airlock/titanium/glass,
/turf/open/floor/plating/abductor2,
/area/deathmatch/fullbright)
"Y" = (
/turf/open/floor/light/colour_cycle/dancefloor_a,
/area/deathmatch/fullbright)

(1,1,1) = {"
u
u
D
D
D
D
D
D
D
D
D
D
D
D
D
D
D
D
D
D
D
D
D
D
u
u
"}
(2,1,1) = {"
u
D
D
H
H
H
H
H
H
H
N
Y
Y
Y
Y
N
H
H
H
H
H
H
H
D
D
u
"}
(3,1,1) = {"
D
D
H
H
H
H
H
H
H
H
N
Y
Y
Y
Y
N
H
H
H
H
H
H
H
H
D
D
"}
(4,1,1) = {"
D
H
H
F
H
a
a
H
H
I
a
Y
Y
Y
Y
a
E
H
H
a
a
H
F
H
H
D
"}
(5,1,1) = {"
D
H
H
H
H
H
B
H
H
H
H
a
Y
Y
a
H
H
H
H
B
H
H
H
H
H
D
"}
(6,1,1) = {"
D
H
H
a
H
H
H
H
H
H
H
H
a
a
H
H
H
H
H
H
H
H
a
H
H
D
"}
(7,1,1) = {"
D
H
H
a
E
H
H
H
a
H
H
H
H
H
H
H
H
a
H
H
H
I
a
H
H
D
"}
(8,1,1) = {"
D
H
H
H
H
H
H
a
E
H
H
v
C
C
v
H
H
I
a
H
H
H
H
H
H
D
"}
(9,1,1) = {"
D
H
H
H
H
H
a
B
F
C
C
a
q
q
a
C
H
F
B
a
H
H
H
H
H
D
"}
(10,1,1) = {"
D
H
H
A
H
H
H
H
H
C
a
c
c
c
c
a
C
C
H
H
H
H
A
H
H
D
"}
(11,1,1) = {"
D
N
N
a
H
H
H
H
C
a
c
c
c
c
c
c
a
C
H
H
H
H
a
N
N
D
"}
(12,1,1) = {"
D
Y
Y
Y
a
H
H
L
a
c
c
c
c
c
c
c
c
a
y
H
H
a
Y
Y
Y
D
"}
(13,1,1) = {"
D
Y
Y
Y
Y
a
H
C
q
c
c
c
c
c
c
c
c
q
C
H
a
Y
Y
Y
Y
D
"}
(14,1,1) = {"
D
Y
Y
Y
Y
a
H
C
q
c
c
c
c
c
c
c
c
q
C
H
a
Y
Y
Y
Y
D
"}
(15,1,1) = {"
D
Y
Y
Y
a
H
H
L
a
c
c
c
c
c
c
c
c
a
y
H
H
a
Y
Y
Y
D
"}
(16,1,1) = {"
D
N
N
a
H
H
H
H
C
a
c
c
c
c
c
c
a
C
H
H
H
H
a
N
N
D
"}
(17,1,1) = {"
D
H
H
B
H
H
H
H
H
C
a
c
c
c
c
a
C
H
H
H
H
H
B
H
H
D
"}
(18,1,1) = {"
D
H
H
H
H
H
a
A
F
C
C
a
q
q
a
C
C
F
A
a
H
H
H
H
H
D
"}
(19,1,1) = {"
D
H
H
H
H
H
H
a
E
H
H
e
C
C
e
H
H
I
a
H
H
H
H
H
H
D
"}
(20,1,1) = {"
D
H
H
a
E
H
H
H
a
H
H
H
H
H
H
H
H
a
H
H
H
I
a
H
H
D
"}
(21,1,1) = {"
D
H
H
a
H
H
H
H
H
H
H
H
a
a
H
H
H
H
H
H
H
H
a
H
H
D
"}
(22,1,1) = {"
D
H
H
H
H
H
A
H
H
H
H
a
Y
Y
a
H
H
H
H
A
H
H
H
H
H
D
"}
(23,1,1) = {"
D
H
H
F
H
a
a
H
H
I
a
Y
Y
Y
Y
a
E
H
H
a
a
H
F
H
H
D
"}
(24,1,1) = {"
D
D
H
H
H
H
H
H
H
H
N
Y
Y
Y
Y
N
H
H
H
H
H
H
H
H
D
D
"}
(25,1,1) = {"
u
D
D
H
H
H
H
H
H
H
N
Y
Y
Y
Y
N
H
H
H
H
H
H
H
D
D
u
"}
(26,1,1) = {"
u
u
D
D
D
D
D
D
D
D
D
D
D
D
D
D
D
D
D
D
D
D
D
D
u
u
"}
