//MAP CONVERTED BY dmm2tgm.py THIS HEADER COMMENT PREVENTS RECONVERSION, DO NOT REMOVE
"a" = (
/obj/machinery/light/directional/east,
/turf/open/floor/wood,
/area/deathmatch)
"f" = (
/obj/machinery/light/directional/west,
/obj/structure/barricade/sandbags,
/turf/open/floor/wood,
/area/deathmatch)
"g" = (
/turf/closed/indestructible/iron,
/area/deathmatch)
"s" = (
/obj/machinery/light/directional/south,
/turf/open/floor/wood,
/area/deathmatch)
"z" = (
/turf/open/floor/wood,
/area/deathmatch)
"B" = (
/obj/machinery/light/directional/west,
/turf/open/floor/wood,
/area/deathmatch)
"C" = (
/obj/machinery/drone_dispenser{
	cooldownTime = 10;
	desc = "A hefty machine that periodically creates 9mm magazines.";
	dispense_type = /obj/item/ammo_box/magazine/m9mm;
	end_create_message = "dispenses ammo.";
	glass_cost = 0;
	iron_cost = 0;
	maximum_idle = 1;
	name = "ammo dispenser";
	production_time = 0
	},
/turf/open/floor/wood,
/area/deathmatch)
"K" = (
/turf/closed/wall,
/area/deathmatch)
"M" = (
/obj/structure/barricade/sandbags,
/turf/open/floor/wood,
/area/deathmatch)
"O" = (
/obj/structure/barricade/wooden,
/turf/open/floor/wood,
/area/deathmatch)
"T" = (
/obj/effect/landmark/deathmatch_player_spawn,
/turf/open/floor/wood,
/area/deathmatch)
"W" = (
/obj/machinery/light/directional/north,
/turf/open/floor/wood,
/area/deathmatch)

(1,1,1) = {"
g
g
g
g
g
g
g
g
g
g
g
g
g
g
g
g
g
g
g
g
g
g
"}
(2,1,1) = {"
g
z
z
z
z
O
z
z
z
z
z
z
z
z
z
z
z
z
z
z
z
g
"}
(3,1,1) = {"
g
z
z
z
T
K
z
z
z
z
z
z
z
z
z
z
z
z
z
z
z
g
"}
(4,1,1) = {"
g
z
z
z
z
K
M
M
M
z
z
z
z
z
O
K
z
z
K
O
z
g
"}
(5,1,1) = {"
g
z
z
a
z
K
z
z
z
z
z
z
z
z
O
z
z
z
z
K
z
g
"}
(6,1,1) = {"
g
O
O
K
z
z
z
z
z
a
z
z
z
z
K
W
z
z
z
z
z
g
"}
(7,1,1) = {"
g
z
z
f
z
z
z
K
K
K
O
O
K
z
K
z
z
T
z
z
z
g
"}
(8,1,1) = {"
g
z
z
M
M
M
z
z
z
z
z
z
z
z
O
z
z
z
z
K
z
g
"}
(9,1,1) = {"
g
z
z
z
z
z
z
K
z
z
z
z
z
z
O
K
K
K
K
O
z
g
"}
(10,1,1) = {"
g
z
z
z
z
z
z
K
z
C
z
z
K
z
z
z
z
M
z
z
z
g
"}
(11,1,1) = {"
g
z
z
z
z
z
z
z
z
z
z
z
O
z
z
z
z
M
z
z
z
g
"}
(12,1,1) = {"
g
z
z
M
M
z
z
K
O
O
K
K
K
z
z
z
z
M
M
z
z
g
"}
(13,1,1) = {"
g
z
z
z
M
z
z
B
z
z
z
M
z
z
z
z
z
z
z
z
z
g
"}
(14,1,1) = {"
g
z
z
z
M
z
z
z
z
M
z
M
z
z
s
K
K
O
O
K
z
g
"}
(15,1,1) = {"
g
z
K
O
O
K
O
z
z
M
z
z
z
z
z
K
T
z
z
K
z
g
"}
(16,1,1) = {"
g
z
z
z
z
z
O
z
K
K
z
K
O
z
z
O
z
z
s
K
z
g
"}
(17,1,1) = {"
g
z
z
z
T
s
K
z
K
z
z
z
O
z
z
O
z
z
z
K
z
g
"}
(18,1,1) = {"
g
z
z
z
z
z
K
z
K
W
z
z
O
z
z
K
z
z
z
z
z
g
"}
(19,1,1) = {"
g
z
z
z
z
z
K
z
K
z
z
z
K
z
z
K
K
K
K
K
z
g
"}
(20,1,1) = {"
g
z
z
K
K
z
K
z
K
K
z
z
K
z
z
z
z
z
z
z
z
g
"}
(21,1,1) = {"
g
z
z
z
z
z
z
z
z
T
z
z
z
z
z
z
z
z
z
z
z
g
"}
(22,1,1) = {"
g
g
g
g
g
g
g
g
g
g
g
g
g
g
g
g
g
g
g
g
g
g
"}