//MAP CONVERTED BY dmm2tgm.py THIS HEADER COMMENT PREVENTS RECONVERSION, DO NOT REMOVE
"ab" = (
/turf/open/space/basic,
/area/space)
"av" = (
/obj/structure/chair/wood{
	dir = 4
	},
/obj/item/toy/plush/goatplushie,
/turf/open/misc/grass/jungle,
/area/ruin/space/has_grav/wonderland)
"aR" = (
/obj/item/clothing/shoes/costume_2021/doll_shoes,
/turf/open/misc/grass/jungle,
/area/ruin/space/has_grav/wonderland)
"bf" = (
/obj/structure/chess/blackrook,
/turf/open/floor/holofloor/pure_white,
/area/ruin/space/has_grav/wonderland)
"br" = (
/obj/structure/chess/blackknight,
/turf/open/floor/black,
/area/ruin/space/has_grav/wonderland)
"bZ" = (
/obj/item/clothing/head/costume_2021/doll_hat,
/turf/open/misc/grass/jungle,
/area/ruin/space/has_grav/wonderland)
"cj" = (
/obj/structure/chess/blackbishop,
/turf/open/floor/holofloor/pure_white,
/area/ruin/space/has_grav/wonderland)
"ct" = (
/obj/structure/chess/blackqueen,
/turf/open/floor/black,
/area/ruin/space/has_grav/wonderland)
"de" = (
/obj/structure/chess/whiterook,
/turf/open/floor/holofloor/pure_white,
/area/ruin/space/has_grav/wonderland)
"dC" = (
/obj/effect/rune/narsie{
	used = 1
	},
/turf/open/floor/wood/large,
/area/ruin/space/has_grav/wonderland)
"dE" = (
/obj/structure/chess/blackking,
/turf/open/floor/holofloor/pure_white,
/area/ruin/space/has_grav/wonderland)
"dJ" = (
/obj/structure/chess/blackbishop,
/turf/open/floor/black,
/area/ruin/space/has_grav/wonderland)
"eu" = (
/obj/structure/rack/weaponsmith,
/turf/open/floor/wood/large,
/area/ruin/space/has_grav/wonderland)
"fb" = (
/obj/structure/chess/blackknight,
/turf/open/floor/holofloor/pure_white,
/area/ruin/space/has_grav/wonderland)
"gc" = (
/obj/structure/blood_fountain,
/turf/open/misc/grass/jungle,
/area/ruin/space/has_grav/wonderland)
"gw" = (
/obj/structure/chess/blackrook,
/turf/open/floor/black,
/area/ruin/space/has_grav/wonderland)
"hK" = (
/obj/structure/flora/bush/flowers_br/style_2,
/obj/structure/flora/tree/jungle,
/turf/open/misc/grass/jungle,
/area/ruin/space/has_grav/wonderland)
"jT" = (
/obj/structure/chess/whiteking,
/turf/open/floor/black,
/area/ruin/space/has_grav/wonderland)
"mD" = (
/obj/structure/chess,
/turf/open/floor/black,
/area/ruin/space/has_grav/wonderland)
"mP" = (
/obj/structure/chess/blackpawn,
/turf/open/floor/black,
/area/ruin/space/has_grav/wonderland)
"mS" = (
/obj/structure/flora/bush/flowers_yw,
/obj/structure/flora/bush/flowers_br/style_2,
/mob/living/basic/rabbit,
/turf/open/misc/grass/jungle,
/area/ruin/space/has_grav/wonderland)
"oC" = (
/obj/structure/chair/wood,
/obj/item/clothing/head/collectable/tophat,
/turf/open/misc/grass/jungle,
/area/ruin/space/has_grav/wonderland)
"oF" = (
/turf/open/floor/black,
/area/ruin/space/has_grav/wonderland)
"pN" = (
/obj/structure/chess/whiterook,
/turf/open/floor/black,
/area/ruin/space/has_grav/wonderland)
"rr" = (
/obj/structure/flora/bush/flowers_yw,
/obj/structure/flora/bush/flowers_br/style_2,
/turf/open/misc/grass/jungle,
/area/ruin/space/has_grav/wonderland)
"sr" = (
/obj/item/grenade/jack,
/obj/item/grenade/jack,
/obj/item/grenade/jack,
/obj/item/grenade/jack,
/obj/structure/closet/cabinet,
/turf/open/floor/wood/large,
/area/ruin/space/has_grav/wonderland)
"tb" = (
/obj/effect/decal/cleanable/blood/old,
/obj/effect/mob_spawn/corpse/rabbit,
/turf/open/floor/wood/large,
/area/ruin/space/has_grav/wonderland)
"wY" = (
/mob/living/basic/rabbit,
/turf/open/misc/grass/jungle,
/area/ruin/space/has_grav/wonderland)
"yW" = (
/obj/structure/flora/bush/flowers_pp/style_2,
/obj/item/clothing/under/costume_2021/doll_suit,
/turf/open/misc/grass/jungle,
/area/ruin/space/has_grav/wonderland)
"Av" = (
/obj/structure/flora/bush/flowers_yw,
/mob/living/basic/rabbit,
/turf/open/misc/grass/jungle,
/area/ruin/space/has_grav/wonderland)
"AH" = (
/obj/structure/flora/bush/flowers_yw,
/turf/open/misc/grass/jungle,
/area/ruin/space/has_grav/wonderland)
"Ck" = (
/obj/structure/flora/bush/flowers_yw,
/obj/structure/flora/bush/flowers_br,
/turf/open/misc/grass/jungle,
/area/ruin/space/has_grav/wonderland)
"Cw" = (
/obj/structure/chess/whitebishop,
/turf/open/floor/holofloor/pure_white,
/area/ruin/space/has_grav/wonderland)
"El" = (
/turf/open/floor/holofloor/pure_white,
/area/ruin/space/has_grav/wonderland)
"Fd" = (
/turf/closed/indestructible/riveted,
/area/space)
"FO" = (
/obj/structure/flora/tree/jungle,
/turf/open/misc/grass/jungle,
/area/ruin/space/has_grav/wonderland)
"Gl" = (
/obj/structure/mineral_door/wood,
/turf/open/misc/grass/jungle,
/area/ruin/space/has_grav/wonderland)
"Gs" = (
/obj/structure/table/wood,
/obj/item/blood_vial,
/turf/open/floor/wood/large,
/area/ruin/space/has_grav/wonderland)
"HK" = (
/obj/effect/decal/cleanable/blood/old,
/turf/open/floor/wood/large,
/area/ruin/space/has_grav/wonderland)
"Iq" = (
/obj/structure/chess/whiteknight,
/turf/open/floor/holofloor/pure_white,
/area/ruin/space/has_grav/wonderland)
"Jy" = (
/obj/structure/flora/tree/dead/style_6,
/turf/open/misc/grass/jungle,
/area/ruin/space/has_grav/wonderland)
"JP" = (
/obj/structure/chess/whitebishop,
/turf/open/floor/black,
/area/ruin/space/has_grav/wonderland)
"JX" = (
/obj/structure/chess/blackpawn,
/turf/open/floor/holofloor/pure_white,
/area/ruin/space/has_grav/wonderland)
"Kw" = (
/obj/structure/chess,
/turf/open/floor/holofloor/pure_white,
/area/ruin/space/has_grav/wonderland)
"Mo" = (
/obj/structure/flora/tree/dead,
/turf/open/misc/grass/jungle,
/area/ruin/space/has_grav/wonderland)
"Mw" = (
/obj/structure/flora/bush/flowers_br/style_2,
/turf/open/misc/grass/jungle,
/area/ruin/space/has_grav/wonderland)
"PU" = (
/obj/structure/chess/redqueen,
/obj/effect/decal/cleanable/blood/bubblegum,
/turf/open/floor/holofloor/pure_white,
/area/ruin/space/has_grav/wonderland)
"RW" = (
/obj/structure/flora/bush/flowers_pp/style_2,
/mob/living/basic/rabbit,
/turf/open/misc/grass/jungle,
/area/ruin/space/has_grav/wonderland)
"Se" = (
/obj/structure/flora/bush/flowers_yw,
/obj/structure/flora/bush/flowers_pp,
/turf/open/misc/grass/jungle,
/area/ruin/space/has_grav/wonderland)
"Sy" = (
/turf/open/floor/wood/large,
/area/ruin/space/has_grav/wonderland)
"Tc" = (
/obj/structure/table/wood,
/obj/item/reagent_containers/cup/glass/mug,
/turf/open/misc/grass/jungle,
/area/ruin/space/has_grav/wonderland)
"UO" = (
/obj/structure/flora/bush/flowers_yw,
/obj/structure/flora/bush/flowers_pp/style_2,
/turf/open/misc/grass/jungle,
/area/ruin/space/has_grav/wonderland)
"Wb" = (
/turf/open/misc/ashplanet/wateryrock{
	initial_gas_mix = "o2=22;n2=82;TEMP=293.15";
	planetary_atmos = 0;
	slowdown = 0
	},
/area/ruin/space/has_grav/wonderland)
"WD" = (
/turf/closed/indestructible/wood,
/area/ruin/space/has_grav/wonderland)
"Xk" = (
/turf/open/floor/holofloor/beach/water,
/area/ruin/space/has_grav/wonderland)
"Xr" = (
/obj/structure/closet/crate/grave/filled,
/turf/open/misc/grass/jungle,
/area/ruin/space/has_grav/wonderland)
"Xt" = (
/obj/structure/chair/wood{
	dir = 1
	},
/obj/effect/landmark/wonderland_mark,
/turf/open/misc/grass/jungle,
/area/ruin/space/has_grav/wonderland)
"Xv" = (
/obj/structure/flora/bush/flowers_yw,
/obj/structure/flora/bush/flowers_br,
/mob/living/basic/rabbit,
/turf/open/misc/grass/jungle,
/area/ruin/space/has_grav/wonderland)
"XC" = (
/obj/structure/chair/wood{
	dir = 8
	},
/obj/item/toy/plush/goatplushie,
/turf/open/misc/grass/jungle,
/area/ruin/space/has_grav/wonderland)
"Yf" = (
/obj/effect/landmark/wonderchess_mark,
/turf/open/floor/black,
/area/ruin/space/has_grav/wonderland)
"Yj" = (
/obj/structure/chess/whiteknight,
/turf/open/floor/black,
/area/ruin/space/has_grav/wonderland)
"Yp" = (
/obj/structure/flora/bush/flowers_pp/style_2,
/turf/open/misc/grass/jungle,
/area/ruin/space/has_grav/wonderland)
"ZA" = (
/turf/open/misc/grass/jungle,
/area/ruin/space/has_grav/wonderland)

(1,1,1) = {"
ab
ab
ab
ab
ab
ab
ab
ab
ab
ab
ab
ab
ab
ab
ab
ab
ab
ab
ab
ab
ab
ab
ab
ab
ab
ab
ab
ab
ab
ab
ab
ab
ab
ab
ab
ab
ab
ab
ab
ab
ab
ab
"}
(2,1,1) = {"
ab
ab
ab
ab
ab
ab
ab
ab
ab
ab
ab
ab
ab
ab
Fd
Fd
Fd
Fd
Fd
Fd
Fd
Fd
Fd
Fd
Fd
Fd
Fd
Fd
Fd
Fd
Fd
Fd
Fd
Fd
Fd
Fd
Fd
Fd
Fd
Fd
Fd
ab
"}
(3,1,1) = {"
ab
ab
ab
ab
ab
ab
ab
ab
ab
ab
ab
ab
ab
ab
Fd
ZA
ZA
ZA
ZA
ZA
ZA
ZA
ZA
ZA
ZA
ZA
ZA
ZA
ZA
ZA
wY
ZA
ZA
ZA
ZA
ZA
ZA
ZA
ZA
ZA
Fd
ab
"}
(4,1,1) = {"
ab
ab
ab
ab
ab
ab
ab
ab
ab
ab
ab
ab
ab
ab
Fd
ZA
ZA
ZA
ZA
ZA
ZA
ZA
ZA
ZA
Yp
FO
Yp
ZA
ZA
ZA
ZA
ZA
ZA
Mw
Mw
ZA
Mw
ZA
ZA
ZA
Fd
ab
"}
(5,1,1) = {"
ab
ab
ab
ab
ab
ab
ab
ab
ab
ab
ab
ab
ab
ab
Fd
ZA
ZA
ZA
ZA
ZA
ZA
ZA
Yp
ZA
ZA
ZA
ZA
ZA
ZA
Yp
ZA
ZA
ZA
ZA
ZA
wY
ZA
ZA
Mw
ZA
Fd
ab
"}
(6,1,1) = {"
ab
ab
ab
ab
ab
ab
ab
ab
ab
ab
ab
ab
ab
ab
Fd
ZA
ZA
ZA
ZA
ZA
ZA
ZA
ZA
ZA
ZA
Yp
ZA
wY
Yp
wY
ZA
Yp
wY
ZA
ZA
ZA
hK
ZA
ZA
ZA
Fd
ab
"}
(7,1,1) = {"
ab
ab
ab
ab
ab
ab
ab
ab
ab
ab
ab
ab
ab
ab
Fd
ZA
ZA
ZA
ZA
ZA
ZA
ZA
ZA
ZA
ZA
Yp
ZA
ZA
ZA
ZA
ZA
ZA
ZA
Yp
ZA
ZA
wY
ZA
ZA
ZA
Fd
ab
"}
(8,1,1) = {"
ab
ab
ab
ab
ab
ab
ab
ab
ab
ab
ab
ab
ab
ab
Fd
WD
WD
WD
WD
WD
WD
ZA
ZA
ZA
ZA
wY
ZA
FO
Yp
wY
ZA
Yp
Mo
ZA
ZA
ZA
ZA
ZA
Mw
ZA
Fd
ab
"}
(9,1,1) = {"
ab
ab
ab
ab
ab
ab
ab
ab
ab
ab
ab
ab
ab
ab
Fd
Sy
tb
Sy
Gs
Sy
WD
ZA
ZA
ZA
ZA
ZA
ZA
ZA
ZA
ZA
ZA
ZA
ZA
Mw
wY
ZA
Mw
ZA
ZA
ZA
Fd
ab
"}
(10,1,1) = {"
ab
ab
ab
ab
ab
ab
ab
ab
ab
ab
ab
ab
ab
ab
Fd
sr
Sy
Sy
Sy
Sy
WD
ZA
ZA
ZA
ZA
ZA
ZA
ZA
ZA
Yp
Mo
ZA
wY
ZA
ZA
ZA
ZA
ZA
ZA
ZA
Fd
ab
"}
(11,1,1) = {"
ab
ab
ab
ab
ab
ab
ab
ab
ab
ab
ab
ab
ab
ab
Fd
Sy
Sy
tb
HK
Sy
WD
ZA
ZA
ZA
ZA
ZA
Yp
ZA
ZA
ZA
ZA
ZA
ZA
ZA
ZA
ZA
ZA
ZA
ZA
ZA
Fd
ab
"}
(12,1,1) = {"
ab
ab
ab
ab
ab
ab
ab
ab
ab
ab
ab
ab
ab
ab
Fd
eu
Sy
dC
tb
Sy
Gl
ZA
ZA
ZA
ZA
Wb
Wb
Wb
Wb
Wb
Wb
Wb
Wb
Wb
Wb
Wb
Wb
Wb
Wb
Wb
Fd
ab
"}
(13,1,1) = {"
ab
ab
ab
ab
ab
ab
ab
ab
ab
ab
ab
ab
ab
ab
Fd
Sy
tb
Sy
Sy
Sy
WD
ZA
ZA
gc
ZA
Xk
Xk
Xk
Xk
Xk
Xk
Xk
Xk
Xk
Xk
Xk
Xk
Xk
Xk
Xk
Fd
ab
"}
(14,1,1) = {"
ab
ab
ab
ab
ab
ab
ab
ab
ab
ab
ab
ab
ab
ab
Fd
Sy
Sy
Sy
Sy
Sy
WD
ZA
ZA
ZA
ZA
Xk
Xk
Xk
Xk
Xk
Xk
Xk
Xk
Xk
Xk
Xk
Xk
Xk
Xk
Xk
Fd
ab
"}
(15,1,1) = {"
ab
ab
ab
ab
ab
ab
ab
ab
ab
ab
ab
ab
ab
ab
Fd
Sy
Sy
HK
tb
Sy
WD
ZA
ZA
ZA
ZA
Wb
Wb
Wb
Wb
Wb
Wb
Wb
Wb
Wb
Wb
Wb
Wb
Wb
Wb
Wb
Fd
ab
"}
(16,1,1) = {"
ab
ab
ab
ab
ab
ab
ab
ab
ab
ab
ab
ab
ab
ab
Fd
WD
WD
WD
WD
WD
WD
ZA
ZA
ZA
ZA
ZA
ZA
ZA
ZA
ZA
ZA
ZA
ZA
ZA
ZA
ZA
ZA
Mw
ZA
ZA
Fd
ab
"}
(17,1,1) = {"
ab
ab
ab
ab
ab
ab
ab
ab
ab
ab
ab
ab
ab
ab
Fd
ZA
ZA
ZA
ZA
ZA
ZA
ZA
ZA
ZA
ZA
ZA
ZA
ZA
av
ZA
ZA
ZA
ZA
ZA
ZA
ZA
ZA
ZA
ZA
ZA
Fd
ab
"}
(18,1,1) = {"
ab
ab
ab
ab
ab
ab
ab
ab
ab
ab
ab
ab
ab
ab
Fd
ZA
ZA
ZA
ZA
ZA
ZA
ZA
ZA
ZA
Jy
ZA
ZA
oC
Tc
Xt
ZA
ZA
ZA
ZA
Mw
ZA
ZA
ZA
ZA
ZA
Fd
ab
"}
(19,1,1) = {"
ab
ab
ab
ab
ab
ab
ab
ab
ab
ab
ab
ab
ab
ab
Fd
ZA
ZA
ZA
ZA
ZA
ZA
ZA
ZA
ZA
Yp
ZA
ZA
ZA
XC
ZA
ZA
ZA
Mw
ZA
wY
Mw
ZA
ZA
ZA
ZA
Fd
ab
"}
(20,1,1) = {"
ab
ab
ab
ab
ab
ab
ab
ab
ab
ab
ab
ab
ab
ab
Fd
Se
Se
Se
AH
AH
UO
ZA
ZA
ZA
ZA
ZA
ZA
ZA
ZA
ZA
ZA
Mw
ZA
Yp
wY
ZA
ZA
ZA
ZA
ZA
Fd
ab
"}
(21,1,1) = {"
ab
ab
ab
ab
ab
ab
ab
ab
ab
ab
ab
ab
ab
ab
Fd
AH
Xr
AH
Xr
Ck
UO
ZA
ZA
ZA
wY
ZA
ZA
Yp
ZA
ZA
wY
ZA
ZA
Mw
ZA
wY
Mw
ZA
ZA
ZA
Fd
ab
"}
(22,1,1) = {"
ab
ab
ab
ab
ab
ab
ab
ab
ab
ab
ab
ab
ab
ab
Fd
Ck
Ck
Xv
Ck
Xv
UO
ZA
ZA
Yp
ZA
ZA
Mw
bZ
yW
aR
ZA
Yp
wY
ZA
Mw
wY
ZA
ZA
ZA
ZA
Fd
ab
"}
(23,1,1) = {"
ab
ab
ab
ab
ab
ab
ab
ab
ab
ab
ab
ab
ab
ab
Fd
AH
AH
AH
AH
Ck
UO
ZA
ZA
ZA
ZA
ZA
ZA
ZA
ZA
ZA
ZA
ZA
ZA
Mw
ZA
ZA
ZA
ZA
ZA
ZA
Fd
ab
"}
(24,1,1) = {"
ab
ab
ab
ab
ab
ab
ab
ab
ab
ab
ab
ab
ab
ab
Fd
Av
Se
Se
Se
Ck
UO
ZA
ZA
ZA
Mw
ZA
Yp
ZA
Yp
wY
Mw
ZA
ZA
ZA
wY
Mw
ZA
ZA
ZA
ZA
Fd
ab
"}
(25,1,1) = {"
ab
ab
ab
ab
ab
ab
ab
ab
ab
ab
ab
ab
ab
ab
Fd
AH
Xr
Se
Xr
AH
UO
ZA
Yp
ZA
ZA
wY
ZA
FO
Yp
RW
ZA
ZA
Yp
ZA
ZA
Yp
ZA
FO
ZA
ZA
Fd
ab
"}
(26,1,1) = {"
ab
ab
ab
ab
ab
ab
ab
ab
ab
ab
ab
ab
ab
ab
Fd
AH
AH
AH
Av
AH
Av
ZA
ZA
ZA
Mw
ZA
Yp
ZA
ZA
ZA
ZA
Mw
ZA
Mw
ZA
ZA
ZA
ZA
ZA
ZA
Fd
ab
"}
(27,1,1) = {"
ab
ab
ab
ab
ab
ab
ab
ab
ab
ab
ab
ab
ab
ab
Fd
rr
mS
mS
rr
rr
AH
ZA
ZA
ZA
ZA
ZA
ZA
wY
ZA
ZA
ZA
wY
ZA
ZA
ZA
ZA
ZA
ZA
ZA
ZA
Fd
ab
"}
(28,1,1) = {"
ab
ab
ab
ab
ab
ab
ab
ab
ab
ab
ab
ab
ab
ab
Fd
Fd
Fd
Fd
Fd
Fd
Fd
Fd
Fd
Fd
Fd
Fd
Fd
Fd
Fd
Fd
Fd
Fd
Fd
Fd
Fd
Fd
Fd
Fd
Fd
Fd
Fd
ab
"}
(29,1,1) = {"
ab
ab
ab
ab
ab
ab
ab
ab
ab
ab
ab
ab
ab
ab
ab
ab
ab
ab
ab
ab
ab
ab
ab
ab
ab
ab
ab
ab
ab
ab
ab
ab
ab
ab
ab
ab
ab
ab
ab
ab
ab
ab
"}
(30,1,1) = {"
ab
ab
ab
ab
ab
ab
ab
ab
ab
ab
ab
ab
ab
ab
ab
ab
ab
ab
Fd
Fd
Fd
Fd
Fd
Fd
Fd
Fd
Fd
Fd
Fd
Fd
Fd
Fd
Fd
ab
ab
ab
ab
ab
ab
ab
ab
ab
"}
(31,1,1) = {"
ab
ab
ab
ab
ab
ab
ab
ab
ab
ab
ab
ab
ab
ab
ab
ab
ab
ab
Fd
Sy
Sy
Sy
Sy
Sy
Sy
Sy
Sy
Sy
Sy
Sy
Sy
Sy
Fd
ab
ab
ab
ab
ab
ab
ab
ab
ab
"}
(32,1,1) = {"
ab
ab
ab
ab
ab
ab
ab
ab
ab
ab
ab
ab
ab
ab
ab
ab
ab
ab
Fd
Sy
Sy
Sy
Sy
Sy
Sy
Sy
Sy
Sy
Sy
Sy
Sy
Sy
Fd
ab
ab
ab
ab
ab
ab
ab
ab
ab
"}
(33,1,1) = {"
ab
ab
ab
ab
ab
ab
ab
ab
ab
ab
ab
ab
ab
ab
ab
ab
ab
ab
Fd
Sy
Sy
bf
mP
El
oF
El
oF
El
mD
de
Sy
Sy
Fd
ab
ab
ab
ab
ab
ab
ab
ab
ab
"}
(34,1,1) = {"
ab
ab
ab
ab
ab
ab
ab
ab
ab
ab
ab
ab
ab
ab
ab
ab
ab
ab
Fd
Sy
Sy
br
JX
oF
El
oF
El
oF
Kw
Yj
Sy
Sy
Fd
ab
ab
ab
ab
ab
ab
ab
ab
ab
"}
(35,1,1) = {"
ab
ab
ab
ab
ab
ab
ab
ab
ab
ab
ab
ab
ab
ab
ab
ab
ab
ab
Fd
Sy
Sy
cj
mP
El
oF
El
oF
El
mD
Cw
Sy
Sy
Fd
ab
ab
ab
ab
ab
ab
ab
ab
ab
"}
(36,1,1) = {"
ab
ab
ab
ab
ab
ab
ab
ab
ab
ab
ab
ab
ab
ab
ab
ab
ab
ab
Fd
Sy
Sy
ct
JX
oF
El
Yf
El
oF
Kw
jT
Sy
Sy
Fd
ab
ab
ab
ab
ab
ab
ab
ab
ab
"}
(37,1,1) = {"
ab
ab
ab
ab
ab
ab
ab
ab
ab
ab
ab
ab
ab
ab
ab
ab
ab
ab
Fd
Sy
Sy
dE
mP
El
oF
El
oF
El
mD
PU
Sy
Sy
Fd
ab
ab
ab
ab
ab
ab
ab
ab
ab
"}
(38,1,1) = {"
ab
ab
ab
ab
ab
ab
ab
ab
ab
ab
ab
ab
ab
ab
ab
ab
ab
ab
Fd
Sy
Sy
dJ
JX
oF
El
oF
El
oF
Kw
JP
Sy
Sy
Fd
ab
ab
ab
ab
ab
ab
ab
ab
ab
"}
(39,1,1) = {"
ab
ab
ab
ab
ab
ab
ab
ab
ab
ab
ab
ab
ab
ab
ab
ab
ab
ab
Fd
Sy
Sy
fb
mP
El
oF
El
oF
El
mD
Iq
Sy
Sy
Fd
ab
ab
ab
ab
ab
ab
ab
ab
ab
"}
(40,1,1) = {"
ab
ab
ab
ab
ab
ab
ab
ab
ab
ab
ab
ab
ab
ab
ab
ab
ab
ab
Fd
Sy
Sy
gw
JX
oF
El
oF
El
oF
Kw
pN
Sy
Sy
Fd
ab
ab
ab
ab
ab
ab
ab
ab
ab
"}
(41,1,1) = {"
ab
ab
ab
ab
ab
ab
ab
ab
ab
ab
ab
ab
ab
ab
ab
ab
ab
ab
Fd
Sy
Sy
Sy
Sy
Sy
Sy
Sy
Sy
Sy
Sy
Sy
Sy
Sy
Fd
ab
ab
ab
ab
ab
ab
ab
ab
ab
"}
(42,1,1) = {"
ab
ab
ab
ab
ab
ab
ab
ab
ab
ab
ab
ab
ab
ab
ab
ab
ab
ab
Fd
Sy
Sy
Sy
Sy
Sy
Sy
Sy
Sy
Sy
Sy
Sy
Sy
Sy
Fd
ab
ab
ab
ab
ab
ab
ab
ab
ab
"}
(43,1,1) = {"
ab
ab
ab
ab
ab
ab
ab
ab
ab
ab
ab
ab
ab
ab
ab
ab
ab
ab
Fd
Fd
Fd
Fd
Fd
Fd
Fd
Fd
Fd
Fd
Fd
Fd
Fd
Fd
Fd
ab
ab
ab
ab
ab
ab
ab
ab
ab
"}
(44,1,1) = {"
ab
ab
ab
ab
ab
ab
ab
ab
ab
ab
ab
ab
ab
ab
ab
ab
ab
ab
ab
ab
ab
ab
ab
ab
ab
ab
ab
ab
ab
ab
ab
ab
ab
ab
ab
ab
ab
ab
ab
ab
ab
ab
"}
(45,1,1) = {"
ab
ab
ab
ab
ab
ab
ab
ab
ab
ab
ab
ab
ab
ab
ab
ab
ab
ab
ab
ab
ab
ab
ab
ab
ab
ab
ab
ab
ab
ab
ab
ab
ab
ab
ab
ab
ab
ab
ab
ab
ab
ab
"}
