"a" = (/turf/simulated/floor/carpet,/area/space)
"b" = (/obj/item/documents,/turf/simulated/floor/carpet,/area/space)
"c" = (/obj/item/areaeditor/blueprints,/turf/simulated/floor/carpet,/area/space)
"d" = (/mob/living/simple_animal/shade,/turf/simulated/floor/carpet,/area/space)
"e" = (/turf/simulated/floor/carpet{icon_state = "carpetsymbol"},/area/space)
"f" = (/mob/living/simple_animal/shade,/turf/simulated/floor/carpet{icon_state = "carpetsymbol"},/area/space)
"g" = (/obj/item/latexballon,/turf/simulated/floor/carpet,/area/space)
"h" = (/obj/item/pizzabox,/turf/simulated/floor/carpet,/area/space)

(1,1,1) = {"
aaaaaaaaaaaaaaaaaaaaaaaaaaaaaaaaaaaaaaaaaaaaaaaaaa
abaaaaaaaaaaaaaaaaaaaaaaaaaaaaaaaaaaaaaaaaaaaaaaca
aaaaaaaaaaaaaaaaaaaaaaaaaaaaaaaaaaaaaaaaaaaaaaaaaa
aaaaaaaaaaaaaaaaaaaaaaaaaaaaaaaaaaaaaaaaaaaaaaaaaa
aaaaaaaaaaaaaaaaaaaaaaaaaaaaaaaaaaaaaaaaaaaaaaaaaa
aaaaaaaaaaaaaaaaaaaaaaaaaaaaaaaaaaaaaaaaaaaaaaaaaa
aaaaaaaaaaaaaadaaaaaaaaaaaaaaaaaaaaaaaaaaaaaaaaaaa
aaaaaaaaaaaaaaaaaaaaaaaaaaaaaaaaaaaaaaaaaaaaaaaaaa
aaaaaaaaaaaaaaaaaaaaaaaaaaaaaaaaaaaaaaaaaaaaaaaaaa
aaaaaaaaaaaaaaaaaaaaaaaaaaaaaaaaaaaaaaaaaaaaaaaaaa
aaaaaaaaaaaaaaaaaaaaaaaaaaaaaaaaaaaaaaaaaaaaaaaaaa
aaaaaaaaaaaaaaaaaaaaaaaaaaaaaaaaaaaaaaaaaaaaaaaaaa
aaaaaaaaaaeeeaaaaaaaaaaaaaaaaeeaaaaaaaaaaaaaaaaaaa
aaaaaaaaaaeaaeeaaaaaeaaaaaeeeaaaaaaaaaaaaaaaaaaaaa
aaaaaaaaaaeaaaeaaaaaeaaaaeaaaaaaaaaaaaaaaaaaaaaaaa
aaaaaaadaaedaeeaaaaaeaaaeaaaaaaaaaaaaaaaaaaaaaaaaa
aaaaaaaaaaeeeeaaaaaaeaaaeaaaaaaaaaaaaaaaaaaaaaaaaa
aaaaaaaaaaeeeeaaaaaaeaaaeaaaeeeeeaaaaaaaaaaaaaaaaa
aaaaaaaaaaeaaeeeaaaaeaaafaaaaaaaeaaaaaaaaaaaaaaaaa
aaaaaaaaaaeaaaaeaaaaeaaaeaaaaaaaeaaaaaaaaaaaaaaaaa
aaaaaaaaaaeaaaaeeaaaeaaaeeaaaaaaeaaaaaaaaaaaaaaaaa
aaaaaaaaaaeaaaeeaaaaeaaaaeeaaeeaeaaaaaaaaaaaaaaaaa
aaaaaaaaaeeeeeeaaaaaaaaaaaeeeeeaeaaaaaaaaaaaaaaaaa
aaaaaaaaaaaaaaaaaaaaaaaaaaaaaaaeeaaaaaaaaaaaaaaaaa
aaaaaaaaaaaaaaaaaaaaaaadaaaaaaaaaaaaaaaaaaaaaaaaaa
aaadaaaaaaaaaaaaaaaaaaaaaaaaaaaaaaaaaaaaaaaaaaaaaa
aaaaaaaaaaaaaaaaaaaaaaaaaaaaaaaaaaaaaaaaaaaaaaaaaa
aaaaaaaaaaaaaaaaaaaaaaaaaaaaaaaaaaaaaaaaaaaaaaaaaa
aaaaaaaaaaaaaaaaaaaaaaaaaaaaaaaaaaaaaaaaaaaaaaaaaa
aaaaaaaaaaeeaaaaaaaaaaeeeaaaaaaeeeeeaaaaaaaaaaaaaa
aaaaaaaaaaeeeaeeeaaaaaeaeaaaaaaeaaaeeaaaaaaaaaaaaa
aaaaaaaaaaeaeeeaaeeaaeeaaeaaaaaeaaaaeaaaaaaaaaaaaa
aaaaaaaaaaeaeeaaaaeaaeaaaeeaaaaeaaaaeaaaaaaaaaaaaa
aaaaaaaaaaeaaaaaaaeaaeaaaaeaaaaaeaaeeaaaaaaaaaaaaa
aaaaaaaaaaeaaaaaaaeaaeeaaeeeaaaaeeeeaaadaaaaaaaaaa
aaaaaaaaaaeaaaaaaaeaaaeeeeeaaaaaeaaaaaaaaaaaaaaaaa
aaaaaaaaaaeaaaaaaaeaaaeaaaeaaaaaeaaaaaaaaaaaaaaaaa
aaaaaaaaaaeaaaaaaaeaaaeaaaeaaaaaeeaaaaaaaaaaaaaaaa
aaaaaaaaaaaaaaaaaaaaaaaeaaaaaaaaaeaaaaaaaaaaaaaaaa
aaaaaaaaaaaaaaaaaaaaaaaeaaaaaaaaaeaaaaaaaaaaaaaaaa
aaaaaaaaaaaaaaaaaaaaaaaaaaaaaaaaaaaaaaaaaaaaaaaaaa
aaaaaaaaaaaaaaaaaaaaaaaadaaaaaaaaaaaaaaaaaaaaaaaaa
aaaaaaaaaaaaaaaaaaaaaaaaaaaaaaaaaaaaaaaaaaaaaaaaaa
aaaaaaaaaaaaaaaaaaaaaaaaaaaaaaaaaaaaaaaaaaaaaaaaaa
aaaaaaaaaaaaaaaaaaaaaaaaaaaaaaaaaaaaaaaaaaaaaaaaaa
aaaaaaaaaaaaaaaaaaaaaaaaaaaaaaaaaaaaaaaaaaaaaaaaaa
aaaaaaaaaaaaaaaaaaaaaaaaaaaaaaaaaaaaaaaaaaaaaaaaaa
aaaaaaaaaaaaaaaaaaaaaaaaaaaaaaaaaaaaaaaaaaaaaaaaaa
agaaaaaaaaaaaaaaaaaaaaaaaaaaaaaaaaaaaaaaaaaaaaaaha
aaaaaaaaaaaaaaaaaaaaaaaaaaaaaaaaaaaaaaaaaaaaaaaaaa
"}
