//MAP CONVERTED BY dmm2tgm.py THIS HEADER COMMENT PREVENTS RECONVERSION, DO NOT REMOVE
"at" = (
/obj/structure/sign/poster/official/random/directional/north,
/turf/open/floor/wood,
/area/centcom/basketball)
"aw" = (
/obj/effect/turf_decal/stripes/white/line{
	dir = 4
	},
/obj/effect/turf_decal/trimline/blue/line,
/obj/effect/turf_decal/trimline/blue/filled/warning{
	dir = 4
	},
/turf/open/floor/wood,
/area/centcom/basketball)
"aE" = (
/obj/effect/turf_decal/trimline/red/line{
	dir = 5
	},
/obj/effect/landmark/basketball/team_spawn/home,
/turf/open/floor/wood,
/area/centcom/basketball)
"be" = (
/obj/effect/turf_decal/stripes/white/line{
	dir = 1
	},
/obj/effect/turf_decal/trimline/blue/warning{
	dir = 1
	},
/obj/effect/turf_decal/trimline/blue/filled/arrow_ccw,
/turf/open/floor/wood/parquet,
/area/centcom/basketball)
"bA" = (
/obj/structure/table/wood,
/obj/effect/spawner/random/entertainment/deck,
/turf/open/floor/wood,
/area/centcom/basketball)
"cz" = (
/obj/structure/table/wood,
/obj/effect/spawner/random/entertainment/coin,
/turf/open/floor/wood,
/area/centcom/basketball)
"dg" = (
/obj/effect/turf_decal/stripes/white/line{
	dir = 1
	},
/obj/effect/turf_decal/trimline/red/warning{
	dir = 1
	},
/obj/effect/turf_decal/trimline/red/filled/arrow_cw,
/turf/open/floor/wood/parquet,
/area/centcom/basketball)
"dr" = (
/obj/effect/turf_decal/siding/wood/corner,
/turf/open/floor/wood,
/area/centcom/basketball)
"dC" = (
/obj/effect/turf_decal/stripes/white/line{
	dir = 1
	},
/obj/effect/turf_decal/trimline/red/warning{
	dir = 1
	},
/obj/effect/turf_decal/trimline/red/filled/shrink_cw,
/turf/open/floor/wood/parquet,
/area/centcom/basketball)
"dJ" = (
/obj/effect/turf_decal/trimline/blue/filled/warning{
	dir = 8
	},
/turf/open/floor/wood/parquet,
/area/centcom/basketball)
"dM" = (
/obj/effect/turf_decal/siding/wood{
	dir = 8
	},
/turf/open/floor/wood,
/area/centcom/basketball)
"dS" = (
/obj/effect/turf_decal/stripes/white/line,
/obj/effect/turf_decal/trimline/blue/warning,
/obj/effect/turf_decal/trimline/blue/filled/shrink_cw{
	dir = 1
	},
/turf/open/floor/wood/parquet,
/area/centcom/basketball)
"eS" = (
/obj/effect/turf_decal/siding/wood{
	dir = 8
	},
/obj/effect/turf_decal/siding/wood/corner,
/turf/open/floor/wood,
/area/centcom/basketball)
"eU" = (
/obj/effect/turf_decal/tile/dark_green/anticorner/contrasted{
	dir = 8
	},
/turf/open/floor/wood,
/area/centcom/basketball)
"fi" = (
/obj/item/kirbyplants/organic/plant21{
	pixel_x = -3;
	pixel_y = 3
	},
/turf/open/floor/wood,
/area/centcom/basketball)
"fj" = (
/obj/structure/sign/poster/official/random/directional/south,
/turf/open/floor/wood,
/area/centcom/basketball)
"fu" = (
/obj/structure/table/wood,
/obj/machinery/chem_dispenser/drinks/fullupgrade{
	dir = 1
	},
/turf/open/floor/wood,
/area/centcom/basketball)
"fB" = (
/obj/effect/turf_decal/stripes/white/line{
	dir = 8
	},
/obj/effect/turf_decal/trimline/red/filled/warning{
	dir = 8
	},
/obj/effect/turf_decal/trimline/red/filled/line{
	dir = 1
	},
/obj/effect/turf_decal/trimline/red/line{
	dir = 1
	},
/turf/open/floor/wood,
/area/centcom/basketball)
"gk" = (
/obj/effect/turf_decal/tile/dark_green/anticorner/contrasted{
	dir = 4
	},
/turf/open/floor/wood,
/area/centcom/basketball)
"gq" = (
/obj/effect/turf_decal/stripes/white/line,
/obj/effect/turf_decal/trimline/red/warning,
/obj/effect/turf_decal/trimline/red/filled/shrink_ccw{
	dir = 1
	},
/turf/open/floor/wood/parquet,
/area/centcom/basketball)
"hf" = (
/obj/effect/spawner/random/structure/billboard/nanotrasen,
/turf/open/floor/wood,
/area/centcom/basketball)
"hB" = (
/obj/structure/table/wood,
/obj/item/storage/dice,
/turf/open/floor/wood,
/area/centcom/basketball)
"jj" = (
/obj/machinery/computer/security/telescreen/entertainment/directional/east,
/turf/open/floor/wood,
/area/centcom/basketball)
"jr" = (
/obj/effect/turf_decal/trimline/blue/line{
	dir = 9
	},
/obj/effect/landmark/basketball/team_spawn/away,
/turf/open/floor/wood,
/area/centcom/basketball)
"kc" = (
/obj/effect/turf_decal/siding/wood{
	dir = 1
	},
/turf/open/floor/wood,
/area/centcom/basketball)
"kp" = (
/obj/effect/turf_decal/stripes/white/line{
	dir = 10
	},
/obj/effect/turf_decal/trimline/blue/filled/warning{
	dir = 5
	},
/turf/open/floor/wood/parquet,
/area/centcom/basketball)
"ku" = (
/obj/effect/turf_decal/stripes/white/line{
	dir = 1
	},
/obj/effect/turf_decal/trimline/red/filled/warning{
	dir = 5
	},
/turf/open/floor/wood/parquet,
/area/centcom/basketball)
"kT" = (
/obj/effect/turf_decal/trimline/blue/filled/corner{
	dir = 4
	},
/obj/effect/turf_decal/trimline/blue/corner{
	dir = 4
	},
/obj/effect/turf_decal/trimline/blue/line{
	dir = 8
	},
/turf/open/floor/wood,
/area/centcom/basketball)
"ly" = (
/obj/effect/turf_decal/siding/wood,
/turf/open/floor/wood,
/area/centcom/basketball)
"lD" = (
/obj/effect/turf_decal/stripes/white/line{
	dir = 9
	},
/obj/effect/turf_decal/trimline/blue/filled/warning{
	dir = 6
	},
/turf/open/floor/wood/parquet,
/area/centcom/basketball)
"lR" = (
/obj/effect/turf_decal/stripes/white/line{
	dir = 1
	},
/obj/effect/turf_decal/trimline/dark_green/warning{
	dir = 1
	},
/obj/effect/turf_decal/trimline/dark_green/filled/warning,
/turf/open/floor/wood/parquet,
/area/centcom/basketball)
"mp" = (
/obj/effect/turf_decal/tile/dark_green/half/contrasted{
	dir = 8
	},
/obj/effect/turf_decal/tile/neutral/half/contrasted{
	dir = 4
	},
/turf/open/floor/wood,
/area/centcom/basketball)
"my" = (
/obj/structure/table/wood,
/turf/open/floor/wood,
/area/centcom/basketball)
"mV" = (
/obj/effect/turf_decal/stripes/white/line{
	dir = 4
	},
/obj/effect/turf_decal/trimline/blue/filled/warning{
	dir = 4
	},
/obj/effect/turf_decal/trimline/blue/filled/line,
/obj/effect/turf_decal/trimline/blue/line,
/turf/open/floor/wood,
/area/centcom/basketball)
"nE" = (
/obj/effect/turf_decal/siding/wood,
/obj/structure/sign/poster/official/random/directional/north,
/turf/open/floor/wood,
/area/centcom/basketball)
"nW" = (
/obj/effect/turf_decal/stripes/white/line{
	dir = 4
	},
/obj/effect/turf_decal/trimline/blue/line{
	dir = 1
	},
/obj/effect/turf_decal/trimline/blue/filled/warning{
	dir = 4
	},
/turf/open/floor/wood,
/area/centcom/basketball)
"oh" = (
/obj/effect/turf_decal/stripes/white/line,
/obj/effect/turf_decal/trimline/blue/filled/warning,
/turf/open/floor/wood/parquet,
/area/centcom/basketball)
"oR" = (
/obj/effect/turf_decal/tile/dark_green/half/contrasted,
/obj/effect/turf_decal/tile/neutral/half/contrasted{
	dir = 1
	},
/turf/open/floor/wood,
/area/centcom/basketball)
"pu" = (
/obj/structure/chair/plastic,
/turf/open/floor/carpet/red,
/area/centcom/basketball)
"qU" = (
/obj/effect/turf_decal/tile/dark_green/half/contrasted{
	dir = 4
	},
/obj/effect/turf_decal/tile/neutral/half/contrasted{
	dir = 8
	},
/turf/open/floor/wood,
/area/centcom/basketball)
"rS" = (
/obj/effect/turf_decal/stripes/white/line{
	dir = 1
	},
/obj/effect/turf_decal/trimline/blue/filled/warning{
	dir = 1
	},
/turf/open/floor/wood/parquet,
/area/centcom/basketball)
"rU" = (
/obj/effect/turf_decal/trimline/red/line{
	dir = 4
	},
/obj/effect/turf_decal/trimline/red/filled/corner{
	dir = 1
	},
/obj/effect/turf_decal/trimline/red/corner{
	dir = 1
	},
/turf/open/floor/wood,
/area/centcom/basketball)
"sb" = (
/obj/effect/turf_decal/stripes/white/line,
/obj/effect/turf_decal/trimline/red/filled/warning{
	dir = 6
	},
/turf/open/floor/wood/parquet,
/area/centcom/basketball)
"su" = (
/obj/effect/turf_decal/tile/neutral/fourcorners,
/turf/open/floor/wood,
/area/centcom/basketball)
"tO" = (
/turf/open/floor/plating,
/area/centcom/basketball)
"tU" = (
/obj/structure/chair/plastic,
/obj/item/toy/foamfinger,
/turf/open/floor/carpet/blue,
/area/centcom/basketball)
"tX" = (
/turf/open/floor/wood,
/area/centcom/basketball)
"uH" = (
/obj/effect/turf_decal/stripes/white/line,
/obj/effect/turf_decal/trimline/red/warning,
/obj/effect/turf_decal/trimline/red/filled/arrow_ccw{
	dir = 1
	},
/turf/open/floor/wood/parquet,
/area/centcom/basketball)
"uR" = (
/obj/effect/turf_decal/stripes/white/line{
	dir = 1
	},
/obj/effect/turf_decal/trimline/red/filled/warning{
	dir = 1
	},
/turf/open/floor/wood/parquet,
/area/centcom/basketball)
"uW" = (
/obj/effect/turf_decal/stripes/white/line,
/obj/effect/turf_decal/trimline/blue/warning,
/obj/effect/turf_decal/trimline/blue/filled/arrow_cw{
	dir = 1
	},
/turf/open/floor/wood/parquet,
/area/centcom/basketball)
"vo" = (
/obj/effect/turf_decal/stripes/white/line{
	dir = 4
	},
/obj/effect/turf_decal/trimline/blue/filled/line{
	dir = 1
	},
/obj/effect/turf_decal/trimline/blue/filled/warning{
	dir = 4
	},
/obj/effect/turf_decal/trimline/blue/line{
	dir = 1
	},
/turf/open/floor/wood,
/area/centcom/basketball)
"wZ" = (
/obj/structure/table/wood,
/obj/item/reagent_containers/cup/glass/bottle/whiskey,
/turf/open/floor/wood,
/area/centcom/basketball)
"xP" = (
/obj/effect/turf_decal/trimline/red/filled/warning{
	dir = 4
	},
/turf/open/floor/wood/parquet,
/area/centcom/basketball)
"zr" = (
/obj/effect/landmark/basketball/team_spawn/referee,
/turf/open/floor/wood,
/area/centcom/basketball)
"zy" = (
/obj/effect/turf_decal/trimline/blue/filled/line{
	dir = 4
	},
/obj/effect/turf_decal/trimline/blue/line{
	dir = 4
	},
/obj/effect/turf_decal/trimline/blue/line{
	dir = 8
	},
/turf/open/floor/wood,
/area/centcom/basketball)
"zZ" = (
/obj/structure/table/wood,
/obj/effect/spawner/random/entertainment/money_medium,
/turf/open/floor/wood,
/area/centcom/basketball)
"Ax" = (
/obj/machinery/vending/boozeomat,
/turf/open/floor/wood,
/area/centcom/basketball)
"AC" = (
/obj/structure/chair/comfy/brown{
	dir = 1
	},
/turf/open/floor/wood,
/area/centcom/basketball)
"AI" = (
/obj/machinery/status_display,
/turf/closed/indestructible/fakeglass,
/area/centcom/basketball)
"AU" = (
/obj/structure/table/wood,
/obj/machinery/chem_dispenser/drinks/beer/fullupgrade{
	dir = 1
	},
/turf/open/floor/wood,
/area/centcom/basketball)
"Bd" = (
/obj/effect/turf_decal/trimline/blue/line{
	dir = 10
	},
/obj/effect/landmark/basketball/team_spawn/away,
/turf/open/floor/wood,
/area/centcom/basketball)
"BJ" = (
/obj/effect/turf_decal/stripes/white/line{
	dir = 8
	},
/obj/effect/turf_decal/trimline/red/filled/warning{
	dir = 8
	},
/obj/effect/turf_decal/trimline/red/line{
	dir = 1
	},
/turf/open/floor/wood,
/area/centcom/basketball)
"Cv" = (
/obj/effect/turf_decal/stripes/white/line{
	dir = 8
	},
/obj/effect/turf_decal/trimline/red/filled/warning{
	dir = 8
	},
/obj/effect/landmark/basketball/team_spawn/home_hoop,
/obj/structure/hoop/minigame{
	dir = 4
	},
/turf/open/floor/wood,
/area/centcom/basketball)
"Cw" = (
/turf/closed/indestructible/fakeglass,
/area/centcom/basketball)
"CD" = (
/obj/structure/table/wood,
/obj/effect/spawner/random/decoration,
/turf/open/floor/wood,
/area/centcom/basketball)
"CV" = (
/obj/structure/chair/comfy/brown,
/turf/open/floor/wood,
/area/centcom/basketball)
"Dt" = (
/obj/effect/turf_decal/siding/wood{
	dir = 4
	},
/obj/effect/turf_decal/siding/wood/corner{
	dir = 8
	},
/turf/open/floor/wood,
/area/centcom/basketball)
"DP" = (
/obj/effect/turf_decal/stripes/white/line{
	dir = 4
	},
/obj/effect/turf_decal/trimline/blue/filled/warning{
	dir = 4
	},
/obj/effect/landmark/basketball/team_spawn/away_hoop,
/obj/structure/hoop/minigame{
	dir = 8
	},
/turf/open/floor/wood,
/area/centcom/basketball)
"Ev" = (
/mob/living/simple_animal/robot_customer,
/turf/open/floor/wood,
/area/centcom/basketball)
"Gh" = (
/obj/structure/table/wood,
/obj/item/storage/box/drinkingglasses,
/obj/item/reagent_containers/cup/glass/shaker,
/turf/open/floor/wood,
/area/centcom/basketball)
"Gi" = (
/obj/effect/turf_decal/siding/wood{
	dir = 8
	},
/obj/effect/turf_decal/siding/wood{
	dir = 4
	},
/turf/open/floor/wood,
/area/centcom/basketball)
"Hu" = (
/turf/closed/indestructible/riveted,
/area/centcom/basketball)
"HH" = (
/obj/effect/turf_decal/stripes/white/line{
	dir = 1
	},
/obj/effect/turf_decal/trimline/blue/filled/warning{
	dir = 9
	},
/turf/open/floor/wood/parquet,
/area/centcom/basketball)
"Ic" = (
/obj/effect/turf_decal/trimline/red/line{
	dir = 4
	},
/obj/effect/turf_decal/trimline/red/filled/corner{
	dir = 8
	},
/obj/effect/turf_decal/trimline/red/corner{
	dir = 8
	},
/turf/open/floor/wood,
/area/centcom/basketball)
"IA" = (
/obj/effect/turf_decal/trimline/red/line{
	dir = 6
	},
/obj/effect/landmark/basketball/team_spawn/home,
/turf/open/floor/wood,
/area/centcom/basketball)
"JM" = (
/obj/effect/turf_decal/siding/wood/corner{
	dir = 8
	},
/turf/open/floor/wood,
/area/centcom/basketball)
"KH" = (
/obj/effect/turf_decal/stripes/white/line,
/obj/effect/turf_decal/trimline/dark_green/warning,
/obj/effect/turf_decal/trimline/dark_green/filled/warning{
	dir = 1
	},
/turf/open/floor/wood/parquet,
/area/centcom/basketball)
"Lu" = (
/obj/effect/turf_decal/tile/dark_green/anticorner/contrasted,
/turf/open/floor/wood,
/area/centcom/basketball)
"LI" = (
/obj/structure/table/wood,
/obj/effect/spawner/random/entertainment/gambling,
/turf/open/floor/wood,
/area/centcom/basketball)
"LS" = (
/obj/effect/turf_decal/tile/dark_green/half/contrasted{
	dir = 1
	},
/obj/effect/turf_decal/tile/neutral/half/contrasted,
/turf/open/floor/wood,
/area/centcom/basketball)
"LU" = (
/obj/effect/turf_decal/stripes/white/line,
/obj/effect/turf_decal/trimline/red/filled/warning,
/turf/open/floor/wood/parquet,
/area/centcom/basketball)
"LV" = (
/obj/structure/sign/poster/official/random/directional/west,
/turf/open/floor/wood,
/area/centcom/basketball)
"Ma" = (
/obj/effect/turf_decal/trimline/blue/line{
	dir = 8
	},
/obj/effect/turf_decal/trimline/blue/corner,
/obj/effect/turf_decal/trimline/blue/filled/corner,
/turf/open/floor/wood,
/area/centcom/basketball)
"MS" = (
/obj/item/reagent_containers/cup/glass/trophy/silver_cup,
/obj/structure/table/wood/fancy/royalblue,
/turf/open/floor/wood,
/area/centcom/basketball)
"MW" = (
/obj/effect/turf_decal/stripes/white/line{
	dir = 8
	},
/obj/effect/turf_decal/trimline/red/filled/warning{
	dir = 8
	},
/obj/effect/turf_decal/trimline/red/filled/line,
/obj/effect/turf_decal/trimline/red/line{
	dir = 2
	},
/turf/open/floor/wood,
/area/centcom/basketball)
"Nt" = (
/obj/effect/turf_decal/siding/wood{
	dir = 8
	},
/obj/effect/turf_decal/siding/wood/corner{
	dir = 4
	},
/turf/open/floor/wood,
/area/centcom/basketball)
"Oj" = (
/obj/effect/turf_decal/stripes/white/line{
	dir = 6
	},
/obj/effect/turf_decal/trimline/red/filled/warning{
	dir = 9
	},
/turf/open/floor/wood/parquet,
/area/centcom/basketball)
"Om" = (
/obj/effect/turf_decal/stripes/white/line{
	dir = 8
	},
/obj/effect/turf_decal/trimline/red/filled/warning{
	dir = 8
	},
/obj/effect/turf_decal/trimline/red/line{
	dir = 2
	},
/turf/open/floor/wood,
/area/centcom/basketball)
"OB" = (
/obj/structure/chair/plastic,
/turf/open/floor/carpet/blue,
/area/centcom/basketball)
"PU" = (
/obj/effect/turf_decal/siding/wood{
	dir = 4
	},
/turf/open/floor/wood,
/area/centcom/basketball)
"PW" = (
/obj/structure/chair/stool/bar/directional/south,
/turf/open/floor/wood,
/area/centcom/basketball)
"Qa" = (
/obj/effect/turf_decal/stripes/white/line{
	dir = 1
	},
/obj/effect/turf_decal/trimline/blue/warning{
	dir = 1
	},
/obj/effect/turf_decal/trimline/blue/filled/shrink_ccw,
/turf/open/floor/wood/parquet,
/area/centcom/basketball)
"Qh" = (
/obj/effect/turf_decal/siding/wood{
	dir = 4
	},
/obj/effect/turf_decal/siding/wood/corner{
	dir = 1
	},
/turf/open/floor/wood,
/area/centcom/basketball)
"Qi" = (
/obj/effect/turf_decal/trimline/red/filled/line{
	dir = 8
	},
/obj/effect/turf_decal/trimline/red/line{
	dir = 8
	},
/obj/effect/turf_decal/trimline/red/line{
	dir = 4
	},
/turf/open/floor/wood,
/area/centcom/basketball)
"Ql" = (
/obj/structure/sign/poster/official/random/directional/east,
/turf/open/floor/wood,
/area/centcom/basketball)
"Rl" = (
/obj/item/reagent_containers/cup/glass/trophy/gold_cup{
	pixel_x = 0
	},
/obj/structure/table/wood/fancy/royalblue,
/turf/open/floor/wood,
/area/centcom/basketball)
"Se" = (
/obj/effect/turf_decal/siding/wood,
/obj/structure/fireplace,
/turf/open/floor/wood,
/area/centcom/basketball)
"Tc" = (
/obj/machinery/vending/cigarette/syndicate,
/turf/open/floor/wood,
/area/centcom/basketball)
"TV" = (
/obj/effect/turf_decal/trimline/red/filled/warning{
	dir = 4
	},
/obj/effect/landmark/basketball/team_spawn/home,
/turf/open/floor/wood/parquet,
/area/centcom/basketball)
"Uq" = (
/obj/machinery/vending/coffee,
/turf/open/floor/wood,
/area/centcom/basketball)
"Uv" = (
/obj/effect/turf_decal/stripes/white/line,
/obj/effect/turf_decal/trimline/blue/filled/warning{
	dir = 10
	},
/turf/open/floor/wood/parquet,
/area/centcom/basketball)
"Uy" = (
/obj/item/reagent_containers/cup/glass/trophy/bronze_cup,
/obj/structure/table/wood/fancy/royalblue,
/turf/open/floor/wood,
/area/centcom/basketball)
"Vr" = (
/obj/effect/turf_decal/siding/wood/corner{
	dir = 4
	},
/turf/open/floor/wood,
/area/centcom/basketball)
"WB" = (
/obj/machinery/computer/security/telescreen/entertainment/directional/west,
/turf/open/floor/wood,
/area/centcom/basketball)
"WK" = (
/obj/structure/table/wood,
/obj/item/storage/fancy/cigarettes/cigars/havana,
/obj/item/storage/box/matches{
	pixel_x = -3;
	pixel_y = 5
	},
/turf/open/floor/wood,
/area/centcom/basketball)
"WM" = (
/turf/closed/wall/mineral/wood/nonmetal,
/area/centcom/basketball)
"Xm" = (
/obj/effect/turf_decal/tile/dark_green/anticorner/contrasted{
	dir = 1
	},
/turf/open/floor/wood,
/area/centcom/basketball)
"Xn" = (
/obj/effect/turf_decal/siding/wood/corner{
	dir = 1
	},
/turf/open/floor/wood,
/area/centcom/basketball)
"Xo" = (
/obj/effect/turf_decal/stripes/white/line{
	dir = 5
	},
/obj/effect/turf_decal/trimline/red/filled/warning{
	dir = 10
	},
/turf/open/floor/wood/parquet,
/area/centcom/basketball)
"YH" = (
/obj/effect/turf_decal/trimline/blue/filled/warning{
	dir = 8
	},
/obj/effect/landmark/basketball/team_spawn/away,
/turf/open/floor/wood/parquet,
/area/centcom/basketball)
"YX" = (
/obj/item/toy/basketball,
/obj/effect/turf_decal/trimline/dark_green,
/obj/effect/turf_decal/tile/neutral/fourcorners,
/turf/open/floor/wood,
/area/centcom/basketball)
"ZM" = (
/obj/structure/chair/plastic,
/obj/item/toy/foamfinger,
/turf/open/floor/carpet/red,
/area/centcom/basketball)

(1,1,1) = {"
Hu
Hu
Hu
Hu
Hu
Hu
Hu
Hu
Hu
Hu
Hu
Hu
Hu
Hu
Hu
Hu
Hu
Hu
Hu
Hu
Hu
Hu
Hu
Hu
Hu
"}
(2,1,1) = {"
Hu
tO
tO
tO
tO
WM
WM
WM
WM
WM
WM
WM
WM
WM
WM
WM
WM
WM
WM
WM
tO
tO
tO
tO
Hu
"}
(3,1,1) = {"
Hu
tO
tO
tO
tO
WM
fi
tX
tX
WB
tX
tX
LV
tX
tX
WB
tX
tX
fi
WM
tO
tO
tO
tO
Hu
"}
(4,1,1) = {"
Hu
tO
tO
tO
tO
WM
tX
tX
tX
tX
tX
tX
tX
tX
tX
tX
tX
tX
tX
WM
tO
tO
tO
tO
Hu
"}
(5,1,1) = {"
Hu
tO
WM
WM
WM
WM
at
tX
AI
Cw
Cw
Cw
Cw
Cw
Cw
Cw
AI
tX
fj
WM
WM
WM
WM
tO
Hu
"}
(6,1,1) = {"
Hu
tO
WM
dr
PU
PU
Vr
tX
Cw
Oj
BJ
MW
Cv
fB
Om
Xo
Cw
tX
tX
CV
bA
AC
WM
tO
Hu
"}
(7,1,1) = {"
Hu
tO
WM
ly
pu
pu
kc
tX
Cw
uR
aE
Ic
Qi
rU
IA
LU
Cw
tX
tX
tX
tX
tX
WM
tO
Hu
"}
(8,1,1) = {"
Hu
WM
WM
nE
pu
ZM
kc
Ev
Cw
ku
xP
TV
TV
TV
xP
sb
Cw
hf
tX
tX
tX
fj
WM
WM
Hu
"}
(9,1,1) = {"
Hu
WM
Tc
ly
pu
pu
kc
tX
Cw
dC
tX
tX
tX
tX
tX
gq
Cw
tX
tX
tX
Gh
my
cz
WM
Hu
"}
(10,1,1) = {"
Hu
WM
dr
Dt
Gi
Nt
Xn
tX
Cw
dg
tX
Lu
mp
gk
tX
uH
Cw
tX
tX
PW
my
tX
tX
WM
Hu
"}
(11,1,1) = {"
Hu
WM
ly
OB
OB
kc
tX
Uy
Cw
dg
Lu
su
su
su
gk
uH
Cw
tX
tX
PW
LI
tX
fu
WM
Hu
"}
(12,1,1) = {"
Hu
WM
Se
OB
OB
kc
tX
Rl
AI
lR
LS
su
YX
su
oR
KH
AI
zr
tX
PW
wZ
tX
Ax
WM
Hu
"}
(13,1,1) = {"
Hu
WM
ly
tU
OB
kc
tX
MS
Cw
be
eU
su
su
su
Xm
uW
Cw
tX
tX
PW
my
tX
AU
WM
Hu
"}
(14,1,1) = {"
Hu
WM
JM
eS
Gi
Qh
Vr
tX
Cw
be
tX
eU
qU
Xm
tX
uW
Cw
hf
tX
PW
hB
tX
tX
WM
Hu
"}
(15,1,1) = {"
Hu
WM
Uq
ly
pu
ZM
kc
tX
Cw
Qa
tX
tX
tX
tX
tX
dS
Cw
tX
tX
tX
WK
zZ
zZ
WM
Hu
"}
(16,1,1) = {"
Hu
WM
WM
nE
pu
pu
kc
Ev
Cw
HH
dJ
YH
YH
YH
dJ
Uv
Cw
tX
tX
tX
tX
fj
WM
WM
Hu
"}
(17,1,1) = {"
Hu
tO
WM
ly
ZM
pu
kc
tX
Cw
rS
jr
Ma
zy
kT
Bd
oh
Cw
tX
tX
tX
tX
tX
WM
tO
Hu
"}
(18,1,1) = {"
Hu
tO
WM
JM
dM
dM
tX
tX
Cw
kp
nW
mV
DP
vo
aw
lD
Cw
tX
tX
CV
CD
AC
WM
tO
Hu
"}
(19,1,1) = {"
Hu
tO
WM
WM
WM
WM
at
tX
AI
Cw
Cw
Cw
Cw
Cw
Cw
Cw
AI
tX
fj
WM
WM
WM
WM
tO
Hu
"}
(20,1,1) = {"
Hu
tO
tO
tO
tO
WM
tX
tX
tX
tX
tX
tX
tX
tX
tX
tX
tX
tX
tX
WM
tO
tO
tO
tO
Hu
"}
(21,1,1) = {"
Hu
tO
tO
tO
tO
WM
fi
tX
tX
jj
tX
tX
Ql
tX
tX
jj
tX
tX
fi
WM
tO
tO
tO
tO
Hu
"}
(22,1,1) = {"
Hu
tO
tO
tO
tO
WM
WM
WM
WM
WM
WM
WM
WM
WM
WM
WM
WM
WM
WM
WM
tO
tO
tO
tO
Hu
"}
(23,1,1) = {"
Hu
Hu
Hu
Hu
Hu
Hu
Hu
Hu
Hu
Hu
Hu
Hu
Hu
Hu
Hu
Hu
Hu
Hu
Hu
Hu
Hu
Hu
Hu
Hu
Hu
"}
