//MAP CONVERTED BY dmm2tgm.py THIS HEADER COMMENT PREVENTS RECONVERSION, DO NOT REMOVE
"a" = (
/turf/open/space/basic,
/area/space)
"b" = (
/turf/open/floor/engine/plasma,
/area/space)
"c" = (
/obj/machinery/atmospherics/components/unary/vent_pump/siphon/monitored{
	chamber_id = "iceboxplasman2";
	dir = 1
	},
/turf/open/floor/engine/n2,
/area/space)
"d" = (
/obj/machinery/air_sensor{
	chamber_id = "iceboxplasmaoxy"
	},
/turf/open/floor/engine/o2,
/area/space)
"e" = (
/obj/effect/spawner/structure/window/reinforced/plasma,
/obj/machinery/atmospherics/pipe/smart/manifold4w/yellow,
/turf/open/floor/plating,
/area/space)
"f" = (
/obj/effect/turf_decal/tile/yellow/half,
/turf/open/floor/iron/low_pressure_plasma,
/area/space)
"g" = (
/obj/machinery/atmospherics/components/unary/outlet_injector/monitored{
	chamber_id = "iceboxplasmaair";
	dir = 1
	},
/turf/open/floor/engine/air,
/area/space)
"i" = (
/obj/effect/spawner/structure/window/reinforced/plasma,
/obj/machinery/atmospherics/pipe/smart/manifold4w/purple,
/turf/open/floor/plating,
/area/space)
"j" = (
/obj/machinery/air_sensor{
	chamber_id = "iceboxplasmaair"
	},
/turf/open/floor/engine/air,
/area/space)
"k" = (
/turf/open/floor/engine/n2,
/area/space)
"l" = (
/obj/machinery/atmospherics/pipe/layer_manifold/green/visible,
/turf/open/floor/iron/low_pressure_plasma,
/area/space)
"m" = (
/turf/open/floor/plating,
/area/space)
"n" = (
/obj/machinery/atmospherics/components/unary/outlet_injector/monitored{
	chamber_id = "iceboxplasman2";
	dir = 1
	},
/turf/open/floor/engine/n2,
/area/space)
"o" = (
/obj/effect/spawner/structure/window/reinforced/plasma,
/obj/machinery/atmospherics/pipe/smart/manifold4w/yellow/visible,
/turf/open/floor/plating,
/area/space)
"p" = (
/obj/machinery/atmospherics/components/unary/outlet_injector/monitored{
	chamber_id = "iceboxplasmaco2"
	},
/turf/open/floor/engine/co2/equalized_with_regular_air,
/area/space)
"q" = (
/obj/effect/spawner/random/vending/snackvend,
/turf/open/floor/iron/low_pressure_plasma,
/area/space)
"r" = (
/obj/machinery/atmospherics/components/unary/vent_pump/siphon/monitored{
	chamber_id = "iceboxplasmaair";
	dir = 1
	},
/turf/open/floor/engine/air,
/area/space)
"s" = (
/obj/machinery/atmospherics/pipe/smart/manifold4w/yellow/visible,
/turf/open/floor/iron/low_pressure_plasma,
/area/space)
"t" = (
/turf/open/floor/engine/air,
/area/space)
"u" = (
/obj/machinery/atmospherics/components/unary/outlet_injector/monitored{
	chamber_id = "iceboxplasman2o"
	},
/turf/open/floor/engine/n2o,
/area/space)
"v" = (
/obj/machinery/atmospherics/pipe/layer_manifold/dark/visible,
/turf/open/floor/iron/low_pressure_plasma,
/area/space)
"w" = (
/obj/effect/spawner/structure/window/reinforced/plasma,
/obj/machinery/atmospherics/pipe/smart/manifold4w/dark,
/turf/open/floor/plating,
/area/space)
"x" = (
/obj/machinery/atmospherics/components/unary/vent_pump/siphon/monitored{
	chamber_id = "iceboxplasmaco2"
	},
/turf/open/floor/engine/co2/equalized_with_regular_air,
/area/space)
"y" = (
/obj/machinery/air_sensor{
	chamber_id = "iceboxplasmaplas"
	},
/turf/open/floor/engine/plasma,
/area/space)
"z" = (
/turf/open/floor/engine/o2,
/area/space)
"A" = (
/obj/effect/spawner/random/vending/colavend,
/turf/open/floor/iron/low_pressure_plasma,
/area/space)
"B" = (
/turf/open/floor/engine/co2/equalized_with_regular_air,
/area/space)
"C" = (
/obj/effect/spawner/structure/window/reinforced/plasma,
/turf/open/floor/plating,
/area/space)
"D" = (
/turf/closed/wall/r_wall,
/area/space)
"E" = (
/turf/open/floor/iron/low_pressure_plasma,
/area/space)
"F" = (
/obj/machinery/atmospherics/components/unary/thermomachine,
/turf/open/floor/iron/low_pressure_plasma,
/area/space)
"G" = (
/obj/effect/turf_decal/tile/yellow/half,
/obj/machinery/atmospherics/pipe/smart/manifold4w/yellow/visible,
/turf/open/floor/iron/low_pressure_plasma,
/area/space)
"H" = (
/obj/machinery/air_sensor{
	chamber_id = "iceboxplasmaco2"
	},
/turf/open/floor/engine/co2/equalized_with_regular_air,
/area/space)
"I" = (
/turf/open/floor/plating/low_pressure_plasma,
/area/space)
"J" = (
/obj/machinery/atmospherics/pipe/layer_manifold/purple/visible,
/turf/open/floor/iron/low_pressure_plasma,
/area/space)
"K" = (
/obj/machinery/atmospherics/pipe/smart/manifold4w/cyan,
/turf/open/floor/iron/low_pressure_plasma,
/area/space)
"L" = (
/obj/machinery/atmospherics/components/unary/outlet_injector/monitored{
	chamber_id = "iceboxplasmaplas"
	},
/turf/open/floor/engine/plasma,
/area/space)
"M" = (
/obj/effect/spawner/structure/window/reinforced/plasma,
/obj/machinery/atmospherics/pipe/smart/manifold4w/cyan,
/turf/open/floor/plating,
/area/space)
"N" = (
/turf/open/floor/engine/n2o,
/area/space)
"O" = (
/obj/effect/spawner/structure/window/reinforced/plasma,
/obj/machinery/atmospherics/pipe/smart/manifold4w/green,
/turf/open/floor/plating,
/area/space)
"P" = (
/obj/machinery/atmospherics/components/unary/vent_pump/siphon/monitored{
	chamber_id = "iceboxplasmaoxy";
	dir = 1
	},
/turf/open/floor/engine/o2,
/area/space)
"Q" = (
/turf/closed/wall,
/area/space)
"R" = (
/obj/machinery/atmospherics/components/trinary/mixer/airmix/inverse{
	dir = 4
	},
/turf/open/floor/iron/low_pressure_plasma,
/area/space)
"S" = (
/obj/machinery/atmospherics/components/unary/vent_pump/siphon/monitored{
	chamber_id = "iceboxplasmaplas"
	},
/turf/open/floor/engine/plasma,
/area/space)
"T" = (
/obj/structure/fans/tiny,
/turf/open/space/basic,
/area/space)
"U" = (
/obj/machinery/atmospherics/pipe/layer_manifold/yellow/visible,
/obj/effect/turf_decal/tile/yellow/half,
/turf/open/floor/iron/low_pressure_plasma,
/area/space)
"V" = (
/obj/effect/turf_decal/tile/yellow/half,
/obj/machinery/light/directional/south,
/turf/open/floor/iron/low_pressure_plasma,
/area/space)
"W" = (
/obj/machinery/atmospherics/components/unary/vent_pump/siphon/monitored{
	chamber_id = "iceboxplasman2o"
	},
/turf/open/floor/engine/n2o,
/area/space)
"X" = (
/obj/machinery/atmospherics/components/unary/outlet_injector/monitored{
	chamber_id = "iceboxplasmaoxy";
	dir = 1
	},
/turf/open/floor/engine/o2,
/area/space)
"Y" = (
/obj/machinery/air_sensor{
	chamber_id = "iceboxplasman2"
	},
/turf/open/floor/engine/n2,
/area/space)
"Z" = (
/obj/machinery/air_sensor{
	chamber_id = "iceboxplasman2o"
	},
/turf/open/floor/engine/n2o,
/area/space)

(1,1,1) = {"
a
a
a
a
a
a
a
a
a
a
a
a
a
a
a
a
a
a
a
a
a
a
a
a
a
a
a
a
a
a
a
a
a
a
a
a
a
a
a
a
a
a
a
a
a
a
a
a
a
a
"}
(2,1,1) = {"
a
a
a
a
a
a
a
a
a
a
a
a
a
a
a
a
a
a
a
a
a
a
a
a
a
a
a
a
a
a
a
a
a
a
a
a
a
a
a
a
a
a
a
a
a
a
a
a
a
a
"}
(3,1,1) = {"
a
a
a
a
a
a
a
a
a
a
a
a
a
a
a
a
a
a
a
a
a
a
a
a
a
a
a
a
a
a
a
a
a
a
a
a
a
a
a
a
a
a
a
a
a
a
a
a
a
a
"}
(4,1,1) = {"
a
a
a
a
a
a
a
a
a
a
a
a
a
a
a
a
a
a
a
a
a
a
a
a
a
a
a
a
a
a
a
a
a
a
a
a
a
a
a
a
a
a
a
a
a
a
a
a
a
a
"}
(5,1,1) = {"
a
a
a
a
a
a
a
a
a
a
a
a
a
a
a
a
a
a
a
a
a
a
a
a
a
a
a
a
a
a
a
m
m
m
m
m
m
m
a
a
a
a
a
a
a
a
a
a
a
a
"}
(6,1,1) = {"
a
a
a
a
a
a
a
a
a
a
a
a
a
a
a
a
a
a
a
a
a
a
a
a
a
a
a
a
a
a
m
m
E
E
E
E
E
m
m
a
a
a
a
a
a
a
a
a
a
a
"}
(7,1,1) = {"
a
a
a
a
a
a
a
a
a
a
a
a
a
a
a
a
a
a
a
a
a
a
a
a
a
a
a
a
a
m
m
E
E
E
E
E
E
E
m
m
a
a
a
a
a
a
a
a
a
a
"}
(8,1,1) = {"
a
a
a
a
a
a
a
a
a
a
a
a
a
a
a
a
a
a
a
a
Q
Q
Q
Q
Q
Q
Q
Q
Q
Q
E
E
E
E
E
E
E
E
E
m
m
a
a
a
a
a
a
a
a
a
"}
(9,1,1) = {"
a
a
a
a
a
a
a
a
a
a
a
a
a
a
a
a
a
a
a
a
Q
E
E
E
E
E
E
E
Q
E
E
E
E
E
E
E
E
E
E
E
m
a
a
a
a
a
a
a
a
a
"}
(10,1,1) = {"
a
a
a
a
a
a
a
a
a
a
a
a
a
a
a
a
a
a
a
a
Q
E
E
E
E
E
E
E
Q
E
E
E
E
E
E
E
E
E
E
E
m
a
a
a
a
a
a
a
a
a
"}
(11,1,1) = {"
a
a
a
a
a
a
a
a
a
a
a
a
a
a
a
a
a
a
a
a
Q
E
E
E
E
E
E
E
E
E
E
E
E
E
E
E
E
E
E
E
m
a
a
a
a
a
a
a
a
a
"}
(12,1,1) = {"
a
a
a
a
a
a
a
a
a
a
a
a
a
a
a
a
a
a
a
a
a
E
E
E
E
E
E
E
Q
E
E
E
E
E
E
E
E
E
E
E
m
a
a
a
a
a
a
a
a
a
"}
(13,1,1) = {"
a
a
a
a
a
a
a
a
a
a
a
a
a
a
a
a
a
a
a
a
Q
E
E
E
E
E
E
E
Q
E
E
E
E
E
E
E
E
E
E
E
m
a
a
a
a
a
a
a
a
a
"}
(14,1,1) = {"
a
a
a
a
a
a
a
a
Q
Q
T
Q
Q
Q
Q
Q
Q
Q
Q
Q
Q
Q
E
Q
Q
Q
Q
Q
Q
Q
Q
Q
Q
Q
E
Q
Q
Q
Q
Q
Q
a
a
a
a
a
a
a
a
a
"}
(15,1,1) = {"
a
a
a
a
a
a
a
a
Q
E
E
E
Q
E
E
E
Q
E
E
E
Q
A
E
E
Q
E
E
E
Q
E
E
E
E
E
E
E
E
E
E
E
Q
a
a
a
a
a
a
a
a
a
"}
(16,1,1) = {"
a
a
a
a
a
a
a
a
T
E
E
E
Q
E
E
E
Q
E
E
E
Q
q
E
E
Q
E
E
E
Q
E
E
E
E
E
E
E
E
E
E
E
m
a
a
a
a
a
a
a
a
a
"}
(17,1,1) = {"
a
a
a
a
a
a
a
a
Q
E
E
E
Q
E
E
E
Q
E
E
E
Q
E
E
E
Q
E
E
E
Q
E
E
E
E
E
E
E
E
E
E
E
m
a
a
a
a
a
a
a
a
a
"}
(18,1,1) = {"
a
a
a
a
a
a
Q
Q
Q
Q
E
Q
Q
Q
E
Q
Q
Q
E
Q
Q
E
E
E
Q
Q
E
Q
Q
E
E
E
E
E
E
E
E
E
E
E
m
a
a
a
a
a
a
a
a
a
"}
(19,1,1) = {"
a
a
a
a
a
a
Q
E
E
E
E
E
E
E
E
E
E
E
E
E
E
E
E
E
E
E
E
E
Q
E
E
E
E
E
E
E
E
E
E
E
m
a
a
a
a
a
a
a
a
a
"}
(20,1,1) = {"
a
a
a
a
a
a
m
E
E
E
E
E
E
E
E
E
E
E
E
E
E
E
E
E
E
E
E
E
E
E
E
E
E
E
E
E
E
E
E
E
m
a
a
a
a
a
a
a
a
a
"}
(21,1,1) = {"
a
a
a
a
a
a
m
E
E
E
E
E
E
E
E
E
E
E
E
E
E
E
E
E
E
E
E
E
Q
E
E
E
E
E
E
E
E
E
E
E
m
a
a
a
a
a
a
a
a
a
"}
(22,1,1) = {"
a
a
a
a
a
a
m
E
E
E
E
E
Q
Q
E
Q
Q
Q
E
Q
Q
E
E
E
Q
Q
E
Q
Q
E
E
E
E
E
E
E
E
E
E
E
m
a
a
a
a
a
a
a
a
a
"}
(23,1,1) = {"
a
a
a
a
a
a
m
E
E
E
E
E
Q
E
E
E
Q
E
E
E
Q
E
E
E
Q
E
E
E
Q
E
E
E
E
E
E
E
E
E
E
E
m
a
a
a
a
a
a
a
a
a
"}
(24,1,1) = {"
a
a
a
a
a
a
m
E
E
E
E
E
Q
E
E
E
Q
E
E
E
Q
E
E
E
Q
E
E
E
Q
E
E
E
E
E
E
E
E
E
E
E
m
a
a
a
a
a
a
a
a
a
"}
(25,1,1) = {"
a
a
a
a
a
a
Q
E
E
E
E
E
Q
E
E
E
Q
E
E
E
Q
E
E
E
Q
E
E
E
Q
E
E
E
E
E
E
E
E
E
E
E
Q
a
a
a
a
a
a
a
a
a
"}
(26,1,1) = {"
a
a
a
a
a
a
Q
Q
Q
Q
Q
Q
Q
Q
Q
Q
Q
Q
Q
Q
Q
Q
E
Q
Q
Q
Q
Q
Q
Q
Q
Q
Q
Q
E
Q
Q
Q
Q
Q
Q
a
a
a
a
a
a
a
a
a
"}
(27,1,1) = {"
a
a
a
a
a
a
a
a
Q
E
E
E
E
E
E
E
E
E
E
E
Q
E
E
E
E
E
E
Q
E
E
E
E
Q
E
E
E
Q
a
a
a
a
a
a
a
a
a
a
a
a
a
"}
(28,1,1) = {"
a
a
a
a
a
a
a
a
Q
E
E
E
E
E
E
E
E
E
E
E
Q
E
E
E
E
E
E
I
E
E
E
E
Q
E
E
E
T
a
a
a
a
a
a
a
a
a
a
a
a
a
"}
(29,1,1) = {"
a
a
a
a
a
a
a
a
Q
E
E
E
E
E
E
E
E
E
E
E
E
E
E
E
E
E
E
I
E
E
E
E
Q
E
E
E
Q
a
a
a
a
a
a
a
a
a
a
a
a
a
"}
(30,1,1) = {"
a
a
a
a
a
a
a
a
Q
E
E
E
E
E
E
E
E
E
E
E
Q
E
E
E
E
E
E
I
E
E
E
E
Q
Q
T
Q
Q
a
a
a
a
a
a
a
a
a
a
a
a
a
"}
(31,1,1) = {"
a
a
a
a
a
a
a
a
Q
E
E
E
E
E
E
E
E
E
E
E
Q
E
E
E
E
E
E
Q
E
E
E
E
Q
a
a
a
a
a
a
a
a
a
a
a
a
a
a
a
a
a
"}
(32,1,1) = {"
a
a
a
a
a
a
a
a
D
D
D
D
D
E
E
E
E
E
E
D
D
D
D
D
E
E
E
Q
Q
I
I
Q
Q
a
a
a
a
a
a
a
a
a
a
a
a
a
a
a
a
a
"}
(33,1,1) = {"
a
a
a
a
a
a
a
a
D
b
b
S
i
J
E
E
E
E
f
w
X
z
z
D
E
E
E
I
E
E
E
E
Q
a
a
a
a
a
a
a
a
a
a
a
a
a
a
a
a
a
"}
(34,1,1) = {"
a
a
a
a
a
a
a
a
D
b
y
b
C
F
E
E
E
E
f
C
z
d
z
D
E
E
E
I
E
E
E
E
a
a
a
a
a
a
a
a
a
a
a
a
a
a
a
a
a
a
"}
(35,1,1) = {"
a
a
a
a
a
a
a
a
D
b
b
L
w
E
E
E
K
s
U
o
P
z
z
D
Q
E
Q
Q
E
E
E
E
a
a
a
a
a
a
a
a
a
a
a
a
a
a
a
a
a
a
"}
(36,1,1) = {"
a
a
a
a
a
a
a
a
D
D
D
D
D
E
E
E
K
s
f
D
D
D
D
D
E
E
E
E
E
E
E
E
a
a
a
a
a
a
a
a
a
a
a
a
a
a
a
a
a
a
"}
(37,1,1) = {"
a
a
a
a
a
a
a
a
D
N
N
W
O
l
E
E
K
s
f
w
n
k
k
D
E
E
E
E
E
E
E
E
a
a
a
a
a
a
a
a
a
a
a
a
a
a
a
a
a
a
"}
(38,1,1) = {"
a
a
a
a
a
a
a
a
D
N
Z
N
C
E
E
E
K
s
f
C
k
Y
k
D
E
E
E
E
E
E
E
E
Q
a
a
a
a
a
a
a
a
a
a
a
a
a
a
a
a
a
"}
(39,1,1) = {"
a
a
a
a
a
a
a
a
D
N
N
u
w
E
E
E
K
R
U
o
c
k
k
D
E
E
E
E
E
E
E
E
Q
a
a
a
a
a
a
a
a
a
a
a
a
a
a
a
a
a
"}
(40,1,1) = {"
a
a
a
a
a
a
a
a
D
D
D
D
D
E
E
E
K
s
V
D
D
D
D
D
E
E
E
E
E
E
E
E
Q
a
a
a
a
a
a
a
a
a
a
a
a
a
a
a
a
a
"}
(41,1,1) = {"
a
a
a
a
a
a
a
a
D
B
B
x
w
v
E
E
K
s
G
e
g
t
t
D
Q
Q
Q
Q
Q
Q
Q
Q
Q
a
a
a
a
a
a
a
a
a
a
a
a
a
a
a
a
a
"}
(42,1,1) = {"
a
a
a
a
a
a
a
a
D
B
H
B
C
E
E
E
K
E
f
C
t
j
t
D
a
a
a
a
a
a
a
a
a
a
a
a
a
a
a
a
a
a
a
a
a
a
a
a
a
a
"}
(43,1,1) = {"
a
a
a
a
a
a
a
a
D
B
B
p
w
E
E
E
K
K
K
M
r
t
t
D
a
a
a
a
a
a
a
a
a
a
a
a
a
a
a
a
a
a
a
a
a
a
a
a
a
a
"}
(44,1,1) = {"
a
a
a
a
a
a
a
a
D
D
D
D
D
D
C
C
C
C
D
D
D
D
D
D
a
a
a
a
a
a
a
a
a
a
a
a
a
a
a
a
a
a
a
a
a
a
a
a
a
a
"}
(45,1,1) = {"
a
a
a
a
a
a
a
a
a
a
a
a
a
a
a
a
a
a
a
a
a
a
a
a
a
a
a
a
a
a
a
a
a
a
a
a
a
a
a
a
a
a
a
a
a
a
a
a
a
a
"}
(46,1,1) = {"
a
a
a
a
a
a
a
a
a
a
a
a
a
a
a
a
a
a
a
a
a
a
a
a
a
a
a
a
a
a
a
a
a
a
a
a
a
a
a
a
a
a
a
a
a
a
a
a
a
a
"}
(47,1,1) = {"
a
a
a
a
a
a
a
a
a
a
a
a
a
a
a
a
a
a
a
a
a
a
a
a
a
a
a
a
a
a
a
a
a
a
a
a
a
a
a
a
a
a
a
a
a
a
a
a
a
a
"}
(48,1,1) = {"
a
a
a
a
a
a
a
a
a
a
a
a
a
a
a
a
a
a
a
a
a
a
a
a
a
a
a
a
a
a
a
a
a
a
a
a
a
a
a
a
a
a
a
a
a
a
a
a
a
a
"}
(49,1,1) = {"
a
a
a
a
a
a
a
a
a
a
a
a
a
a
a
a
a
a
a
a
a
a
a
a
a
a
a
a
a
a
a
a
a
a
a
a
a
a
a
a
a
a
a
a
a
a
a
a
a
a
"}
(50,1,1) = {"
a
a
a
a
a
a
a
a
a
a
a
a
a
a
a
a
a
a
a
a
a
a
a
a
a
a
a
a
a
a
a
a
a
a
a
a
a
a
a
a
a
a
a
a
a
a
a
a
a
a
"}
