//MAP CONVERTED BY dmm2tgm.py THIS HEADER COMMENT PREVENTS RECONVERSION, DO NOT REMOVE
"l" = (
/turf/template_noop,
/area/template_noop)
"q" = (
/obj/effect/decal/cleanable/dirt,
/obj/machinery/door/airlock/maintenance_hatch{
	name = "Construction Storage"
	},
/obj/effect/mapping_helpers/airlock/unres{
	dir = 1
	},
/obj/effect/mapping_helpers/airlock/access/all/engineering/construction,
/obj/machinery/atmospherics/pipe/smart/manifold4w/supply/hidden/layer4,
/obj/machinery/atmospherics/pipe/smart/manifold4w/scrubbers/hidden/layer2,
/obj/modular_map_connector,
/turf/open/floor/catwalk_floor,
/area/station/maintenance/central/lesser)
"s" = (
/obj/effect/decal/cleanable/dirt,
/obj/machinery/light/small/directional/west,
/turf/open/floor/iron/smooth,
/area/station/maintenance/central/lesser)
"u" = (
/obj/effect/decal/cleanable/dirt,
/obj/structure/rack,
/obj/item/stack/sheet/glass/fifty,
/obj/item/stack/sheet/rglass{
	amount = 50
	},
/turf/open/floor/iron/smooth,
/area/station/maintenance/central/lesser)
"x" = (
/obj/effect/decal/cleanable/dirt,
/obj/effect/turf_decal/bot{
	dir = 1
	},
/obj/structure/reagent_dispensers/watertank,
/turf/open/floor/plating,
/area/station/maintenance/central/lesser)
"F" = (
/obj/effect/decal/cleanable/dirt,
/obj/structure/table,
/obj/item/storage/toolbox/mechanical{
	pixel_y = 5
	},
/obj/item/flashlight{
	pixel_x = 1;
	pixel_y = 5
	},
/obj/item/clothing/head/utility/welding{
	pixel_x = -5;
	pixel_y = 3
	},
/turf/open/floor/iron/smooth,
/area/station/maintenance/central/lesser)
"K" = (
/obj/structure/grille,
/obj/effect/decal/cleanable/dirt,
/turf/open/floor/iron/smooth,
/area/station/maintenance/central/lesser)
"L" = (
/obj/effect/decal/cleanable/dirt,
/obj/effect/turf_decal/bot{
	dir = 1
	},
/obj/machinery/portable_atmospherics/scrubber,
/turf/open/floor/plating,
/area/station/maintenance/central/lesser)
"M" = (
/turf/closed/mineral/random/stationside/asteroid/porus,
/area/misc/asteroid)
"Q" = (
/obj/effect/decal/cleanable/dirt,
/obj/structure/rack,
/obj/item/stack/sheet/iron/fifty,
/obj/item/stack/rods/fifty,
/turf/open/floor/iron/smooth,
/area/station/maintenance/central/lesser)
"U" = (
/obj/effect/decal/cleanable/dirt,
/obj/effect/turf_decal/bot{
	dir = 1
	},
/obj/structure/reagent_dispensers/fueltank,
/turf/open/floor/plating,
/area/station/maintenance/central/lesser)
"X" = (
/turf/closed/wall,
/area/station/maintenance/central/lesser)
"Z" = (
/obj/effect/decal/cleanable/dirt,
/turf/open/floor/iron/smooth,
/area/station/maintenance/central/lesser)

(1,1,1) = {"
M
M
X
X
X
X
X
X
l
"}
(2,1,1) = {"
M
M
X
U
K
Z
s
Z
l
"}
(3,1,1) = {"
M
M
X
L
K
Z
Z
Z
q
"}
(4,1,1) = {"
M
M
X
x
K
Z
Z
Z
l
"}
(5,1,1) = {"
l
l
l
l
l
Q
F
u
l
"}
(6,1,1) = {"
l
l
l
l
l
l
l
l
l
"}
