//MAP CONVERTED BY dmm2tgm.py THIS HEADER COMMENT PREVENTS RECONVERSION, DO NOT REMOVE
"a" = (
/turf/closed/mineral/random/stationside/asteroid/porus,
/area/mine/explored)
"c" = (
/turf/open/misc/asteroid/airless,
/area/mine/explored)
"e" = (
/obj/effect/spawner/random/trash/grille_or_waste,
/turf/open/misc/asteroid/airless,
/area/mine/explored)
"h" = (
/obj/structure/table,
/obj/item/reagent_containers/food/drinks/bottle/beer{
	pixel_x = 7;
	pixel_y = 5
	},
/obj/effect/spawner/random/food_or_drink/donkpockets,
/turf/open/misc/asteroid/airless,
/area/mine/explored)
"k" = (
/obj/effect/spawner/random/trash/cigbutt,
/turf/open/misc/asteroid/airless,
/area/mine/explored)
"o" = (
/obj/item/relic,
/turf/open/misc/asteroid/airless,
/area/mine/explored)
"r" = (
/obj/effect/spawner/random/trash/hobo_squat,
/obj/item/bedsheet/brown,
/obj/structure/sign/poster/contraband/imperial_propaganda{
	pixel_y = 32
	},
/turf/open/misc/asteroid/airless,
/area/mine/explored)
"t" = (
/obj/item/stack/ore/glass,
/turf/open/misc/asteroid/airless,
/area/mine/explored)
"u" = (
/obj/item/pickaxe/mini{
	pixel_x = 5;
	pixel_y = -1
	},
/turf/open/misc/asteroid/airless,
/area/mine/explored)
"x" = (
/turf/template_noop,
/area/template_noop)
"y" = (
/turf/closed/wall,
/area/mine/explored)
"z" = (
/obj/structure/water_source/puddle,
/turf/open/misc/asteroid/airless,
/area/mine/explored)
"E" = (
/obj/modular_map_connector,
/turf/closed/wall/rock/porous,
/area/mine/explored)
"I" = (
/obj/item/stack/ore/iron{
	pixel_y = -11
	},
/turf/open/misc/asteroid/airless,
/area/mine/explored)
"V" = (
/obj/item/kirbyplants/random,
/turf/open/misc/asteroid/airless,
/area/mine/explored)

(1,1,1) = {"
a
y
r
V
c
c
c
c
c
c
u
a
x
x
x
"}
(2,1,1) = {"
a
h
c
k
a
c
a
a
a
a
c
a
x
x
x
"}
(3,1,1) = {"
a
a
a
a
a
e
c
I
t
a
c
a
a
a
x
"}
(4,1,1) = {"
E
c
c
a
a
a
a
a
c
a
z
e
c
a
a
"}
(5,1,1) = {"
a
I
c
t
c
c
a
a
e
a
a
a
c
o
t
"}
(6,1,1) = {"
a
a
a
a
c
c
c
c
c
c
c
a
a
a
a
"}
