//MAP CONVERTED BY dmm2tgm.py THIS HEADER COMMENT PREVENTS RECONVERSION, DO NOT REMOVE
"a" = (
/turf/closed/wall,
/area/maintenance/department/crew_quarters/dorms)
"d" = (
/obj/item/relic,
/turf/open/floor/plating/asteroid,
/area/mine/explored)
"e" = (
/obj/item/stack/ore/iron,
/turf/open/floor/plating/asteroid,
/area/mine/explored)
"k" = (
/obj/effect/turf_decal/sand/plating,
/obj/item/stack/ore/glass,
/turf/open/floor/plating,
/area/maintenance/department/crew_quarters/dorms)
"l" = (
/obj/effect/turf_decal/sand,
/turf/open/floor/iron/smooth,
/area/maintenance/department/crew_quarters/dorms)
"n" = (
/turf/open/floor/plating/asteroid,
/area/mine/explored)
"t" = (
/obj/modular_map_connector,
/obj/machinery/door/airlock/maintenance_hatch{
	req_one_access_txt = "12"
	},
/obj/effect/decal/cleanable/dirt,
/obj/effect/mapping_helpers/airlock/locked,
/turf/open/floor/iron/smooth,
/area/maintenance/department/crew_quarters/dorms)
"u" = (
/obj/effect/spawner/random/structure/girder,
/turf/open/floor/plating/asteroid,
/area/mine/explored)
"x" = (
/obj/effect/turf_decal/sand/plating,
/turf/open/floor/plating,
/area/maintenance/department/crew_quarters/dorms)
"A" = (
/turf/template_noop,
/area/template_noop)
"C" = (
/obj/item/shovel{
	pixel_x = -5
	},
/turf/open/floor/plating/asteroid,
/area/mine/explored)
"G" = (
/obj/item/stack/ore/glass,
/turf/open/floor/plating/asteroid,
/area/mine/explored)
"J" = (
/turf/closed/mineral/random/stationside/asteroid/porus,
/area/mine/explored)
"K" = (
/turf/closed/wall,
/area/template_noop)

(1,1,1) = {"
J
J
J
J
a
a
a
a
"}
(2,1,1) = {"
J
J
n
u
k
x
l
a
"}
(3,1,1) = {"
G
n
n
e
A
A
t
a
"}
(4,1,1) = {"
n
C
n
K
A
A
A
A
"}
(5,1,1) = {"
d
J
n
K
A
A
A
A
"}
(6,1,1) = {"
A
A
A
A
A
A
A
A
"}
