//MAP CONVERTED BY dmm2tgm.py THIS HEADER COMMENT PREVENTS RECONVERSION, DO NOT REMOVE
"a" = (
/obj/structure/table/wood,
/obj/effect/decal/cleanable/dirt,
/obj/item/camera_film{
	pixel_x = 3;
	pixel_y = 3
	},
/obj/item/camera_film{
	pixel_y = 9
	},
/obj/item/camera,
/turf/open/floor/iron/smooth,
/area/station/maintenance/port/aft)
"e" = (
/obj/effect/decal/cleanable/dirt,
/obj/machinery/light/small/blacklight/directional/south,
/turf/open/floor/iron/smooth,
/area/station/maintenance/port/aft)
"g" = (
/obj/structure/cable,
/obj/effect/decal/cleanable/dirt,
/turf/open/floor/catwalk_floor,
/area/station/maintenance/port/aft)
"k" = (
/obj/structure/closet/crate{
	name = "corporate approved leisure-time activites pack"
	},
/obj/item/storage/dice,
/obj/item/canvas/nineteen_nineteen,
/obj/item/canvas/nineteen_nineteen,
/obj/item/storage/crayons,
/obj/item/toy/crayon/spraycan,
/obj/effect/decal/cleanable/dirt,
/obj/item/toy/figure/curator,
/turf/open/floor/iron/smooth,
/area/station/maintenance/port/aft)
"o" = (
/obj/structure/cable,
/obj/machinery/door/airlock/maintenance_hatch{
	name = "Communal Services Storage"
	},
/obj/modular_map_connector,
/obj/effect/decal/cleanable/dirt,
/obj/effect/mapping_helpers/airlock/access/any/service/library,
/obj/effect/mapping_helpers/airlock/access/any/service/chapel_office,
/obj/effect/mapping_helpers/airlock/unres,
/turf/open/floor/catwalk_floor,
/area/station/maintenance/port/aft)
"p" = (
/obj/structure/rack,
/obj/effect/decal/cleanable/cobweb/cobweb2,
/obj/effect/decal/cleanable/dirt,
/obj/item/taperecorder,
/obj/item/tape{
	pixel_y = -4
	},
/obj/item/tape,
/turf/open/floor/iron/smooth,
/area/station/maintenance/port/aft)
"q" = (
/obj/structure/cable,
/obj/machinery/power/apc/auto_name/directional/north,
/obj/effect/decal/cleanable/dirt,
/turf/open/floor/catwalk_floor,
/area/station/maintenance/port/aft)
"z" = (
/obj/structure/table/wood,
/obj/item/paper_bin,
/obj/effect/decal/cleanable/dirt,
/obj/item/pen/red,
/obj/item/pen/blue{
	pixel_x = 5;
	pixel_y = 5
	},
/turf/open/floor/iron/smooth,
/area/station/maintenance/port/aft)
"B" = (
/turf/template_noop,
/area/template_noop)
"C" = (
/obj/effect/decal/cleanable/dirt,
/obj/structure/rack,
/obj/item/storage/fancy/candle_box{
	pixel_y = 5
	},
/obj/item/storage/fancy/candle_box{
	pixel_x = -2;
	pixel_y = 2
	},
/obj/item/storage/book/bible,
/turf/open/floor/iron/smooth,
/area/station/maintenance/port/aft)
"L" = (
/obj/effect/decal/cleanable/cobweb,
/obj/structure/filingcabinet,
/obj/effect/decal/cleanable/dirt,
/obj/item/paper{
	name = "mime's request list"
	},
/obj/item/paper{
	default_raw_text = "The Stars Below. I Died And ReIncarnated As a Cute Plasma Skeleton?! Ashwalker Love: Sandy Tunnels. I Fell In Love With A Rogue AI. The Hop Gave Me All Access To Their Heart.Hairballs In Bed: A Feline Story.";
	name = "failed sci-fi romance novel names"
	},
/obj/item/paper{
	default_raw_text = "A comprehensive list of various overdue books, their associated current owner and the amount owed by them at this point. All of them are copies of 'Fantastic Beasts and Where to Find Them' taken out by crewmember 'Hunts-The-Beasts'.";
	name = "overdue books list"
	},
/obj/item/paper{
	default_raw_text = "1. Steal the chaplain's candles for better mood lighting. 2. Expand the adult literature section. 3. Prevent assistants from unscrewing my wooden floorboards. 4. Buy more paper from cargo. 5. Figure out who keeps drawing dicks in the fiction books.";
	name = "library to-do list"
	},
/turf/open/floor/iron/smooth,
/area/station/maintenance/port/aft)
"O" = (
/turf/closed/wall,
/area/station/maintenance/port/aft)
"Q" = (
/obj/structure/closet/crate{
	name = "crew literature pack"
	},
/obj/item/book/manual/random,
/obj/item/book/manual/random,
/obj/item/book/manual/random,
/obj/item/book/manual/random,
/obj/item/book/manual/wiki/medicine,
/obj/item/book/manual/wiki/cytology,
/obj/item/book/manual/wiki/surgery,
/obj/effect/decal/cleanable/dirt,
/turf/open/floor/iron/smooth,
/area/station/maintenance/port/aft)
"T" = (
/obj/effect/decal/cleanable/dirt,
/turf/open/floor/iron/smooth,
/area/station/maintenance/port/aft)

(1,1,1) = {"
O
O
O
O
O
O
"}
(2,1,1) = {"
O
L
C
Q
k
O
"}
(3,1,1) = {"
o
g
T
T
T
O
"}
(4,1,1) = {"
O
q
T
T
e
O
"}
(5,1,1) = {"
O
O
p
z
a
O
"}
(6,1,1) = {"
B
O
O
O
O
O
"}
