//MAP CONVERTED BY dmm2tgm.py THIS HEADER COMMENT PREVENTS RECONVERSION, DO NOT REMOVE
"a" = (
/turf/closed/wall,
/area/station/maintenance/port/aft)
"b" = (
/obj/effect/decal/cleanable/dirt,
/obj/item/clothing/head/cone{
	pixel_y = -8
	},
/obj/item/clothing/head/cone{
	pixel_y = -4
	},
/obj/item/clothing/head/cone,
/obj/effect/turf_decal/trimline/neutral/filled/corner,
/turf/open/floor/plating,
/area/station/maintenance/port/aft)
"c" = (
/obj/effect/decal/cleanable/dirt,
/obj/machinery/light/small/directional/south,
/turf/open/floor/plating,
/area/station/maintenance/port/aft)
"d" = (
/obj/effect/decal/cleanable/dirt,
/obj/structure/closet,
/obj/item/relic,
/obj/item/stack/sheet/iron/ten,
/obj/item/stack/sheet/glass{
	amount = 10
	},
/turf/open/floor/plating,
/area/station/maintenance/port/aft)
"g" = (
/obj/effect/decal/cleanable/dirt,
/obj/effect/turf_decal/trimline/neutral/filled/line{
	dir = 4
	},
/turf/open/floor/plating,
/area/station/maintenance/port/aft)
"n" = (
/obj/effect/decal/cleanable/dirt,
/turf/open/floor/plating,
/area/station/maintenance/port/aft)
"t" = (
/obj/machinery/door/airlock/maintenance_hatch{
	name = "Maintenance Storage";
	req_one_access_txt = "12"
	},
/obj/effect/decal/cleanable/dirt,
/obj/modular_map_connector,
/turf/open/floor/iron/smooth,
/area/station/maintenance/port/aft)
"N" = (
/obj/effect/decal/cleanable/dirt,
/obj/effect/spawner/random/structure/crate,
/turf/open/floor/plating,
/area/station/maintenance/port/aft)
"P" = (
/turf/template_noop,
/area/template_noop)
"R" = (
/obj/machinery/door/airlock/maintenance_hatch{
	req_one_access_txt = "12"
	},
/obj/effect/mapping_helpers/airlock/abandoned,
/obj/effect/decal/cleanable/dirt,
/turf/open/floor/plating,
/area/station/maintenance/port/aft)
"T" = (
/obj/structure/closet/crate,
/obj/effect/decal/cleanable/dirt,
/obj/item/clothing/suit/hazardvest,
/obj/item/clothing/suit/hazardvest,
/obj/item/clothing/suit/hazardvest,
/obj/item/clothing/head/hardhat,
/obj/item/clothing/head/hardhat,
/obj/item/clothing/head/hardhat,
/turf/open/floor/plating,
/area/station/maintenance/port/aft)
"U" = (
/obj/structure/table,
/obj/effect/decal/cleanable/dirt,
/obj/item/stack/sheet/cardboard{
	amount = 23
	},
/obj/item/storage/crayons,
/turf/open/floor/plating,
/area/station/maintenance/port/aft)

(1,1,1) = {"
a
a
a
a
a
a
"}
(2,1,1) = {"
a
T
n
R
d
a
"}
(3,1,1) = {"
a
U
c
a
a
a
"}
(4,1,1) = {"
P
b
g
R
N
a
"}
(5,1,1) = {"
P
P
t
P
P
P
"}
