//MAP CONVERTED BY dmm2tgm.py THIS HEADER COMMENT PREVENTS RECONVERSION, DO NOT REMOVE
"a" = (
/obj/structure/cable,
/obj/effect/decal/cleanable/dirt,
/turf/open/floor/catwalk_floor,
/area/station/maintenance/port/aft)
"b" = (
/obj/effect/turf_decal/sand/plating,
/obj/structure/barricade/wooden/crude,
/turf/open/floor/plating,
/area/station/maintenance/port/aft)
"d" = (
/obj/effect/turf_decal/sand/plating,
/turf/open/floor/plating,
/area/station/maintenance/port/aft)
"f" = (
/obj/effect/turf_decal/sand/plating,
/obj/effect/decal/cleanable/cobweb,
/turf/open/floor/plating,
/area/station/maintenance/port/aft)
"k" = (
/obj/effect/turf_decal/sand/plating,
/obj/effect/decal/cleanable/cobweb/cobweb2,
/turf/open/floor/plating,
/area/station/maintenance/port/aft)
"l" = (
/turf/closed/wall/rust,
/area/station/maintenance/port/aft)
"m" = (
/obj/effect/decal/cleanable/dirt,
/turf/open/floor/iron/smooth,
/area/station/maintenance/port/aft)
"p" = (
/turf/closed/wall,
/area/station/maintenance/port/aft)
"r" = (
/obj/effect/decal/cleanable/dirt,
/obj/effect/spawner/random/trash/food_packaging,
/turf/open/floor/iron/smooth,
/area/station/maintenance/port/aft)
"w" = (
/obj/structure/cable,
/obj/effect/decal/cleanable/dirt,
/obj/effect/spawner/random/trash/food_packaging,
/turf/open/floor/catwalk_floor,
/area/station/maintenance/port/aft)
"z" = (
/turf/closed/wall/rock,
/area/station/maintenance/port/aft)
"D" = (
/turf/template_noop,
/area/template_noop)
"E" = (
/obj/effect/turf_decal/weather,
/turf/open/floor/iron/smooth,
/area/station/maintenance/port/aft)
"I" = (
/turf/closed/mineral/random/stationside/asteroid/porus,
/area/station/maintenance/port/aft)
"N" = (
/obj/structure/ore_box,
/turf/open/misc/asteroid,
/area/station/maintenance/port/aft)
"O" = (
/obj/item/shovel,
/obj/effect/landmark/event_spawn,
/turf/open/misc/asteroid{
	icon_state = "asteroid_dug"
	},
/area/station/maintenance/port/aft)
"U" = (
/obj/modular_map_connector,
/turf/template_noop,
/area/template_noop)
"V" = (
/turf/open/misc/asteroid,
/area/station/maintenance/port/aft)
"W" = (
/obj/structure/girder,
/obj/effect/turf_decal/sand/plating,
/turf/open/floor/plating,
/area/station/maintenance/port/aft)
"X" = (
/obj/item/stack/ore/glass,
/turf/open/misc/asteroid,
/area/station/maintenance/port/aft)
"Z" = (
/obj/structure/closet/crate,
/obj/item/storage/backpack/satchel/explorer,
/obj/item/stack/ore/silver,
/obj/item/stack/ore/silver,
/turf/open/misc/asteroid,
/area/station/maintenance/port/aft)

(1,1,1) = {"
p
l
p
I
I
z
l
z
I
D
D
D
D
D
D
D
D
D
D
D
D
D
D
D
"}
(2,1,1) = {"
p
f
b
V
X
V
V
V
I
z
l
l
z
z
D
D
D
D
D
D
D
D
D
D
"}
(3,1,1) = {"
p
m
D
D
D
D
D
d
W
N
X
Z
d
l
p
p
D
D
D
D
D
D
D
D
"}
(4,1,1) = {"
p
r
D
D
D
D
D
k
d
V
O
X
d
b
E
p
D
D
D
D
D
D
D
D
"}
(5,1,1) = {"
p
m
D
D
D
D
D
D
D
D
D
D
D
D
a
D
D
D
D
D
D
D
D
D
"}
(6,1,1) = {"
D
m
D
D
D
D
D
D
D
D
D
D
D
D
a
p
D
D
D
D
D
D
D
D
"}
(7,1,1) = {"
D
D
D
D
D
D
D
D
D
D
D
D
D
D
a
p
p
D
D
D
D
D
D
D
"}
(8,1,1) = {"
D
D
D
D
D
D
D
D
D
D
D
D
D
D
a
a
p
p
l
l
l
p
D
D
"}
(9,1,1) = {"
D
D
D
D
D
D
D
D
D
D
D
D
D
D
D
a
a
a
a
a
w
p
p
D
"}
(10,1,1) = {"
D
D
D
D
D
D
D
D
D
D
D
D
D
D
D
D
D
D
D
D
a
a
p
D
"}
(11,1,1) = {"
D
D
D
D
D
D
D
D
D
D
D
D
D
D
D
D
D
D
D
D
D
a
p
D
"}
(12,1,1) = {"
D
D
D
D
D
D
D
D
D
D
D
D
D
D
D
D
D
D
D
D
D
a
p
p
"}
(13,1,1) = {"
D
D
D
D
D
D
D
D
D
D
D
D
D
D
D
D
D
D
D
D
U
a
m
p
"}
(14,1,1) = {"
D
D
D
D
D
D
D
D
D
D
D
D
D
D
D
D
D
D
D
D
D
D
D
D
"}
