//MAP CONVERTED BY dmm2tgm.py THIS HEADER COMMENT PREVENTS RECONVERSION, DO NOT REMOVE
"a" = (
/turf/template_noop,
/area/template_noop)
"d" = (
/obj/structure/rack,
/obj/item/pickaxe/mini{
	pixel_x = 5;
	pixel_y = -1
	},
/obj/item/shovel{
	pixel_x = -5
	},
/obj/item/stack/ore/iron,
/turf/open/floor/plating/asteroid,
/area/mine/explored)
"i" = (
/obj/effect/spawner/random/structure/crate,
/turf/open/floor/plating/asteroid,
/area/mine/explored)
"m" = (
/obj/modular_map_root/tramstation{
	key = "maintenance_miningsolar_cavetunnel_attachment"
	},
/turf/closed/wall/rock/porous,
/area/mine/explored)
"n" = (
/turf/closed/wall,
/area/maintenance/starboard/central)
"p" = (
/mob/living/simple_animal/hostile/lizard/space{
	name = "Digs-The-Tunnels"
	},
/turf/open/floor/plating/asteroid,
/area/mine/explored)
"q" = (
/obj/structure/barricade/wooden,
/turf/open/floor/plating/asteroid,
/area/mine/explored)
"r" = (
/obj/item/stack/ore/iron,
/turf/open/floor/plating/asteroid,
/area/mine/explored)
"u" = (
/turf/closed/wall/rock/porous,
/area/mine/explored)
"v" = (
/turf/open/floor/plating/asteroid,
/area/mine/explored)
"x" = (
/obj/effect/turf_decal/sand/plating,
/turf/open/floor/plating,
/area/maintenance/starboard/central)
"y" = (
/obj/item/clothing/head/cone{
	pixel_x = 9;
	pixel_y = 8
	},
/obj/item/clothing/head/cone{
	pixel_x = -9;
	pixel_y = 8
	},
/turf/template_noop,
/area/template_noop)
"A" = (
/obj/item/pickaxe/mini,
/turf/open/floor/plating/asteroid,
/area/mine/explored)
"B" = (
/obj/effect/spawner/random/trash/garbage,
/turf/open/floor/plating/asteroid,
/area/mine/explored)
"C" = (
/obj/item/stack/ore/glass,
/turf/open/floor/plating/asteroid,
/area/mine/explored)
"K" = (
/turf/closed/mineral/random/stationside/asteroid/porus,
/area/mine/explored)
"P" = (
/obj/effect/decal/cleanable/dirt,
/turf/open/floor/iron/smooth,
/area/maintenance/starboard/central)
"R" = (
/obj/machinery/door/airlock/maintenance_hatch{
	req_one_access_txt = "12"
	},
/obj/effect/mapping_helpers/airlock/abandoned,
/obj/modular_map_connector,
/turf/open/floor/iron/smooth,
/area/template_noop)
"S" = (
/obj/effect/decal/cleanable/dirt,
/turf/open/floor/plating,
/area/maintenance/starboard/central)
"V" = (
/obj/effect/decal/cleanable/cobweb/cobweb2,
/turf/open/floor/plating/asteroid,
/area/mine/explored)
"X" = (
/obj/structure/ore_box,
/turf/open/floor/plating/asteroid,
/area/mine/explored)
"Y" = (
/obj/effect/decal/cleanable/cobweb,
/turf/open/floor/plating/asteroid,
/area/mine/explored)

(1,1,1) = {"
K
K
K
K
a
a
a
a
a
a
a
a
a
a
a
a
a
a
a
a
a
a
a
a
a
a
a
"}
(2,1,1) = {"
K
Y
v
K
a
a
a
a
a
a
a
a
a
a
a
a
a
a
a
a
a
a
a
a
a
a
a
"}
(3,1,1) = {"
K
K
C
K
K
a
a
a
a
a
a
a
a
a
a
a
a
a
a
a
a
a
a
a
a
a
a
"}
(4,1,1) = {"
K
q
A
X
K
a
a
a
a
a
a
a
a
a
a
a
a
a
a
a
a
a
a
a
a
a
a
"}
(5,1,1) = {"
K
u
p
K
K
a
a
a
a
a
a
a
a
a
a
a
a
a
a
a
a
a
a
a
a
a
a
"}
(6,1,1) = {"
K
K
v
C
K
a
a
a
a
a
a
a
a
a
a
a
a
a
a
a
a
a
a
a
a
a
a
"}
(7,1,1) = {"
K
K
K
v
K
a
a
a
a
a
a
a
a
a
a
a
a
a
a
a
a
a
a
a
a
a
a
"}
(8,1,1) = {"
K
K
K
v
K
a
a
a
a
a
a
a
a
a
a
a
a
a
a
a
a
a
a
a
a
a
a
"}
(9,1,1) = {"
K
K
v
v
K
a
a
a
a
a
a
a
a
a
a
a
a
a
a
a
a
a
a
a
a
a
a
"}
(10,1,1) = {"
K
K
v
K
K
a
a
a
a
a
a
a
a
a
a
a
a
a
a
a
a
a
a
a
a
a
a
"}
(11,1,1) = {"
K
q
v
K
K
a
a
a
a
a
a
a
a
a
a
a
a
a
a
a
a
a
a
a
a
a
a
"}
(12,1,1) = {"
K
u
v
v
K
a
a
a
a
a
a
a
a
a
a
a
a
a
a
a
a
a
a
a
a
a
a
"}
(13,1,1) = {"
K
K
v
v
K
K
K
a
a
a
a
a
a
a
a
a
a
a
a
a
a
a
a
a
a
a
a
"}
(14,1,1) = {"
a
K
v
v
K
K
u
a
a
a
a
a
a
a
a
a
a
a
a
a
a
a
a
a
a
a
a
"}
(15,1,1) = {"
a
K
v
v
K
r
q
a
a
a
a
a
a
a
a
a
a
a
a
a
a
a
a
a
a
a
a
"}
(16,1,1) = {"
a
K
C
v
v
v
v
a
a
a
a
a
a
a
a
a
a
a
a
a
a
a
a
a
a
a
a
"}
(17,1,1) = {"
a
K
K
v
v
K
K
a
a
a
a
a
a
a
a
a
a
a
a
a
a
a
a
a
a
a
a
"}
(18,1,1) = {"
a
K
K
v
v
C
m
a
a
a
a
a
a
a
a
a
a
a
a
a
a
a
a
a
a
a
a
"}
(19,1,1) = {"
a
K
v
v
C
B
K
a
a
a
a
a
a
a
a
a
a
a
a
a
a
a
a
a
a
a
a
"}
(20,1,1) = {"
a
K
K
v
v
K
K
a
a
a
a
a
a
a
a
a
a
a
a
a
a
a
a
a
a
a
a
"}
(21,1,1) = {"
a
K
v
C
v
K
K
K
a
a
a
a
a
a
a
a
a
a
a
a
a
a
a
a
a
a
a
"}
(22,1,1) = {"
a
K
u
v
v
v
v
K
K
a
a
a
a
a
a
a
a
a
a
a
a
a
a
a
a
a
a
"}
(23,1,1) = {"
a
K
K
K
v
v
v
v
K
K
K
K
K
K
K
K
K
K
K
K
K
K
K
a
a
a
a
"}
(24,1,1) = {"
a
a
K
v
v
v
v
v
v
v
K
K
v
K
K
K
C
K
K
u
q
i
n
n
a
a
a
"}
(25,1,1) = {"
a
a
K
K
i
K
K
v
v
v
B
v
v
v
v
v
v
v
v
v
v
x
P
n
n
a
a
"}
(26,1,1) = {"
a
a
a
K
K
K
K
V
v
K
X
d
v
v
r
r
v
v
v
v
x
x
S
S
P
R
y
"}
(27,1,1) = {"
a
a
a
a
a
K
K
K
K
K
K
K
v
K
q
u
K
K
v
v
v
x
P
n
n
a
a
"}
(28,1,1) = {"
a
a
a
a
a
a
a
a
K
K
K
K
K
K
K
K
K
K
K
K
n
n
n
n
a
a
a
"}
