//MAP CONVERTED BY dmm2tgm.py THIS HEADER COMMENT PREVENTS RECONVERSION, DO NOT REMOVE
"a" = (
/obj/machinery/door/airlock/maintenance_hatch{
	name = "Maintenance Hatch"
	},
/obj/effect/mapping_helpers/airlock/access/all/engineering/maintenance,
/obj/effect/decal/cleanable/dirt,
/obj/structure/barricade/wooden,
/obj/modular_map_connector,
/turf/open/floor/iron/smooth,
/area/station/maintenance/department/security)
"b" = (
/turf/open/misc/asteroid,
/area/station/maintenance/department/security)
"c" = (
/obj/structure/closet/crate/miningcar,
/obj/item/stack/ore/silver,
/obj/item/stack/ore/silver,
/obj/item/stack/ore/gold,
/obj/item/stack/ore/gold,
/obj/item/stack/ore/gold,
/obj/item/storage/bag/ore,
/turf/open/misc/asteroid,
/area/station/maintenance/department/security)
"d" = (
/turf/closed/mineral/random/stationside/asteroid/porus,
/area/station/maintenance/department/security)
"m" = (
/obj/item/stack/ore/glass,
/turf/open/misc/asteroid,
/area/station/maintenance/department/security)
"n" = (
/obj/effect/turf_decal/sand,
/turf/open/floor/iron/smooth,
/area/station/maintenance/department/security)
"t" = (
/obj/effect/turf_decal/sand/plating,
/turf/open/floor/plating,
/area/station/maintenance/department/security)
"w" = (
/turf/closed/wall/rock,
/area/station/maintenance/department/security)
"y" = (
/obj/structure/ore_box,
/turf/open/misc/asteroid,
/area/station/maintenance/department/security)
"F" = (
/turf/template_noop,
/area/template_noop)
"H" = (
/turf/template_noop,
/area/station/maintenance/department/security)
"I" = (
/turf/closed/wall,
/area/station/maintenance/department/security)
"M" = (
/obj/item/shovel,
/obj/item/relic,
/turf/open/misc/asteroid,
/area/station/maintenance/department/security)
"T" = (
/obj/item/pickaxe/mini,
/turf/open/misc/asteroid,
/area/station/maintenance/department/security)

(1,1,1) = {"
H
w
d
d
d
d
w
F
F
"}
(2,1,1) = {"
H
T
b
d
t
c
y
d
d
"}
(3,1,1) = {"
H
t
b
b
m
b
b
b
d
"}
(4,1,1) = {"
I
t
t
b
b
b
t
M
b
"}
(5,1,1) = {"
I
n
n
t
b
b
m
b
b
"}
(6,1,1) = {"
I
I
a
w
F
F
F
w
b
"}
