//MAP CONVERTED BY dmm2tgm.py THIS HEADER COMMENT PREVENTS RECONVERSION, DO NOT REMOVE
"a" = (
/turf/template_noop,
/area/template_noop)
"b" = (
/obj/effect/decal/cleanable/dirt,
/turf/open/floor/iron/smooth_edge{
	dir = 1
	},
/area/station/maintenance/central/greater)
"g" = (
/obj/effect/decal/cleanable/dirt,
/turf/open/floor/iron/smooth_corner{
	dir = 8
	},
/area/station/maintenance/central/greater)
"i" = (
/turf/closed/wall,
/area/station/maintenance/central/greater)
"j" = (
/obj/effect/decal/cleanable/dirt,
/obj/item/stack/tile/iron/smooth,
/turf/open/floor/plating,
/area/station/maintenance/central/greater)
"s" = (
/obj/effect/decal/cleanable/dirt,
/obj/effect/turf_decal/bot,
/obj/structure/closet/crate{
	icon_state = "crateopen"
	},
/obj/effect/spawner/random/engineering/material_cheap,
/obj/effect/spawner/random/engineering/material_cheap,
/turf/open/floor/plating,
/area/station/maintenance/central/greater)
"u" = (
/obj/effect/decal/cleanable/dirt,
/turf/open/floor/iron/smooth_large,
/area/station/maintenance/central/greater)
"v" = (
/obj/structure/table/reinforced,
/obj/effect/decal/cleanable/dirt,
/obj/structure/spider/stickyweb,
/turf/open/floor/iron/smooth_large,
/area/station/maintenance/central/greater)
"w" = (
/obj/effect/decal/cleanable/dirt,
/obj/item/chair/greyscale,
/turf/open/floor/iron/smooth_corner,
/area/station/maintenance/central/greater)
"x" = (
/obj/effect/decal/cleanable/dirt,
/obj/effect/decal/cleanable/cobweb/cobweb2,
/obj/effect/turf_decal/bot,
/obj/structure/closet/crate/engineering,
/obj/effect/spawner/random/engineering/tool,
/obj/effect/spawner/random/engineering/tool,
/turf/open/floor/iron/smooth,
/area/station/maintenance/central/greater)
"y" = (
/obj/structure/falsewall,
/obj/effect/decal/cleanable/dirt,
/turf/open/floor/plating,
/area/station/maintenance/central/greater)
"z" = (
/obj/effect/decal/cleanable/dirt,
/obj/item/stack/tile/iron/smooth,
/turf/open/floor/iron/smooth_edge,
/area/station/maintenance/central/greater)
"A" = (
/obj/effect/decal/cleanable/dirt,
/mob/living/simple_animal/hostile/giant_spider/hunter/scrawny,
/turf/open/floor/plating,
/area/station/maintenance/central/greater)
"C" = (
/obj/effect/decal/cleanable/dirt,
/obj/effect/turf_decal/bot,
/obj/structure/closet/crate{
	icon_state = "crateopen"
	},
/obj/effect/spawner/random/engineering/material,
/obj/effect/spawner/random/maintenance/three,
/turf/open/floor/iron/smooth,
/area/station/maintenance/central/greater)
"G" = (
/obj/effect/decal/cleanable/dirt,
/turf/open/floor/iron/smooth,
/area/station/maintenance/central/greater)
"I" = (
/obj/effect/decal/cleanable/dirt,
/obj/effect/turf_decal/bot,
/turf/open/floor/iron/smooth,
/area/station/maintenance/central/greater)
"J" = (
/obj/effect/decal/cleanable/dirt,
/obj/structure/spider/stickyweb,
/turf/open/floor/iron/smooth_large,
/area/station/maintenance/central/greater)
"L" = (
/obj/effect/decal/cleanable/dirt,
/obj/structure/spider/stickyweb,
/obj/structure/rack,
/turf/open/floor/iron/smooth_corner{
	dir = 1
	},
/area/station/maintenance/central/greater)
"M" = (
/obj/effect/decal/cleanable/dirt,
/obj/machinery/door/airlock/maintenance_hatch{
	name = "Bar Excess Storage"
	},
/obj/modular_map_connector,
/obj/effect/mapping_helpers/airlock/unres{
	dir = 4
	},
/obj/effect/mapping_helpers/airlock/access/any/service/maintenance,
/turf/open/floor/iron/smooth,
/area/station/maintenance/central/greater)
"O" = (
/obj/effect/decal/cleanable/dirt,
/obj/structure/spider/stickyweb,
/turf/open/floor/iron/smooth_edge,
/area/station/maintenance/central/greater)
"Q" = (
/obj/effect/decal/cleanable/dirt,
/obj/structure/spider/stickyweb,
/turf/open/floor/iron/smooth,
/area/station/maintenance/central/greater)
"R" = (
/obj/effect/decal/cleanable/dirt,
/obj/effect/turf_decal/bot,
/turf/open/floor/iron/smooth_corner{
	dir = 4
	},
/area/station/maintenance/central/greater)
"T" = (
/obj/effect/decal/cleanable/dirt,
/obj/item/chair/greyscale,
/turf/open/floor/iron/smooth,
/area/station/maintenance/central/greater)
"X" = (
/obj/effect/decal/cleanable/dirt,
/obj/structure/spider/stickyweb,
/obj/effect/turf_decal/bot,
/turf/open/floor/iron/smooth,
/area/station/maintenance/central/greater)
"Y" = (
/obj/effect/decal/cleanable/dirt,
/obj/item/kirbyplants/dead{
	desc = "A long-dead potted plant, left to rot in the bowls of maintenance.";
	name = "rotted potted plant"
	},
/obj/machinery/light/small/directional/east,
/turf/open/floor/iron/smooth,
/area/station/maintenance/central/greater)
"Z" = (
/obj/effect/decal/cleanable/dirt,
/obj/item/stack/tile/iron/smooth,
/obj/structure/spider/stickyweb,
/obj/machinery/light/small/broken/directional/north,
/turf/open/floor/plating,
/area/station/maintenance/central/greater)

(1,1,1) = {"
a
a
a
a
a
a
a
a
a
"}
(2,1,1) = {"
a
a
y
a
a
a
M
a
a
"}
(3,1,1) = {"
i
G
Q
j
L
i
g
G
G
"}
(4,1,1) = {"
i
s
I
O
u
v
u
b
G
"}
(5,1,1) = {"
i
Z
A
z
u
v
J
b
G
"}
(6,1,1) = {"
i
x
X
C
R
i
w
Y
T
"}
(7,1,1) = {"
i
i
i
i
i
i
i
i
i
"}
