//MAP CONVERTED BY dmm2tgm.py THIS HEADER COMMENT PREVENTS RECONVERSION, DO NOT REMOVE
"a" = (
/obj/machinery/atmospherics/pipe/smart/manifold4w/supply/hidden/layer4,
/obj/machinery/atmospherics/pipe/smart/manifold4w/scrubbers/hidden/layer2,
/obj/effect/decal/cleanable/dirt,
/obj/structure/cable,
/turf/open/floor/catwalk_floor,
/area/station/maintenance/starboard/central)
"b" = (
/obj/effect/decal/cleanable/dirt,
/turf/open/floor/iron/smooth,
/area/station/maintenance/starboard/central)
"c" = (
/obj/machinery/atmospherics/pipe/smart/manifold4w/supply/hidden/layer4,
/obj/machinery/atmospherics/pipe/smart/manifold4w/scrubbers/hidden/layer2,
/obj/effect/decal/cleanable/dirt,
/obj/structure/cable,
/obj/structure/disposalpipe/segment{
	dir = 6
	},
/turf/open/floor/catwalk_floor,
/area/station/maintenance/starboard/central)
"d" = (
/turf/open/misc/asteroid/airless,
/area/template_noop)
"e" = (
/obj/structure/disposalpipe/segment{
	dir = 6
	},
/obj/machinery/atmospherics/pipe/smart/manifold4w/supply/hidden/layer4,
/obj/machinery/atmospherics/pipe/smart/manifold4w/scrubbers/hidden/layer2,
/obj/structure/cable,
/obj/effect/decal/cleanable/dirt,
/turf/open/floor/catwalk_floor,
/area/station/maintenance/starboard/central)
"f" = (
/obj/effect/decal/cleanable/dirt,
/obj/structure/filingcabinet/chestdrawer,
/turf/open/floor/iron/smooth,
/area/station/maintenance/starboard/central)
"h" = (
/obj/effect/landmark/blobstart,
/turf/open/floor/catwalk_floor,
/area/station/maintenance/starboard/central)
"i" = (
/obj/structure/disposalpipe/segment,
/obj/machinery/atmospherics/pipe/smart/manifold4w/scrubbers/hidden/layer2,
/obj/machinery/atmospherics/pipe/smart/manifold4w/supply/hidden/layer4,
/obj/effect/decal/cleanable/dirt,
/obj/structure/cable,
/turf/open/floor/catwalk_floor,
/area/station/maintenance/starboard/central)
"j" = (
/obj/machinery/airalarm/directional/west,
/turf/open/floor/iron/smooth,
/area/station/maintenance/starboard/central)
"k" = (
/turf/open/floor/iron/smooth,
/area/station/maintenance/starboard/central)
"m" = (
/obj/machinery/atmospherics/pipe/smart/manifold4w/scrubbers/hidden/layer2,
/obj/machinery/atmospherics/pipe/smart/manifold4w/supply/hidden/layer4,
/obj/effect/decal/cleanable/dirt,
/obj/structure/cable,
/obj/structure/disposalpipe/segment{
	dir = 9
	},
/turf/open/floor/catwalk_floor,
/area/station/maintenance/starboard/central)
"n" = (
/obj/machinery/atmospherics/pipe/smart/manifold4w/scrubbers/hidden/layer2,
/obj/machinery/atmospherics/pipe/smart/manifold4w/supply/hidden/layer4,
/obj/effect/decal/cleanable/dirt,
/obj/structure/cable,
/turf/open/floor/catwalk_floor,
/area/station/maintenance/starboard/central)
"p" = (
/obj/modular_map_connector,
/turf/template_noop,
/area/template_noop)
"q" = (
/obj/machinery/atmospherics/pipe/smart/manifold4w/scrubbers/hidden/layer2,
/obj/machinery/atmospherics/pipe/smart/manifold4w/supply/hidden/layer4,
/obj/effect/decal/cleanable/dirt,
/obj/structure/cable,
/obj/structure/disposalpipe/segment,
/turf/open/floor/catwalk_floor,
/area/station/maintenance/starboard/central)
"r" = (
/obj/effect/decal/cleanable/dirt,
/obj/effect/spawner/random/trash/food_packaging,
/obj/structure/grille/broken,
/turf/open/floor/plating,
/area/station/maintenance/starboard/central)
"t" = (
/obj/structure/disposalpipe/segment,
/obj/machinery/atmospherics/pipe/smart/manifold4w/scrubbers/hidden/layer2,
/obj/effect/decal/cleanable/dirt,
/obj/effect/spawner/random/trash/garbage,
/turf/open/floor/catwalk_floor,
/area/station/maintenance/starboard/central)
"u" = (
/turf/closed/wall,
/area/station/maintenance/starboard/central)
"v" = (
/obj/effect/decal/cleanable/dirt,
/obj/machinery/light/small/directional/west,
/turf/open/floor/iron/smooth,
/area/station/maintenance/starboard/central)
"x" = (
/turf/template_noop,
/area/template_noop)
"y" = (
/obj/structure/disposalpipe/segment,
/obj/effect/decal/cleanable/dirt,
/turf/open/floor/catwalk_floor,
/area/station/maintenance/starboard/central)
"z" = (
/obj/effect/decal/cleanable/dirt,
/obj/structure/rack,
/obj/item/compact_remote,
/obj/item/multitool/circuit{
	pixel_x = -8
	},
/turf/open/floor/iron/smooth,
/area/station/maintenance/starboard/central)
"A" = (
/obj/machinery/atmospherics/pipe/smart/manifold4w/supply/hidden/layer4,
/obj/machinery/atmospherics/pipe/smart/manifold4w/scrubbers/hidden/layer2,
/obj/effect/decal/cleanable/dirt,
/obj/structure/disposalpipe/segment{
	dir = 10
	},
/obj/structure/cable,
/turf/open/floor/catwalk_floor,
/area/station/maintenance/starboard/central)
"B" = (
/obj/machinery/atmospherics/pipe/smart/manifold4w/scrubbers/hidden/layer2,
/obj/machinery/atmospherics/pipe/smart/manifold4w/supply/hidden/layer4,
/obj/effect/decal/cleanable/dirt,
/obj/structure/disposalpipe/segment{
	dir = 5
	},
/obj/structure/cable,
/turf/open/floor/catwalk_floor,
/area/station/maintenance/starboard/central)
"C" = (
/turf/open/floor/catwalk_floor,
/area/station/maintenance/starboard/central)
"D" = (
/obj/structure/disposalpipe/segment,
/obj/machinery/atmospherics/pipe/smart/manifold4w/supply/hidden/layer4,
/obj/machinery/atmospherics/pipe/smart/manifold4w/scrubbers/hidden/layer2,
/obj/effect/decal/cleanable/dirt,
/obj/structure/cable,
/turf/open/floor/catwalk_floor,
/area/station/maintenance/starboard/central)
"E" = (
/obj/effect/decal/cleanable/dirt,
/turf/open/floor/plating,
/area/station/maintenance/starboard/central)
"G" = (
/obj/structure/disposalpipe/segment,
/obj/machinery/atmospherics/pipe/smart/manifold4w/scrubbers/hidden/layer2,
/obj/effect/decal/cleanable/dirt,
/turf/open/floor/catwalk_floor,
/area/station/maintenance/starboard/central)
"H" = (
/obj/structure/disposalpipe/segment,
/obj/effect/decal/cleanable/dirt,
/obj/structure/cable,
/obj/machinery/power/apc/auto_name/directional/west,
/turf/open/floor/catwalk_floor,
/area/station/maintenance/starboard/central)
"I" = (
/obj/effect/decal/cleanable/dirt,
/obj/structure/rack,
/obj/item/integrated_circuit/loaded/hello_world,
/turf/open/floor/iron/smooth,
/area/station/maintenance/starboard/central)
"L" = (
/obj/effect/decal/cleanable/dirt,
/obj/effect/spawner/random/trash/garbage,
/turf/open/floor/plating,
/area/station/maintenance/starboard/central)
"N" = (
/obj/effect/landmark/event_spawn,
/turf/open/floor/catwalk_floor,
/area/station/maintenance/starboard/central)
"O" = (
/obj/effect/decal/cleanable/dirt,
/obj/effect/mapping_helpers/airlock/access/any/science/maintenance,
/obj/machinery/door/airlock/maintenance_hatch{
	name = "Maintenance Hatch"
	},
/obj/effect/mapping_helpers/airlock/unres{
	dir = 8
	},
/turf/open/floor/iron/smooth,
/area/station/maintenance/starboard/central)
"P" = (
/obj/machinery/atmospherics/pipe/smart/manifold4w/scrubbers/hidden/layer2,
/obj/machinery/atmospherics/pipe/smart/manifold4w/supply/hidden/layer4,
/obj/effect/decal/cleanable/dirt,
/obj/structure/cable,
/obj/structure/disposalpipe/segment{
	dir = 4
	},
/turf/open/floor/catwalk_floor,
/area/station/maintenance/starboard/central)
"Q" = (
/obj/machinery/atmospherics/pipe/smart/manifold4w/supply/hidden/layer4,
/obj/machinery/atmospherics/pipe/smart/manifold4w/scrubbers/hidden/layer2,
/obj/effect/decal/cleanable/dirt,
/obj/structure/disposalpipe/segment{
	dir = 5
	},
/obj/structure/cable,
/turf/open/floor/catwalk_floor,
/area/station/maintenance/starboard/central)
"S" = (
/turf/closed/mineral/random/stationside/asteroid/porus,
/area/template_noop)
"T" = (
/obj/machinery/atmospherics/pipe/smart/manifold4w/supply/hidden/layer4,
/obj/machinery/atmospherics/pipe/smart/manifold4w/scrubbers/hidden/layer2,
/obj/effect/decal/cleanable/dirt,
/obj/structure/cable,
/obj/effect/spawner/random/structure/steam_vent,
/turf/open/floor/catwalk_floor,
/area/station/maintenance/starboard/central)
"U" = (
/obj/structure/disposalpipe/segment,
/obj/structure/reagent_dispensers/watertank,
/turf/open/floor/iron/smooth,
/area/station/maintenance/starboard/central)
"V" = (
/obj/machinery/atmospherics/pipe/smart/manifold4w/scrubbers/hidden/layer2,
/obj/machinery/atmospherics/pipe/smart/manifold4w/supply/hidden/layer4,
/obj/effect/decal/cleanable/dirt,
/obj/structure/cable,
/obj/structure/disposalpipe/junction/yjunction{
	dir = 8
	},
/turf/open/floor/catwalk_floor,
/area/station/maintenance/starboard/central)
"Y" = (
/obj/effect/decal/cleanable/dirt,
/obj/structure/sign/departments/drop/directional/east,
/turf/open/floor/iron/smooth,
/area/station/maintenance/starboard/central)
"Z" = (
/obj/machinery/atmospherics/pipe/smart/manifold4w/scrubbers/hidden/layer2,
/obj/machinery/atmospherics/pipe/smart/manifold4w/supply/hidden/layer4,
/obj/effect/decal/cleanable/dirt,
/obj/structure/disposalpipe/segment{
	dir = 10
	},
/obj/structure/cable,
/turf/open/floor/catwalk_floor,
/area/station/maintenance/starboard/central)

(1,1,1) = {"
x
x
x
x
x
x
x
x
x
x
x
x
x
x
x
x
x
x
x
x
x
x
x
x
x
x
x
"}
(2,1,1) = {"
x
x
x
x
x
x
x
x
x
x
x
x
x
x
x
x
x
x
x
x
x
b
v
b
z
x
x
"}
(3,1,1) = {"
x
x
x
x
x
x
x
x
x
x
x
x
x
x
x
x
x
x
x
x
x
f
b
b
I
x
x
"}
(4,1,1) = {"
x
x
x
x
x
x
x
x
x
x
x
x
x
x
x
x
x
x
x
x
x
u
u
O
u
x
x
"}
(5,1,1) = {"
x
x
x
x
x
x
x
x
x
x
x
x
x
x
x
x
x
x
x
x
y
y
y
y
H
y
B
"}
(6,1,1) = {"
x
x
x
x
x
x
x
x
x
x
x
x
x
x
x
x
x
x
x
x
u
u
a
n
n
n
Z
"}
(7,1,1) = {"
x
x
x
x
x
x
x
x
x
x
x
x
x
x
x
x
x
x
x
x
E
u
T
x
x
x
x
"}
(8,1,1) = {"
x
x
x
x
x
x
x
x
x
x
x
x
x
x
x
x
x
x
x
x
r
u
a
x
x
x
x
"}
(9,1,1) = {"
x
x
x
x
x
x
x
x
x
x
x
x
x
x
x
x
x
x
x
x
E
u
a
x
x
x
x
"}
(10,1,1) = {"
x
x
x
x
x
x
x
x
x
x
x
x
x
x
x
x
x
x
x
x
E
u
a
x
x
x
x
"}
(11,1,1) = {"
x
x
x
x
x
x
x
x
x
x
x
x
x
x
x
x
x
x
x
x
E
u
a
x
x
x
x
"}
(12,1,1) = {"
x
x
p
x
x
x
x
x
x
x
x
x
x
x
x
x
x
x
x
x
L
u
a
x
x
x
x
"}
(13,1,1) = {"
x
x
P
x
x
x
x
x
c
D
i
x
x
x
x
x
x
x
x
x
E
u
a
x
x
x
x
"}
(14,1,1) = {"
x
e
V
q
q
q
q
q
m
u
a
x
x
x
x
x
x
x
x
x
u
u
a
u
x
x
x
"}
(15,1,1) = {"
x
x
x
x
x
u
u
u
u
u
a
x
x
x
x
x
x
x
x
x
t
G
Q
u
x
x
x
"}
(16,1,1) = {"
x
x
x
x
x
S
S
S
u
a
a
x
x
x
x
x
x
x
x
x
u
u
A
U
x
x
x
"}
(17,1,1) = {"
x
x
x
x
x
S
S
u
u
a
x
x
x
x
x
x
x
x
x
x
x
j
a
u
x
x
x
"}
(18,1,1) = {"
x
x
x
x
x
S
S
u
a
a
x
x
x
x
x
x
x
x
x
x
x
k
C
k
k
x
x
"}
(19,1,1) = {"
x
x
x
x
x
S
S
u
a
x
x
x
x
x
x
x
x
x
x
x
x
x
N
k
k
x
x
"}
(20,1,1) = {"
x
x
x
x
x
S
S
u
a
x
x
x
x
x
x
x
x
x
x
x
x
x
C
k
k
x
x
"}
(21,1,1) = {"
x
x
x
x
x
S
S
u
a
x
x
x
x
x
x
x
x
x
x
x
x
x
C
k
k
x
x
"}
(22,1,1) = {"
x
x
x
x
x
S
S
u
a
x
x
x
x
x
x
x
x
x
x
x
x
x
h
k
k
x
x
"}
(23,1,1) = {"
x
x
x
x
x
S
S
u
a
a
a
a
x
x
x
x
x
x
x
k
k
u
C
k
k
x
x
"}
(24,1,1) = {"
x
x
x
x
x
S
S
u
u
u
u
a
a
a
a
a
a
a
a
C
C
C
C
k
k
x
x
"}
(25,1,1) = {"
x
x
x
x
x
S
S
S
S
S
u
u
b
Y
b
b
b
Y
b
u
u
u
u
u
k
x
x
"}
(26,1,1) = {"
x
x
x
x
x
d
S
S
S
S
S
u
x
x
x
x
x
x
x
u
S
S
S
u
C
x
x
"}
