//MAP CONVERTED BY dmm2tgm.py THIS HEADER COMMENT PREVENTS RECONVERSION, DO NOT REMOVE
"a" = (
/obj/effect/decal/cleanable/dirt,
/obj/structure/closet/crate/cardboard,
/obj/effect/spawner/random/engineering/material_cheap,
/obj/effect/spawner/random/engineering/material_cheap,
/turf/open/floor/iron/smooth,
/area/station/maintenance/starboard/central)
"b" = (
/obj/effect/decal/cleanable/dirt,
/obj/machinery/light/small/directional/south,
/turf/open/floor/iron/smooth,
/area/station/maintenance/starboard/central)
"h" = (
/obj/effect/decal/cleanable/dirt,
/obj/machinery/atmospherics/components/unary/vent_pump/on/layer4{
	dir = 1
	},
/turf/open/floor/iron/smooth,
/area/station/maintenance/starboard/central)
"i" = (
/obj/modular_map_connector,
/turf/closed/wall,
/area/station/maintenance/starboard/central)
"j" = (
/obj/effect/decal/cleanable/dirt,
/turf/open/floor/iron/smooth,
/area/station/maintenance/starboard/central)
"r" = (
/turf/open/floor/catwalk_floor,
/area/station/maintenance/starboard/central)
"v" = (
/obj/effect/decal/cleanable/dirt,
/obj/structure/closet/cardboard,
/obj/effect/spawner/random/maintenance/two,
/turf/open/floor/iron/smooth,
/area/station/maintenance/starboard/central)
"w" = (
/obj/effect/decal/cleanable/dirt,
/obj/effect/landmark/xeno_spawn,
/turf/open/floor/iron/smooth,
/area/station/maintenance/starboard/central)
"A" = (
/obj/effect/decal/cleanable/dirt,
/obj/structure/closet,
/obj/effect/spawner/random/engineering/toolbox,
/obj/effect/spawner/random/engineering/flashlight,
/turf/open/floor/iron/smooth,
/area/station/maintenance/starboard/central)
"B" = (
/obj/machinery/atmospherics/pipe/smart/manifold4w/supply/hidden/layer4,
/obj/machinery/atmospherics/pipe/smart/manifold4w/scrubbers/hidden/layer2,
/obj/effect/decal/cleanable/dirt,
/obj/structure/cable,
/obj/effect/decal/cleanable/dirt,
/turf/open/floor/catwalk_floor,
/area/station/maintenance/starboard/central)
"J" = (
/obj/effect/decal/cleanable/dirt,
/obj/machinery/atmospherics/components/unary/vent_scrubber/on/layer2,
/turf/open/floor/iron/smooth,
/area/station/maintenance/starboard/central)
"L" = (
/turf/template_noop,
/area/template_noop)
"M" = (
/obj/machinery/atmospherics/pipe/smart/manifold4w/scrubbers/hidden/layer2,
/obj/effect/decal/cleanable/dirt,
/turf/open/floor/catwalk_floor,
/area/station/maintenance/starboard/central)
"N" = (
/turf/closed/wall,
/area/station/maintenance/starboard/central)
"S" = (
/obj/effect/decal/cleanable/dirt,
/obj/machinery/door/airlock/maintenance_hatch{
	name = "Water Closet"
	},
/obj/effect/mapping_helpers/airlock/access/any/science/maintenance,
/obj/effect/mapping_helpers/airlock/unres,
/turf/open/floor/iron/smooth,
/area/station/maintenance/starboard/central)
"V" = (
/obj/effect/decal/cleanable/dirt,
/obj/structure/mop_bucket{
	pixel_y = 15;
	pixel_x = 5
	},
/obj/item/mop{
	pixel_x = -2;
	pixel_y = 19
	},
/obj/effect/decal/cleanable/cobweb/cobweb2,
/obj/structure/sink/directional/north,
/obj/item/reagent_containers/cup/bucket{
	pixel_x = 9;
	pixel_y = -4
	},
/turf/open/floor/iron/smooth,
/area/station/maintenance/starboard/central)

(1,1,1) = {"
L
L
J
B
N
i
"}
(2,1,1) = {"
L
L
L
B
S
b
"}
(3,1,1) = {"
L
L
L
B
N
V
"}
(4,1,1) = {"
L
L
L
B
N
N
"}
(5,1,1) = {"
L
L
L
B
w
A
"}
(6,1,1) = {"
v
a
N
B
h
j
"}
(7,1,1) = {"
B
B
B
B
M
M
"}
(8,1,1) = {"
N
N
N
N
N
r
"}
