//MAP CONVERTED BY dmm2tgm.py THIS HEADER COMMENT PREVENTS RECONVERSION, DO NOT REMOVE
"a" = (
/turf/closed/wall,
/area/station/maintenance/department/cargo)
"b" = (
/obj/effect/turf_decal/sand,
/obj/structure/barricade/wooden,
/turf/open/floor/iron/smooth,
/area/station/maintenance/department/cargo)
"c" = (
/obj/effect/turf_decal/sand/plating,
/obj/effect/decal/cleanable/cobweb/cobweb2,
/turf/open/floor/plating,
/area/station/maintenance/department/cargo)
"e" = (
/obj/effect/decal/cleanable/dirt,
/obj/structure/grille,
/turf/open/floor/iron/smooth,
/area/station/maintenance/department/cargo)
"g" = (
/obj/effect/turf_decal/sand/plating,
/turf/open/floor/iron/smooth,
/area/station/maintenance/department/cargo)
"h" = (
/obj/effect/turf_decal/sand/plating,
/obj/effect/decal/cleanable/cobweb,
/obj/structure/barricade/wooden,
/turf/open/floor/plating,
/area/station/maintenance/department/cargo)
"j" = (
/obj/effect/decal/cleanable/dirt,
/turf/open/floor/iron/smooth,
/area/station/maintenance/department/cargo)
"l" = (
/obj/effect/turf_decal/sand/plating,
/obj/structure/falsewall,
/turf/open/floor/plating,
/area/station/maintenance/department/cargo)
"m" = (
/obj/effect/decal/cleanable/dirt,
/obj/structure/closet/crate,
/turf/open/floor/iron/smooth,
/area/station/maintenance/department/cargo)
"n" = (
/mob/living/simple_animal/hostile/giant_spider,
/turf/open/misc/asteroid,
/area/station/maintenance/department/cargo)
"q" = (
/turf/closed/wall/rust,
/area/station/maintenance/department/cargo)
"s" = (
/turf/closed/wall/rock,
/area/station/maintenance/department/cargo)
"t" = (
/obj/structure/spider/stickyweb,
/obj/item/relic,
/turf/open/misc/asteroid,
/area/station/maintenance/department/cargo)
"u" = (
/turf/template_noop,
/area/template_noop)
"w" = (
/turf/open/misc/asteroid,
/area/station/maintenance/department/cargo)
"x" = (
/obj/effect/decal/cleanable/cobweb,
/turf/open/misc/asteroid,
/area/station/maintenance/department/cargo)
"y" = (
/obj/structure/table,
/obj/effect/decal/cleanable/dirt,
/obj/effect/spawner/random/maintenance/two,
/turf/open/floor/iron/smooth,
/area/station/maintenance/department/cargo)
"z" = (
/obj/effect/decal/cleanable/dirt,
/obj/structure/rack,
/obj/item/chair/plastic{
	pixel_x = 4;
	pixel_y = 5
	},
/obj/item/chair/plastic,
/obj/item/chair/plastic{
	pixel_x = 5;
	pixel_y = 12
	},
/turf/open/floor/iron/smooth,
/area/station/maintenance/department/cargo)
"A" = (
/obj/effect/turf_decal/sand/plating,
/mob/living/simple_animal/hostile/giant_spider,
/turf/open/floor/plating,
/area/station/maintenance/department/cargo)
"B" = (
/obj/structure/spider/stickyweb,
/turf/open/misc/asteroid,
/area/station/maintenance/department/cargo)
"C" = (
/obj/structure/spider/stickyweb,
/mob/living/simple_animal/hostile/giant_spider,
/turf/open/misc/asteroid,
/area/station/maintenance/department/cargo)
"F" = (
/obj/structure/table,
/obj/effect/decal/cleanable/dirt,
/obj/effect/spawner/random/engineering/tool,
/turf/open/floor/iron/smooth,
/area/station/maintenance/department/cargo)
"L" = (
/obj/effect/turf_decal/sand,
/obj/machinery/portable_atmospherics/canister/nitrogen,
/turf/open/floor/iron/smooth,
/area/station/maintenance/department/cargo)
"O" = (
/obj/modular_map_connector,
/obj/effect/decal/cleanable/dirt,
/obj/machinery/door/airlock/maintenance_hatch{
	name = "Maintenance Hatch"
	},
/obj/effect/mapping_helpers/airlock/access/all/engineering/maintenance,
/obj/effect/mapping_helpers/airlock/unres{
	dir = 8
	},
/turf/open/floor/iron/smooth,
/area/station/maintenance/department/cargo)
"P" = (
/obj/effect/turf_decal/sand,
/obj/machinery/portable_atmospherics/canister/air,
/turf/open/floor/iron/smooth,
/area/station/maintenance/department/cargo)
"T" = (
/obj/structure/spider/stickyweb,
/obj/item/storage/toolbox/mechanical/old,
/turf/open/misc/asteroid,
/area/station/maintenance/department/cargo)
"Y" = (
/obj/effect/turf_decal/sand/plating,
/obj/structure/girder,
/turf/open/floor/plating,
/area/station/maintenance/department/cargo)

(1,1,1) = {"
g
a
s
s
Y
w
n
B
B
u
"}
(2,1,1) = {"
g
l
h
B
w
B
B
B
C
u
"}
(3,1,1) = {"
u
u
a
q
A
B
w
t
T
u
"}
(4,1,1) = {"
u
u
x
w
B
s
c
a
w
u
"}
(5,1,1) = {"
u
u
w
w
u
a
l
a
a
a
"}
(6,1,1) = {"
u
u
u
w
u
a
b
L
m
a
"}
(7,1,1) = {"
u
u
u
u
u
a
P
e
j
a
"}
(8,1,1) = {"
u
u
u
u
u
a
e
z
j
a
"}
(9,1,1) = {"
u
u
u
u
u
a
y
j
j
a
"}
(10,1,1) = {"
u
u
u
u
u
a
F
j
j
a
"}
(11,1,1) = {"
u
u
u
u
u
u
u
u
O
u
"}
(12,1,1) = {"
u
u
u
u
u
u
u
u
u
u
"}
