//MAP CONVERTED BY dmm2tgm.py THIS HEADER COMMENT PREVENTS RECONVERSION, DO NOT REMOVE
"a" = (
/turf/template_noop,
/area/template_noop)
"c" = (
/obj/machinery/atmospherics/pipe/smart/manifold4w/supply/hidden/layer4,
/obj/machinery/atmospherics/pipe/smart/manifold4w/scrubbers/hidden/layer2,
/obj/structure/cable,
/obj/modular_map_connector,
/obj/effect/decal/cleanable/dirt,
/turf/open/floor/catwalk_floor,
/area/maintenance/department/medical)
"e" = (
/obj/modular_map_root/tramstation{
	key = "maintenance_science_west_attachment"
	},
/turf/open/floor/plating,
/area/maintenance/department/medical)
"f" = (
/obj/machinery/atmospherics/pipe/smart/manifold4w/supply/hidden/layer4,
/obj/machinery/atmospherics/pipe/smart/manifold4w/scrubbers/hidden/layer2,
/obj/structure/cable,
/obj/effect/decal/cleanable/dirt,
/obj/effect/spawner/random/trash/food_packaging,
/turf/open/floor/catwalk_floor,
/area/maintenance/department/medical)
"h" = (
/obj/effect/decal/cleanable/dirt,
/obj/machinery/space_heater,
/turf/open/floor/iron/smooth,
/area/maintenance/department/medical)
"i" = (
/obj/effect/decal/cleanable/dirt,
/obj/structure/grille,
/turf/open/floor/iron/smooth,
/area/maintenance/department/medical)
"j" = (
/obj/effect/decal/cleanable/dirt,
/obj/structure/rack,
/obj/effect/spawner/random/maintenance/three,
/obj/effect/spawner/random/engineering/tool,
/obj/effect/decal/cleanable/cobweb/cobweb2,
/obj/effect/spawner/random/engineering/flashlight,
/turf/open/floor/iron/smooth,
/area/maintenance/department/medical)
"k" = (
/obj/effect/decal/cleanable/dirt,
/obj/structure/rack,
/obj/effect/spawner/random/maintenance/two,
/obj/effect/spawner/random/medical/firstaid,
/turf/open/floor/iron/smooth,
/area/maintenance/department/medical)
"n" = (
/obj/effect/decal/cleanable/dirt,
/obj/effect/spawner/random/trash/food_packaging,
/turf/open/floor/iron/smooth,
/area/maintenance/department/medical)
"I" = (
/obj/effect/decal/cleanable/dirt,
/turf/open/floor/iron/smooth,
/area/maintenance/department/medical)
"J" = (
/obj/machinery/atmospherics/pipe/smart/manifold4w/supply/hidden/layer4,
/obj/machinery/atmospherics/pipe/smart/manifold4w/scrubbers/hidden/layer2,
/obj/structure/cable,
/obj/effect/decal/cleanable/dirt,
/turf/open/floor/catwalk_floor,
/area/maintenance/department/medical)
"K" = (
/obj/effect/decal/cleanable/dirt,
/obj/effect/spawner/random/trash/cigbutt,
/turf/open/floor/iron/smooth,
/area/maintenance/department/medical)
"Q" = (
/turf/closed/wall,
/area/maintenance/department/medical)

(1,1,1) = {"
a
e
a
a
a
a
a
a
a
a
a
a
a
a
"}
(2,1,1) = {"
J
J
J
f
J
J
J
J
Q
a
a
a
a
a
"}
(3,1,1) = {"
c
Q
Q
Q
Q
Q
Q
J
Q
a
a
a
a
a
"}
(4,1,1) = {"
a
a
a
a
a
a
Q
J
Q
Q
Q
Q
Q
Q
"}
(5,1,1) = {"
a
a
a
a
a
a
Q
J
K
I
I
I
I
Q
"}
(6,1,1) = {"
a
a
a
a
a
a
a
a
a
a
Q
Q
I
Q
"}
(7,1,1) = {"
a
a
a
a
a
a
a
a
a
a
a
Q
I
Q
"}
(8,1,1) = {"
a
a
a
a
a
a
a
a
a
a
a
Q
I
Q
"}
(9,1,1) = {"
a
a
a
a
a
a
a
a
a
a
Q
Q
I
Q
"}
(10,1,1) = {"
a
a
a
a
a
a
a
a
a
a
Q
h
I
Q
"}
(11,1,1) = {"
a
a
a
a
a
a
a
a
a
a
Q
i
I
Q
"}
(12,1,1) = {"
a
a
a
a
a
a
a
a
a
a
Q
k
n
Q
"}
(13,1,1) = {"
a
a
a
a
a
a
a
a
a
a
Q
j
I
Q
"}
(14,1,1) = {"
a
a
a
a
a
a
a
a
a
a
Q
Q
I
Q
"}
(15,1,1) = {"
a
a
a
a
a
a
a
a
a
a
a
Q
I
Q
"}
(16,1,1) = {"
a
a
a
a
a
a
a
a
a
a
a
Q
I
Q
"}
(17,1,1) = {"
a
a
a
a
a
a
a
a
a
Q
Q
Q
I
Q
"}
(18,1,1) = {"
a
a
a
a
a
a
a
a
a
I
I
I
I
Q
"}
(19,1,1) = {"
a
a
a
a
a
a
a
a
a
a
a
a
a
a
"}
