//MAP CONVERTED BY dmm2tgm.py THIS HEADER COMMENT PREVENTS RECONVERSION, DO NOT REMOVE
"a" = (
/turf/closed/mineral/random/stationside/asteroid/porus,
/area/station/maintenance/port/aft)
"c" = (
/obj/effect/turf_decal/sand/plating,
/obj/item/clothing/head/utility/hardhat/welding/orange,
/turf/open/floor/plating,
/area/station/maintenance/port/aft)
"f" = (
/obj/effect/decal/cleanable/dirt,
/obj/structure/cable,
/turf/open/floor/catwalk_floor,
/area/station/maintenance/port/aft)
"o" = (
/obj/item/stack/ore/glass,
/turf/open/misc/asteroid{
	icon_state = "asteroid_dug"
	},
/area/station/maintenance/port/aft)
"t" = (
/turf/closed/wall/rock,
/area/station/maintenance/port/aft)
"u" = (
/turf/closed/wall/rust,
/area/station/maintenance/port/aft)
"v" = (
/obj/item/stack/ore/glass,
/turf/open/misc/asteroid,
/area/station/maintenance/port/aft)
"z" = (
/obj/effect/turf_decal/weather,
/obj/effect/spawner/random/trash/cigbutt,
/turf/open/floor/iron/smooth,
/area/station/maintenance/port/aft)
"B" = (
/obj/item/pickaxe,
/turf/open/misc/asteroid,
/area/station/maintenance/port/aft)
"C" = (
/obj/effect/decal/cleanable/dirt,
/obj/structure/cable,
/obj/machinery/power/apc/auto_name/directional/north,
/turf/open/floor/catwalk_floor,
/area/station/maintenance/port/aft)
"D" = (
/turf/template_noop,
/area/template_noop)
"G" = (
/obj/effect/decal/cleanable/dirt,
/obj/structure/cable,
/obj/machinery/door/airlock/maintenance_hatch{
	name = "Maintenance Access"
	},
/obj/modular_map_connector,
/obj/effect/mapping_helpers/airlock/access/all/engineering/maintenance,
/obj/effect/mapping_helpers/airlock/unres,
/turf/open/floor/catwalk_floor,
/area/station/maintenance/port/aft)
"J" = (
/turf/open/misc/asteroid,
/area/station/maintenance/port/aft)
"N" = (
/obj/effect/turf_decal/weather,
/turf/open/floor/iron/smooth,
/area/station/maintenance/port/aft)
"O" = (
/obj/effect/turf_decal/weather,
/obj/structure/closet/crate,
/obj/effect/spawner/random/maintenance/two,
/obj/machinery/light/small/blacklight/directional/north,
/obj/effect/spawner/random/engineering/flashlight,
/turf/open/floor/iron/smooth,
/area/station/maintenance/port/aft)
"P" = (
/obj/effect/turf_decal/sand/plating,
/turf/open/floor/plating,
/area/station/maintenance/port/aft)
"Q" = (
/obj/item/relic,
/turf/open/misc/asteroid{
	icon_state = "asteroid_dug"
	},
/area/station/maintenance/port/aft)
"T" = (
/obj/structure/ore_box,
/turf/open/misc/asteroid,
/area/station/maintenance/port/aft)
"U" = (
/obj/structure/girder,
/turf/open/floor/plating,
/area/station/maintenance/port/aft)
"W" = (
/turf/closed/wall,
/area/station/maintenance/port/aft)
"Y" = (
/obj/effect/turf_decal/sand/plating,
/obj/item/clothing/suit/hazardvest,
/turf/open/floor/plating,
/area/station/maintenance/port/aft)
"Z" = (
/obj/item/shovel,
/turf/open/misc/asteroid{
	icon_state = "asteroid_dug"
	},
/area/station/maintenance/port/aft)

(1,1,1) = {"
D
a
a
D
D
D
D
D
D
"}
(2,1,1) = {"
W
u
a
a
a
a
a
D
D
"}
(3,1,1) = {"
W
O
P
o
v
t
a
a
D
"}
(4,1,1) = {"
G
f
N
Y
B
T
U
a
a
"}
(5,1,1) = {"
D
C
z
c
o
Q
U
a
a
"}
(6,1,1) = {"
D
D
P
J
Z
v
a
a
D
"}
(7,1,1) = {"
D
D
D
D
D
D
D
D
D
"}
