//MAP CONVERTED BY dmm2tgm.py THIS HEADER COMMENT PREVENTS RECONVERSION, DO NOT REMOVE
"a" = (
/turf/closed/mineral/random/stationside/asteroid/porus,
/area/station/maintenance/department/medical)
"b" = (
/obj/effect/turf_decal/sand/plating,
/turf/open/floor/plating,
/area/station/maintenance/department/medical)
"l" = (
/turf/closed/wall/rust,
/area/station/maintenance/department/medical)
"m" = (
/turf/closed/wall/rock,
/area/station/maintenance/department/medical)
"p" = (
/obj/effect/turf_decal/sand/plating,
/obj/structure/girder,
/obj/item/stack/sheet/iron,
/turf/open/floor/plating,
/area/station/maintenance/department/medical)
"u" = (
/obj/effect/decal/cleanable/dirt,
/turf/open/floor/iron/smooth,
/area/station/maintenance/department/medical)
"B" = (
/obj/effect/spawner/random/trash/cigbutt,
/turf/open/misc/asteroid,
/area/station/maintenance/department/medical)
"D" = (
/obj/effect/turf_decal/sand/plating,
/obj/structure/rack,
/obj/item/stack/rods/ten,
/obj/item/stack/sheet/iron/ten,
/obj/effect/decal/cleanable/cobweb/cobweb2,
/obj/effect/spawner/random/engineering/material_cheap,
/turf/open/floor/plating,
/area/station/maintenance/department/medical)
"E" = (
/obj/effect/turf_decal/sand,
/turf/open/floor/iron/smooth,
/area/station/maintenance/department/medical)
"I" = (
/obj/item/shovel,
/obj/item/stack/ore/glass,
/turf/open/misc/asteroid{
	icon_state = "asteroid_dug"
	},
/area/station/maintenance/department/medical)
"J" = (
/obj/effect/turf_decal/sand/plating,
/obj/effect/spawner/random/engineering/tool,
/turf/open/floor/plating,
/area/station/maintenance/department/medical)
"K" = (
/obj/effect/decal/cleanable/cobweb,
/obj/item/clothing/suit/hazardvest,
/obj/item/clothing/head/utility/hardhat/orange,
/turf/open/misc/asteroid,
/area/station/maintenance/department/medical)
"M" = (
/obj/effect/turf_decal/sand,
/obj/item/tank/internals/emergency_oxygen,
/turf/open/floor/iron/smooth,
/area/station/maintenance/department/medical)
"N" = (
/obj/item/stack/tile/iron/smooth{
	amount = 3
	},
/turf/open/misc/asteroid,
/area/station/maintenance/department/medical)
"Q" = (
/turf/open/misc/asteroid,
/area/station/maintenance/department/medical)
"T" = (
/turf/closed/wall,
/area/station/maintenance/department/medical)
"W" = (
/obj/effect/decal/cleanable/dirt,
/obj/modular_map_connector,
/obj/machinery/door/airlock/maintenance_hatch{
	name = "Maintenance Hatch"
	},
/obj/effect/mapping_helpers/airlock/unres{
	dir = 1
	},
/obj/effect/mapping_helpers/airlock/locked,
/turf/open/floor/iron/smooth,
/area/station/maintenance/department/medical)

(1,1,1) = {"
T
T
T
T
T
T
"}
(2,1,1) = {"
T
a
a
a
a
m
"}
(3,1,1) = {"
T
a
K
B
Q
T
"}
(4,1,1) = {"
T
a
a
J
b
p
"}
(5,1,1) = {"
T
I
N
b
E
W
"}
(6,1,1) = {"
T
a
D
M
u
m
"}
(7,1,1) = {"
T
T
T
l
T
T
"}
