//MAP CONVERTED BY dmm2tgm.py THIS HEADER COMMENT PREVENTS RECONVERSION, DO NOT REMOVE
"a" = (
/turf/template_noop,
/area/template_noop)
"c" = (
/obj/effect/decal/cleanable/dirt,
/obj/effect/turf_decal/bot,
/obj/machinery/power/shuttle_engine/propulsion{
	desc = "A standard reliable bluespace engine used by many forms of shuttles. This one has the bluespace core removed.";
	name = "inactive propulsion engine"
	},
/obj/structure/window/reinforced/spawner/north,
/turf/open/floor/iron/smooth,
/area/station/maintenance/port/central)
"d" = (
/obj/effect/decal/cleanable/dirt,
/obj/effect/turf_decal/bot,
/obj/machinery/power/shuttle_engine/propulsion{
	desc = "A standard reliable bluespace engine used by many forms of shuttles. This one has the bluespace core removed.";
	name = "inactive propulsion engine"
	},
/obj/structure/window/reinforced/spawner,
/turf/open/floor/iron/smooth,
/area/station/maintenance/port/central)
"k" = (
/obj/effect/decal/cleanable/dirt,
/obj/effect/turf_decal/bot,
/obj/structure/reagent_dispensers/fueltank,
/turf/open/floor/iron/smooth,
/area/station/maintenance/port/central)
"q" = (
/obj/effect/decal/cleanable/dirt,
/obj/machinery/power/shuttle_engine/propulsion{
	desc = "A standard reliable bluespace engine used by many forms of shuttles. This one has the bluespace core removed.";
	name = "inactive propulsion engine"
	},
/obj/structure/window/reinforced/spawner,
/obj/effect/turf_decal/bot,
/turf/open/floor/iron/smooth,
/area/station/maintenance/port/central)
"u" = (
/obj/effect/decal/cleanable/dirt,
/obj/structure/rack,
/obj/item/weldingtool,
/obj/item/clothing/glasses/welding,
/obj/machinery/light/small/directional/north,
/turf/open/floor/iron/smooth,
/area/station/maintenance/port/central)
"C" = (
/obj/modular_map_connector,
/obj/machinery/door/airlock/maintenance_hatch{
	name = "Tram Maintenance Storage"
	},
/obj/effect/decal/cleanable/dirt,
/obj/effect/mapping_helpers/airlock/access/all/engineering/general,
/turf/open/floor/iron/smooth,
/area/station/maintenance/port/central)
"H" = (
/obj/effect/decal/cleanable/dirt,
/obj/machinery/power/shuttle_engine/propulsion{
	desc = "A standard reliable bluespace engine used by many forms of shuttles. This one has the bluespace core removed.";
	name = "inactive propulsion engine"
	},
/obj/structure/window/reinforced/spawner/north,
/obj/effect/turf_decal/bot,
/turf/open/floor/iron/smooth,
/area/station/maintenance/port/central)
"P" = (
/turf/closed/wall,
/area/station/maintenance/port/central)
"S" = (
/obj/effect/decal/cleanable/dirt,
/turf/open/floor/iron/smooth,
/area/station/maintenance/port/central)

(1,1,1) = {"
P
P
P
P
a
"}
(2,1,1) = {"
P
c
d
k
a
"}
(3,1,1) = {"
P
S
S
S
C
"}
(4,1,1) = {"
P
u
S
S
a
"}
(5,1,1) = {"
P
S
S
a
a
"}
(6,1,1) = {"
P
H
q
a
a
"}
(7,1,1) = {"
P
a
a
a
a
"}
