//MAP CONVERTED BY dmm2tgm.py THIS HEADER COMMENT PREVENTS RECONVERSION, DO NOT REMOVE
"a" = (
/turf/template_noop,
/area/template_noop)
"b" = (
/obj/structure/rack,
/obj/item/bodybag,
/turf/open/misc/asteroid,
/area/station/maintenance/central/greater)
"c" = (
/obj/effect/turf_decal/sand/plating,
/obj/item/stack/sheet/iron,
/turf/open/floor/plating,
/area/station/maintenance/central/greater)
"d" = (
/obj/structure/cable,
/obj/machinery/atmospherics/pipe/smart/manifold4w/supply/hidden/layer4,
/obj/machinery/atmospherics/pipe/smart/manifold4w/scrubbers/hidden/layer2,
/obj/effect/turf_decal/sand/plating,
/obj/machinery/power/apc/auto_name/directional/west,
/turf/open/floor/plating,
/area/station/maintenance/central/greater)
"e" = (
/obj/machinery/door/airlock/maintenance_hatch{
	name = "Security Maintenance Hatch"
	},
/obj/effect/mapping_helpers/airlock/access/any/security/maintenance,
/obj/effect/mapping_helpers/airlock/unres{
	dir = 1
	},
/obj/effect/turf_decal/sand,
/turf/open/floor/iron/smooth,
/area/station/maintenance/central/greater)
"f" = (
/obj/structure/cable,
/obj/machinery/atmospherics/pipe/smart/manifold4w/supply/hidden/layer4,
/obj/machinery/atmospherics/pipe/smart/manifold4w/scrubbers/hidden/layer2,
/obj/effect/turf_decal/sand/plating,
/obj/item/wirecutters,
/turf/open/floor/plating,
/area/station/maintenance/central/greater)
"h" = (
/obj/machinery/atmospherics/pipe/smart/manifold4w/supply/hidden/layer4,
/obj/effect/turf_decal/sand/plating,
/turf/open/floor/plating,
/area/station/maintenance/central/greater)
"i" = (
/turf/open/floor/catwalk_floor,
/area/station/maintenance/central/greater)
"j" = (
/obj/structure/cable,
/obj/machinery/atmospherics/pipe/smart/manifold4w/supply/hidden/layer4,
/obj/machinery/atmospherics/pipe/smart/manifold4w/scrubbers/hidden/layer2,
/obj/effect/decal/cleanable/dirt,
/obj/structure/barricade/wooden,
/turf/open/floor/catwalk_floor,
/area/station/maintenance/central/greater)
"k" = (
/turf/open/misc/asteroid,
/area/template_noop)
"l" = (
/obj/structure/girder,
/obj/effect/turf_decal/sand/plating,
/obj/item/stack/sheet/iron,
/turf/open/floor/plating,
/area/station/maintenance/central/greater)
"m" = (
/obj/structure/cable,
/obj/machinery/atmospherics/pipe/smart/manifold4w/supply/hidden/layer4,
/obj/machinery/atmospherics/pipe/smart/manifold4w/scrubbers/hidden/layer2,
/obj/effect/turf_decal/sand/plating,
/turf/open/floor/plating,
/area/station/maintenance/central/greater)
"n" = (
/turf/closed/wall/rock/porous,
/area/template_noop)
"o" = (
/obj/structure/ore_box,
/turf/open/misc/asteroid,
/area/template_noop)
"p" = (
/obj/effect/decal/cleanable/dirt,
/obj/machinery/atmospherics/pipe/smart/manifold4w/supply/hidden/layer4,
/turf/open/floor/catwalk_floor,
/area/station/maintenance/central/greater)
"r" = (
/turf/closed/wall,
/area/station/maintenance/central/greater)
"s" = (
/obj/structure/closet,
/obj/effect/spawner/random/maintenance/three,
/obj/effect/turf_decal/sand,
/obj/item/wallframe/apc,
/obj/item/electronics/apc,
/turf/open/floor/iron/smooth,
/area/station/maintenance/central/greater)
"t" = (
/obj/effect/turf_decal/sand/plating,
/obj/effect/spawner/random/engineering/toolbox,
/turf/open/floor/plating,
/area/station/maintenance/central/greater)
"u" = (
/obj/machinery/light/small/directional/east,
/obj/effect/turf_decal/sand/plating,
/turf/open/floor/plating,
/area/station/maintenance/central/greater)
"v" = (
/obj/modular_map_connector,
/turf/template_noop,
/area/template_noop)
"w" = (
/turf/open/misc/asteroid,
/area/station/maintenance/central/greater)
"x" = (
/obj/structure/reagent_dispensers/fueltank,
/obj/effect/turf_decal/sand,
/turf/open/floor/iron/smooth,
/area/station/maintenance/central/greater)
"y" = (
/obj/effect/turf_decal/sand/plating,
/obj/item/stack/ore/iron{
	pixel_x = 11;
	pixel_y = 7
	},
/obj/item/stack/ore/iron{
	pixel_y = -4
	},
/turf/open/floor/plating,
/area/station/maintenance/central/greater)
"z" = (
/turf/closed/mineral/random/stationside/asteroid/porus,
/area/template_noop)
"A" = (
/obj/structure/cable,
/obj/machinery/atmospherics/pipe/smart/manifold4w/supply/hidden/layer4,
/obj/machinery/atmospherics/pipe/smart/manifold4w/scrubbers/hidden/layer2,
/obj/effect/turf_decal/sand/plating,
/obj/structure/barricade/wooden,
/turf/open/floor/plating,
/area/station/maintenance/central/greater)
"B" = (
/obj/structure/cable,
/obj/machinery/atmospherics/pipe/smart/manifold4w/supply/hidden/layer4,
/obj/machinery/atmospherics/pipe/smart/manifold4w/scrubbers/hidden/layer2,
/obj/effect/turf_decal/sand/plating,
/obj/item/clothing/head/utility/hardhat,
/obj/effect/landmark/event_spawn,
/turf/open/floor/plating,
/area/station/maintenance/central/greater)
"C" = (
/obj/effect/decal/cleanable/dirt,
/obj/structure/closet,
/obj/effect/spawner/random/maintenance/two,
/turf/open/floor/iron/smooth,
/area/station/maintenance/central/greater)
"D" = (
/obj/item/stack/ore/glass,
/turf/open/misc/asteroid,
/area/template_noop)
"E" = (
/obj/structure/ladder,
/turf/open/misc/asteroid,
/area/station/maintenance/central/greater)
"F" = (
/obj/structure/girder,
/obj/effect/turf_decal/sand/plating,
/turf/open/floor/plating,
/area/station/maintenance/central/greater)
"G" = (
/obj/effect/turf_decal/sand/plating,
/obj/effect/landmark/blobstart,
/turf/open/floor/plating,
/area/station/maintenance/central/greater)
"H" = (
/turf/open/misc/asteroid/airless,
/area/template_noop)
"I" = (
/obj/structure/cable,
/obj/machinery/atmospherics/pipe/smart/manifold4w/supply/hidden/layer4,
/obj/machinery/atmospherics/pipe/smart/manifold4w/scrubbers/hidden/layer2,
/obj/effect/turf_decal/sand/plating,
/obj/item/crowbar,
/turf/open/floor/plating,
/area/station/maintenance/central/greater)
"J" = (
/obj/structure/cable,
/obj/machinery/atmospherics/pipe/smart/manifold4w/supply/hidden/layer4,
/obj/machinery/atmospherics/pipe/smart/manifold4w/scrubbers/hidden/layer2,
/obj/effect/decal/cleanable/dirt,
/obj/effect/spawner/random/trash/food_packaging,
/turf/open/floor/catwalk_floor,
/area/station/maintenance/central/greater)
"K" = (
/obj/item/stack/ore/iron,
/turf/open/misc/asteroid,
/area/template_noop)
"L" = (
/obj/structure/cable,
/obj/machinery/atmospherics/pipe/smart/manifold4w/supply/hidden/layer4,
/obj/machinery/atmospherics/pipe/smart/manifold4w/scrubbers/hidden/layer2,
/obj/effect/decal/cleanable/dirt,
/turf/open/floor/catwalk_floor,
/area/station/maintenance/central/greater)
"M" = (
/turf/closed/wall/rust,
/area/station/maintenance/central/greater)
"N" = (
/obj/effect/turf_decal/sand/plating,
/turf/open/floor/plating,
/area/station/maintenance/central/greater)
"O" = (
/obj/effect/turf_decal/sand,
/turf/open/floor/iron/smooth,
/area/station/maintenance/central/greater)
"P" = (
/turf/open/floor/iron/smooth,
/area/station/maintenance/central/greater)
"R" = (
/turf/closed/wall/rock/porous,
/area/station/maintenance/central/greater)
"S" = (
/obj/effect/decal/cleanable/dirt,
/obj/machinery/atmospherics/pipe/smart/manifold4w/supply/hidden/layer4,
/obj/effect/spawner/random/trash/cigbutt,
/turf/open/floor/catwalk_floor,
/area/station/maintenance/central/greater)
"U" = (
/obj/machinery/door/airlock/maintenance_hatch{
	name = "Security Maintenance Hatch"
	},
/obj/effect/mapping_helpers/airlock/access/any/security/maintenance,
/obj/effect/turf_decal/sand/plating,
/turf/open/floor/plating,
/area/station/maintenance/central/greater)
"W" = (
/obj/structure/cable,
/obj/machinery/atmospherics/pipe/smart/manifold4w/supply/hidden/layer4,
/obj/machinery/atmospherics/pipe/smart/manifold4w/scrubbers/hidden/layer2,
/obj/effect/decal/cleanable/dirt,
/turf/open/floor/plating,
/area/station/maintenance/central/greater)
"X" = (
/obj/structure/cable,
/obj/machinery/atmospherics/pipe/smart/manifold4w/supply/hidden/layer4,
/obj/machinery/atmospherics/pipe/smart/manifold4w/scrubbers/hidden/layer2,
/obj/effect/turf_decal/sand/plating,
/obj/effect/spawner/random/decoration/glowstick,
/turf/open/floor/plating,
/area/station/maintenance/central/greater)
"Y" = (
/obj/effect/spawner/random/trash/moisture_trap,
/obj/effect/turf_decal/sand,
/turf/open/floor/iron/smooth,
/area/station/maintenance/central/greater)
"Z" = (
/obj/effect/turf_decal/sand/plating,
/obj/item/pickaxe/mini,
/turf/open/floor/plating,
/area/station/maintenance/central/greater)

(1,1,1) = {"
a
a
a
a
a
a
a
a
v
a
a
a
a
a
a
a
a
a
a
a
a
a
a
a
a
a
a
a
a
a
a
a
a
a
a
a
z
z
"}
(2,1,1) = {"
a
a
a
a
a
a
z
r
L
r
z
a
a
a
a
a
a
a
a
a
a
a
a
a
a
a
a
a
a
z
z
z
z
z
z
z
z
z
"}
(3,1,1) = {"
a
a
a
a
a
a
z
r
L
r
z
a
a
a
a
a
a
a
a
a
a
a
a
a
a
a
a
a
a
a
a
a
a
a
a
z
z
z
"}
(4,1,1) = {"
a
a
a
a
a
a
z
r
L
r
k
k
k
k
k
k
z
z
z
z
z
z
z
a
a
a
a
a
a
a
a
a
a
a
a
z
z
z
"}
(5,1,1) = {"
a
a
a
a
a
a
z
r
L
M
M
N
r
N
N
r
r
r
r
r
r
r
z
a
a
a
a
a
a
a
a
a
a
a
a
z
z
z
"}
(6,1,1) = {"
a
a
a
a
a
a
z
r
J
j
m
m
m
m
L
L
L
L
L
L
L
r
z
a
a
a
a
a
a
a
a
a
a
a
a
z
z
z
"}
(7,1,1) = {"
a
a
a
a
a
a
z
r
r
r
r
r
R
r
P
r
r
M
M
r
L
r
z
a
a
a
a
a
a
a
z
r
L
r
z
z
k
z
"}
(8,1,1) = {"
a
a
a
a
a
a
z
z
z
z
z
z
z
z
z
R
N
w
E
R
L
r
z
a
a
a
a
a
a
a
k
N
m
M
z
k
D
z
"}
(9,1,1) = {"
a
a
a
a
a
a
z
z
z
z
z
z
z
z
z
r
N
G
b
r
L
r
z
z
a
a
a
a
a
k
k
t
m
R
k
k
o
z
"}
(10,1,1) = {"
a
a
a
a
a
a
z
z
z
z
z
z
z
z
z
r
U
r
r
r
L
r
k
k
k
k
k
k
k
D
r
r
m
Z
k
k
o
z
"}
(11,1,1) = {"
a
a
a
a
a
a
z
z
z
z
z
z
z
z
z
r
u
c
O
e
L
R
k
k
a
a
a
a
a
M
M
s
X
l
r
k
z
z
"}
(12,1,1) = {"
a
a
a
a
a
a
z
z
z
z
z
z
z
z
z
r
r
F
r
M
L
l
D
z
a
a
a
a
a
W
d
f
B
Y
N
k
z
z
"}
(13,1,1) = {"
a
a
a
a
a
a
z
z
z
z
z
z
z
z
z
z
K
k
z
r
m
N
r
r
a
a
a
a
a
W
r
x
m
m
y
k
k
z
"}
(14,1,1) = {"
a
a
a
a
a
a
z
z
z
z
z
z
z
z
z
K
D
k
k
N
X
m
m
W
a
a
a
a
a
W
r
M
r
A
F
k
k
z
"}
(15,1,1) = {"
a
a
a
a
a
a
z
z
z
z
z
z
z
z
z
z
z
k
k
R
r
h
a
a
a
a
a
a
a
a
a
a
a
I
R
z
k
z
"}
(16,1,1) = {"
a
a
a
a
a
a
n
n
z
z
z
z
z
z
z
z
z
z
z
z
r
p
a
a
a
a
a
a
a
a
a
a
a
W
r
r
r
r
"}
(17,1,1) = {"
a
a
a
a
a
a
H
H
H
H
H
H
z
z
z
n
n
z
z
z
r
p
a
a
a
a
a
a
a
a
a
a
a
L
L
L
L
a
"}
(18,1,1) = {"
a
a
a
a
a
a
a
a
a
a
a
a
a
a
a
a
a
a
a
a
r
p
a
a
a
a
a
a
a
a
a
a
a
a
a
a
a
a
"}
(19,1,1) = {"
a
a
a
a
a
a
a
a
a
a
a
a
a
a
a
a
a
a
a
a
r
p
a
a
a
a
a
a
a
a
a
a
a
a
a
a
a
a
"}
(20,1,1) = {"
a
a
a
a
a
a
a
a
a
a
a
a
a
a
a
a
a
a
a
a
r
p
a
a
a
a
a
a
a
a
a
a
a
a
a
a
a
a
"}
(21,1,1) = {"
a
a
a
a
a
a
a
a
a
a
a
a
a
a
a
a
a
a
a
a
a
p
a
a
a
a
a
a
a
a
a
a
a
a
a
a
a
a
"}
(22,1,1) = {"
a
a
a
a
a
a
a
a
a
a
a
a
a
a
a
a
a
a
a
a
a
p
a
a
a
a
a
a
a
a
a
a
a
a
a
a
a
a
"}
(23,1,1) = {"
a
a
a
a
a
a
a
a
a
a
a
a
a
a
a
a
a
a
a
a
i
S
a
a
a
a
a
a
a
a
a
a
a
a
a
a
a
a
"}
(24,1,1) = {"
a
a
a
a
a
a
a
a
a
a
a
a
a
a
a
a
a
a
a
a
a
C
a
a
a
a
a
a
a
a
a
a
a
a
a
a
a
a
"}
(25,1,1) = {"
a
a
a
a
a
a
a
a
a
a
a
a
a
a
a
a
a
a
a
a
a
r
a
a
a
a
a
a
a
a
a
a
a
a
a
a
a
a
"}
