//MAP CONVERTED BY dmm2tgm.py THIS HEADER COMMENT PREVENTS RECONVERSION, DO NOT REMOVE
"aG" = (
/obj/effect/turf_decal/sand/plating,
/obj/structure/door_assembly/door_assembly_ext,
/obj/item/electronics/airlock,
/obj/item/stack/cable_coil,
/obj/item/stack/sheet/glass,
/turf/open/floor/plating,
/area/station/maintenance/starboard/greater)
"aM" = (
/obj/machinery/door/airlock/external{
	name = "External Access"
	},
/obj/effect/mapping_helpers/airlock/cyclelink_helper{
	dir = 1
	},
/obj/effect/turf_decal/sand/plating,
/obj/machinery/atmospherics/pipe/smart/manifold4w/supply/hidden/layer4,
/obj/structure/cable,
/obj/effect/mapping_helpers/airlock/access/all/engineering/general,
/turf/open/floor/plating,
/area/station/maintenance/starboard/greater)
"bd" = (
/obj/machinery/light/small/directional/south,
/turf/template_noop,
/area/template_noop)
"bD" = (
/obj/effect/decal/cleanable/dirt,
/turf/open/floor/iron/smooth,
/area/station/maintenance/starboard/greater)
"cd" = (
/obj/effect/decal/cleanable/dirt,
/obj/machinery/atmospherics/pipe/smart/manifold4w/supply/hidden/layer4,
/obj/machinery/atmospherics/pipe/smart/manifold4w/scrubbers/hidden/layer2,
/obj/structure/cable,
/turf/open/floor/catwalk_floor,
/area/station/maintenance/starboard/greater)
"du" = (
/obj/item/reagent_containers/cup/glass/bottle/beer,
/turf/open/misc/asteroid,
/area/template_noop)
"fy" = (
/obj/effect/mapping_helpers/airlock/abandoned,
/obj/effect/mapping_helpers/airlock/unres{
	dir = 8
	},
/obj/machinery/door/airlock/maintenance_hatch{
	name = "Maintenance Hatch"
	},
/obj/effect/turf_decal/sand,
/turf/open/floor/iron/smooth,
/area/station/maintenance/starboard/greater)
"fP" = (
/obj/effect/decal/cleanable/dirt,
/obj/structure/table,
/obj/effect/spawner/random/entertainment/cigar,
/turf/open/floor/iron/smooth,
/area/station/maintenance/starboard/greater)
"fX" = (
/obj/machinery/atmospherics/pipe/smart/manifold4w/supply/hidden/layer4,
/obj/effect/decal/cleanable/dirt,
/turf/open/floor/catwalk_floor,
/area/station/maintenance/starboard/greater)
"gN" = (
/obj/effect/decal/cleanable/dirt,
/obj/structure/rack,
/obj/effect/spawner/random/maintenance/two,
/obj/effect/spawner/random/decoration/glowstick,
/turf/open/floor/iron/smooth,
/area/station/maintenance/starboard/greater)
"hb" = (
/obj/effect/decal/cleanable/dirt,
/obj/effect/turf_decal/sand/plating,
/turf/open/floor/plating,
/area/station/maintenance/starboard/greater)
"jb" = (
/obj/effect/decal/cleanable/dirt,
/obj/effect/landmark/xeno_spawn,
/turf/open/floor/iron/smooth,
/area/station/maintenance/starboard/greater)
"jp" = (
/obj/effect/decal/cleanable/dirt,
/obj/item/stack/rods,
/obj/machinery/airalarm/directional/north,
/turf/open/floor/iron/smooth,
/area/station/maintenance/starboard/greater)
"kI" = (
/obj/structure/barricade/wooden,
/turf/open/misc/asteroid,
/area/template_noop)
"kO" = (
/obj/effect/turf_decal/sand,
/obj/item/stack/ore/glass,
/turf/open/floor/iron/smooth,
/area/station/maintenance/starboard/greater)
"mu" = (
/obj/machinery/atmospherics/pipe/smart/manifold4w/scrubbers/hidden/layer2,
/obj/machinery/atmospherics/pipe/smart/manifold4w/supply/hidden/layer4,
/obj/effect/decal/cleanable/dirt,
/obj/structure/cable,
/turf/open/floor/catwalk_floor,
/area/station/maintenance/starboard/greater)
"mF" = (
/obj/effect/decal/cleanable/dirt,
/obj/machinery/atmospherics/components/unary/vent_scrubber/on/layer2{
	dir = 1
	},
/turf/open/floor/iron/smooth,
/area/station/maintenance/starboard/greater)
"nq" = (
/obj/effect/decal/cleanable/dirt,
/obj/effect/spawner/random/structure/steam_vent,
/turf/open/floor/iron/smooth,
/area/station/maintenance/starboard/greater)
"ox" = (
/obj/item/stack/ore/iron,
/turf/open/misc/asteroid,
/area/template_noop)
"po" = (
/obj/machinery/door/airlock/external{
	name = "External Access"
	},
/obj/effect/mapping_helpers/airlock/cyclelink_helper,
/obj/effect/turf_decal/sand/plating,
/obj/machinery/atmospherics/pipe/smart/manifold4w/supply/hidden/layer4,
/obj/structure/cable,
/obj/effect/mapping_helpers/airlock/access/all/engineering/general,
/turf/open/floor/plating,
/area/station/maintenance/starboard/greater)
"qO" = (
/obj/effect/decal/cleanable/dirt,
/obj/structure/rack,
/obj/effect/spawner/random/maintenance/two,
/obj/effect/spawner/random/entertainment/drugs,
/turf/open/floor/iron/smooth,
/area/station/maintenance/starboard/greater)
"ra" = (
/obj/machinery/atmospherics/pipe/smart/manifold4w/scrubbers/hidden/layer2,
/obj/machinery/atmospherics/pipe/smart/manifold4w/supply/hidden/layer4,
/obj/structure/cable,
/obj/effect/turf_decal/sand,
/turf/open/floor/plating,
/area/station/maintenance/starboard/greater)
"rv" = (
/obj/effect/turf_decal/sand/plating,
/obj/item/stack/ore/glass,
/turf/open/floor/plating,
/area/station/maintenance/starboard/greater)
"rF" = (
/obj/effect/decal/cleanable/dirt,
/obj/machinery/atmospherics/pipe/smart/manifold4w/scrubbers/hidden/layer2,
/obj/machinery/atmospherics/pipe/smart/manifold4w/supply/hidden/layer4,
/obj/structure/cable,
/turf/open/floor/catwalk_floor,
/area/station/maintenance/starboard/greater)
"rP" = (
/obj/effect/decal/cleanable/dirt,
/obj/structure/ore_box,
/obj/machinery/light/small/directional/north,
/turf/open/floor/iron/smooth,
/area/station/maintenance/starboard/greater)
"se" = (
/obj/machinery/light/small/directional/west,
/turf/open/misc/asteroid,
/area/template_noop)
"sA" = (
/obj/structure/ore_box,
/turf/open/misc/asteroid,
/area/template_noop)
"uC" = (
/obj/item/electronics/airlock,
/turf/open/misc/asteroid,
/area/template_noop)
"uP" = (
/turf/open/misc/asteroid,
/area/template_noop)
"wV" = (
/obj/effect/turf_decal/sand,
/turf/open/floor/iron/smooth,
/area/station/maintenance/starboard/greater)
"wY" = (
/obj/effect/decal/cleanable/dirt,
/obj/effect/spawner/random/trash/grille_or_waste,
/turf/open/floor/iron/smooth,
/area/station/maintenance/starboard/greater)
"xa" = (
/obj/structure/sign/warning/vacuum/external{
	pixel_x = -32
	},
/obj/machinery/light/small/directional/east,
/obj/effect/turf_decal/sand/plating,
/turf/open/floor/plating,
/area/station/maintenance/starboard/greater)
"xP" = (
/obj/effect/decal/cleanable/dirt,
/obj/machinery/atmospherics/pipe/smart/manifold4w/scrubbers/hidden/layer2,
/obj/machinery/atmospherics/pipe/smart/manifold4w/supply/hidden/layer4,
/obj/structure/cable,
/obj/effect/spawner/random/trash/food_packaging,
/turf/open/floor/catwalk_floor,
/area/station/maintenance/starboard/greater)
"zC" = (
/obj/effect/turf_decal/sand/plating,
/obj/item/stack/sheet/iron,
/turf/open/floor/plating,
/area/station/maintenance/starboard/greater)
"AK" = (
/obj/effect/spawner/random/structure/crate,
/obj/item/relic,
/turf/open/misc/asteroid,
/area/template_noop)
"Bd" = (
/obj/item/stack/ore/glass,
/turf/open/misc/asteroid,
/area/template_noop)
"Bu" = (
/obj/machinery/portable_atmospherics/pump{
	name = "Lil Pump"
	},
/obj/effect/turf_decal/sand/plating,
/obj/machinery/light/small/directional/east,
/turf/open/floor/plating,
/area/template_noop)
"BF" = (
/turf/closed/mineral/random/stationside/asteroid/porus,
/area/template_noop)
"CX" = (
/obj/effect/turf_decal/sand,
/obj/structure/falsewall,
/turf/open/floor/iron/smooth,
/area/station/maintenance/starboard/greater)
"Ei" = (
/obj/item/paper{
	default_raw_text = "on break, talk to me in 30 minutes"
	},
/turf/open/misc/asteroid,
/area/template_noop)
"Eu" = (
/obj/modular_map_connector,
/turf/template_noop,
/area/template_noop)
"Ey" = (
/turf/closed/mineral/random/stationside/asteroid/porus,
/area/station/maintenance/starboard/greater)
"GX" = (
/obj/structure/closet/firecloset,
/obj/effect/decal/cleanable/dirt,
/turf/open/floor/iron/smooth,
/area/station/maintenance/starboard/greater)
"HJ" = (
/turf/open/misc/asteroid,
/area/station/maintenance/starboard/greater)
"Ix" = (
/obj/effect/turf_decal/sand/plating,
/obj/structure/girder,
/obj/item/stack/sheet/iron,
/turf/open/floor/plating,
/area/station/maintenance/starboard/greater)
"Iy" = (
/obj/effect/decal/cleanable/dirt,
/obj/effect/decal/cleanable/cobweb,
/obj/effect/spawner/random/trash/mess,
/turf/open/floor/iron/smooth,
/area/station/maintenance/starboard/greater)
"IP" = (
/obj/effect/decal/cleanable/dirt,
/obj/machinery/door/airlock/maintenance_hatch{
	name = "Maintenance Hatch"
	},
/obj/effect/mapping_helpers/airlock/access/any/supply/maintenance,
/obj/effect/mapping_helpers/airlock/unres{
	dir = 8
	},
/turf/open/floor/iron/smooth,
/area/station/maintenance/starboard/greater)
"IU" = (
/obj/machinery/light/small/directional/north,
/obj/structure/chair/stool/directional/west,
/mob/living/simple_animal/hostile/lizard/space{
	name = "Builds-The-Maintenance"
	},
/turf/open/misc/asteroid,
/area/template_noop)
"KG" = (
/obj/item/plate/large,
/obj/item/food/cheese_sandwich{
	pixel_y = 10
	},
/turf/open/misc/asteroid,
/area/template_noop)
"KM" = (
/obj/structure/closet/crate,
/obj/item/pickaxe/mini,
/obj/effect/decal/cleanable/dirt,
/obj/effect/spawner/random/engineering/flashlight,
/obj/effect/spawner/random/maintenance/two,
/obj/machinery/light/small/directional/north,
/turf/open/floor/iron/smooth,
/area/station/maintenance/starboard/greater)
"KT" = (
/obj/machinery/atmospherics/pipe/smart/manifold4w/scrubbers/hidden/layer2,
/obj/machinery/atmospherics/pipe/smart/manifold4w/supply/hidden/layer4,
/obj/effect/decal/cleanable/dirt,
/obj/structure/cable,
/obj/effect/mapping_helpers/airlock/access/any/supply/maintenance,
/obj/machinery/door/airlock/maintenance_hatch{
	name = "Maintenance Hatch"
	},
/turf/open/floor/catwalk_floor,
/area/station/maintenance/starboard/greater)
"LF" = (
/obj/machinery/portable_atmospherics/canister/air,
/obj/effect/turf_decal/sand/plating,
/turf/open/floor/plating,
/area/template_noop)
"LL" = (
/obj/machinery/atmospherics/pipe/smart/manifold4w/supply/hidden/layer4,
/obj/machinery/atmospherics/pipe/smart/manifold4w/scrubbers/hidden/layer2,
/obj/effect/decal/cleanable/dirt,
/obj/effect/spawner/random/trash/food_packaging,
/obj/structure/cable,
/turf/open/floor/catwalk_floor,
/area/station/maintenance/starboard/greater)
"LR" = (
/obj/machinery/atmospherics/pipe/smart/manifold4w/scrubbers/hidden/layer2,
/obj/machinery/atmospherics/pipe/smart/manifold4w/supply/hidden/layer4,
/obj/effect/decal/cleanable/dirt,
/obj/structure/cable,
/obj/effect/landmark/event_spawn,
/turf/open/floor/catwalk_floor,
/area/station/maintenance/starboard/greater)
"MI" = (
/turf/closed/wall/rock/porous,
/area/template_noop)
"Nw" = (
/obj/structure/sign/warning/vacuum/external{
	pixel_x = -32
	},
/obj/effect/turf_decal/sand/plating,
/obj/machinery/light/small/directional/east,
/obj/machinery/atmospherics/pipe/smart/manifold4w/supply/hidden/layer4,
/obj/structure/cable,
/turf/open/floor/plating,
/area/station/maintenance/starboard/greater)
"Nx" = (
/turf/template_noop,
/area/template_noop)
"Nz" = (
/turf/closed/wall/rock/porous,
/area/station/maintenance/starboard/greater)
"Of" = (
/turf/open/misc/asteroid/airless,
/area/template_noop)
"Pj" = (
/obj/item/storage/toolbox/electrical,
/turf/open/misc/asteroid,
/area/template_noop)
"PS" = (
/obj/machinery/atmospherics/pipe/smart/manifold4w/supply/hidden/layer4,
/obj/item/clothing/head/cone{
	pixel_x = -8
	},
/obj/effect/decal/cleanable/dirt,
/obj/structure/cable,
/turf/open/floor/catwalk_floor,
/area/station/maintenance/starboard/greater)
"RC" = (
/obj/machinery/atmospherics/pipe/smart/manifold4w/supply/hidden/layer4,
/obj/machinery/atmospherics/pipe/smart/manifold4w/scrubbers/hidden/layer2,
/obj/effect/decal/cleanable/dirt,
/obj/structure/cable,
/obj/effect/spawner/random/trash/garbage,
/obj/item/stack/rods,
/turf/open/floor/catwalk_floor,
/area/station/maintenance/starboard/greater)
"SN" = (
/obj/effect/turf_decal/sand/plating,
/turf/open/floor/plating,
/area/station/maintenance/starboard/greater)
"Tc" = (
/obj/effect/turf_decal/sand/plating,
/obj/structure/girder,
/turf/open/floor/plating,
/area/station/maintenance/starboard/greater)
"TA" = (
/obj/machinery/atmospherics/pipe/smart/manifold4w/supply/hidden/layer4,
/obj/machinery/atmospherics/pipe/smart/manifold4w/scrubbers/hidden/layer2,
/obj/effect/decal/cleanable/dirt,
/obj/structure/cable,
/turf/open/floor/catwalk_floor,
/area/station/maintenance/starboard/greater)
"TH" = (
/turf/open/floor/catwalk_floor,
/area/station/maintenance/starboard/greater)
"TQ" = (
/obj/machinery/atmospherics/pipe/smart/manifold4w/supply/hidden/layer4,
/obj/effect/decal/cleanable/dirt,
/obj/structure/cable,
/turf/open/floor/catwalk_floor,
/area/station/maintenance/starboard/greater)
"UC" = (
/obj/effect/decal/cleanable/dirt,
/obj/machinery/atmospherics/components/unary/vent_pump/on/layer4{
	dir = 1
	},
/obj/machinery/light/small/directional/south,
/turf/open/floor/iron/smooth,
/area/station/maintenance/starboard/greater)
"VT" = (
/obj/structure/closet/emcloset,
/obj/effect/decal/cleanable/dirt,
/turf/open/floor/iron/smooth,
/area/station/maintenance/starboard/greater)
"Xc" = (
/turf/open/floor/iron/smooth,
/area/station/maintenance/starboard/greater)
"Xr" = (
/turf/closed/wall,
/area/station/maintenance/starboard/greater)
"Xx" = (
/obj/item/shovel,
/turf/open/misc/asteroid,
/area/template_noop)
"XG" = (
/turf/closed/wall/r_wall,
/area/station/maintenance/starboard/greater)
"XP" = (
/obj/structure/door_assembly/door_assembly_ext,
/obj/item/stack/cable_coil,
/obj/item/stack/sheet/glass,
/turf/open/misc/asteroid,
/area/template_noop)
"YD" = (
/obj/effect/decal/cleanable/dirt,
/obj/structure/chair/plastic{
	dir = 8
	},
/turf/open/floor/iron/smooth,
/area/station/maintenance/starboard/greater)
"YT" = (
/turf/closed/wall/rust,
/area/station/maintenance/starboard/greater)

(1,1,1) = {"
Nx
Nx
Nx
Nx
Nx
Nx
Eu
Nx
Nx
Nx
Nx
Nx
Nx
Nx
Nx
Nx
Nx
Nx
Nx
Nx
Nx
"}
(2,1,1) = {"
Nx
Nx
Nx
Nx
Nx
bD
rF
Xr
gN
fP
Nx
Nx
Nx
Nx
Nx
Nx
Nx
Nx
Nx
Nx
Nx
"}
(3,1,1) = {"
Nx
Nx
Nx
Nx
Nx
nq
rF
Xr
bD
YD
Nx
Nx
Nx
Nx
Nx
Nx
BF
BF
BF
Nx
Nx
"}
(4,1,1) = {"
Nx
Nx
Nx
Nx
Nx
bD
rF
Xr
IP
Xr
Nx
Nx
Nx
Nx
Nx
Nx
BF
BF
BF
Nx
Nx
"}
(5,1,1) = {"
Nx
Nx
Nx
Nx
Nx
Xr
rF
rF
rF
ra
Nx
Nx
Nx
Nx
Nx
Nx
BF
BF
BF
Nx
Nx
"}
(6,1,1) = {"
BF
BF
BF
BF
BF
Xr
rF
Xr
Xr
CX
Nx
Nx
Nx
Nx
Nx
Nx
BF
BF
BF
BF
Nx
"}
(7,1,1) = {"
BF
BF
BF
BF
BF
Xc
cd
Xr
qO
wV
Nx
Nx
Nx
Nx
Nx
Nx
Xr
Ey
BF
BF
Nx
"}
(8,1,1) = {"
BF
BF
BF
BF
BF
Xr
rF
Xr
rP
wV
wV
wV
SN
SN
wV
SN
rv
Ey
Ey
BF
Nx
"}
(9,1,1) = {"
BF
BF
BF
BF
BF
Xr
xP
Xr
Xr
YT
Xr
Ey
Nz
Ey
Ey
Ey
SN
SN
Nz
BF
Nx
"}
(10,1,1) = {"
BF
BF
BF
BF
BF
Xr
rF
Xr
BF
BF
uP
uP
uP
uP
BF
BF
Ey
SN
YT
BF
Nx
"}
(11,1,1) = {"
BF
BF
BF
BF
BF
Xr
rF
Xr
BF
uP
uP
uP
uP
uP
uP
BF
YT
SN
YT
BF
Nx
"}
(12,1,1) = {"
BF
BF
BF
BF
BF
Xr
rF
Xr
BF
uP
uP
uP
uP
uP
uP
uP
Ey
SN
Ey
BF
Nx
"}
(13,1,1) = {"
BF
BF
BF
BF
BF
YT
rF
Xc
BF
uP
uP
uP
uP
uP
uP
BF
Ey
SN
Nx
Nx
Nx
"}
(14,1,1) = {"
BF
BF
BF
BF
BF
Xr
rF
Xr
BF
uP
uP
uP
uP
uP
uP
uP
Ey
kO
Nx
Nx
Nx
"}
(15,1,1) = {"
BF
BF
BF
BF
BF
Xr
rF
Xr
BF
uP
uP
uP
uP
uP
uP
BF
YT
SN
Nx
Nx
Nx
"}
(16,1,1) = {"
BF
BF
BF
BF
BF
Xr
rF
Xr
BF
BF
BF
uP
uP
uP
uP
uP
uP
ox
Nx
Nx
Nx
"}
(17,1,1) = {"
BF
BF
BF
BF
BF
Xr
rF
Xr
BF
BF
BF
BF
uP
uP
uP
uP
uP
uP
Nx
Nx
Nx
"}
(18,1,1) = {"
BF
BF
BF
BF
BF
Ix
rF
Xr
BF
BF
BF
BF
uP
uP
ox
uP
uP
uP
Nx
Nx
Nx
"}
(19,1,1) = {"
BF
BF
BF
BF
BF
YT
rF
Xr
BF
BF
BF
BF
BF
LF
Bu
uP
uP
BF
Nx
Nx
Nx
"}
(20,1,1) = {"
BF
BF
BF
Xr
Xr
YT
rF
zC
BF
BF
MI
BF
BF
BF
MI
BF
uP
uP
Nx
Nx
Nx
"}
(21,1,1) = {"
Nx
Of
Of
YT
GX
TA
rF
Tc
BF
kI
Pj
XP
BF
MI
se
uP
uP
uP
BF
BF
Nx
"}
(22,1,1) = {"
Nx
Xr
Xr
Xr
KM
TA
mF
Nz
Xr
Xr
uC
uP
uP
uP
uP
Bd
uP
ox
BF
BF
Nx
"}
(23,1,1) = {"
Nx
po
Nw
aM
TQ
LR
jb
hb
xa
aG
uP
Ei
uP
Xx
Bd
uP
uP
uP
BF
BF
Nx
"}
(24,1,1) = {"
bd
Xr
Xr
Xr
jp
LL
UC
Xr
Xr
Xr
IU
KG
BF
BF
AK
BF
uP
MI
BF
BF
Nx
"}
(25,1,1) = {"
Nx
Of
Of
Xr
VT
TA
wY
Xr
Iy
Xr
sA
du
BF
BF
uP
uP
uP
uP
BF
BF
Nx
"}
(26,1,1) = {"
Nx
Of
Of
Xr
Xr
mu
TA
KT
TA
Xr
BF
uP
MI
BF
BF
Ey
HJ
Xr
BF
BF
Nx
"}
(27,1,1) = {"
Nx
BF
BF
BF
Nx
Nx
Nx
Nx
TA
Tc
BF
BF
BF
BF
BF
Xr
HJ
Xr
BF
BF
Nx
"}
(28,1,1) = {"
BF
BF
BF
BF
Nx
Nx
Nx
Nx
mu
XG
Nx
Nx
Nx
Nx
Nx
Nx
SN
Xr
BF
Nx
Nx
"}
(29,1,1) = {"
Nx
Nx
Nx
Nx
Nx
Nx
Nx
Nx
TA
XG
Nx
Nx
Nx
Nx
Nx
Nx
SN
Ey
BF
Nx
Nx
"}
(30,1,1) = {"
Nx
Nx
Nx
Nx
Nx
Nx
Nx
Nx
TA
XG
Nx
Nx
Nx
Nx
Nx
Nx
SN
Ey
BF
Nx
Nx
"}
(31,1,1) = {"
Nx
Nx
Nx
Nx
Nx
Nx
Nx
Nx
TA
TH
Nx
Nx
Nx
Nx
Nx
Nx
SN
Xr
Nx
Nx
Nx
"}
(32,1,1) = {"
Nx
Nx
Nx
Nx
Nx
Nx
Nx
Nx
TA
XG
Nx
Nx
Nx
Nx
Nx
Nx
wV
Nz
BF
Nx
Nx
"}
(33,1,1) = {"
Nx
Nx
Nx
Nx
Nx
Nx
Nx
Nx
TA
XG
XG
XG
Nx
Nx
Nx
Nx
wV
Tc
BF
Nx
Nx
"}
(34,1,1) = {"
Nx
Nx
Nx
Nx
Nx
Nx
Nx
Nx
LL
TA
TA
XG
Nx
Nx
Nx
Nx
wV
wV
BF
BF
Nx
"}
(35,1,1) = {"
Nx
Nx
Nx
Nx
Nx
Nx
Nx
Nx
Nx
Nx
mu
XG
XG
XG
XG
XG
fy
Xr
Xr
BF
Nx
"}
(36,1,1) = {"
Nx
Nx
Nx
Nx
Nx
Nx
Nx
Nx
Nx
Nx
RC
TA
TQ
TQ
TQ
TQ
PS
TQ
Xr
Xr
Nx
"}
(37,1,1) = {"
Nx
Nx
Nx
Nx
Nx
Nx
Nx
Nx
Nx
Nx
Nx
mu
Nx
Nx
Nx
Nx
Nx
TQ
fX
fX
Nx
"}
(38,1,1) = {"
Nx
Nx
Nx
Nx
Nx
Nx
Nx
Nx
Nx
Nx
Nx
Nx
Nx
Nx
Nx
Nx
Nx
Nx
Nx
Nx
Nx
"}
