//MAP CONVERTED BY dmm2tgm.py THIS HEADER COMMENT PREVENTS RECONVERSION, DO NOT REMOVE
"a" = (
/turf/template_noop,
/area/template_noop)
"b" = (
/turf/closed/wall/rust,
/area/template_noop)
"d" = (
/obj/modular_map_connector,
/turf/closed/wall,
/area/template_noop)
"g" = (
/turf/open/floor/plating/asteroid/airless,
/area/template_noop)
"p" = (
/obj/effect/turf_decal/sand/plating,
/turf/open/floor/plating,
/area/template_noop)
"q" = (
/obj/effect/turf_decal/sand/plating,
/turf/open/floor/plating/airless,
/area/template_noop)
"r" = (
/obj/effect/turf_decal/sand/plating,
/obj/item/storage/toolbox/mechanical,
/turf/open/floor/plating,
/area/template_noop)
"x" = (
/turf/closed/wall/rock/porous,
/area/template_noop)
"y" = (
/obj/structure/ladder,
/obj/effect/turf_decal/sand/plating,
/turf/open/floor/plating,
/area/template_noop)
"z" = (
/turf/closed/wall,
/area/template_noop)
"A" = (
/obj/effect/decal/cleanable/dirt,
/turf/open/floor/plating,
/area/template_noop)
"D" = (
/obj/structure/closet/crate,
/obj/effect/spawner/random/maintenance/two,
/obj/effect/decal/cleanable/dirt,
/turf/open/floor/plating,
/area/template_noop)
"I" = (
/turf/closed/mineral/random/stationside/asteroid/porus,
/area/template_noop)
"Q" = (
/obj/effect/turf_decal/sand/plating,
/obj/machinery/light/small/directional/north,
/turf/open/floor/plating,
/area/template_noop)
"T" = (
/obj/structure/holosign/barrier/atmos,
/obj/effect/turf_decal/sand/plating,
/turf/open/floor/plating,
/area/template_noop)
"W" = (
/obj/effect/turf_decal/sand/plating,
/obj/item/stack/ore/glass,
/turf/open/floor/plating/airless,
/area/template_noop)

(1,1,1) = {"
z
z
b
I
I
a
a
a
a
"}
(2,1,1) = {"
z
D
p
A
z
a
a
a
a
"}
(3,1,1) = {"
b
Q
y
A
p
p
a
a
d
"}
(4,1,1) = {"
b
r
p
p
I
a
a
a
a
"}
(5,1,1) = {"
z
x
T
x
q
a
a
a
a
"}
(6,1,1) = {"
a
a
W
q
g
a
a
a
a
"}
(7,1,1) = {"
a
a
q
q
g
a
a
a
a
"}
