//MAP CONVERTED BY dmm2tgm.py THIS HEADER COMMENT PREVENTS RECONVERSION, DO NOT REMOVE
"a" = (
/turf/closed/wall,
/area/station/maintenance/department/crew_quarters/dorms)
"c" = (
/obj/effect/decal/cleanable/dirt,
/obj/effect/spawner/random/trash/moisture_trap,
/turf/open/floor/plating,
/area/station/maintenance/department/crew_quarters/dorms)
"e" = (
/obj/effect/decal/cleanable/dirt,
/obj/effect/spawner/random/trash/bucket,
/turf/open/floor/plating,
/area/station/maintenance/department/crew_quarters/dorms)
"j" = (
/obj/structure/grille,
/obj/effect/decal/cleanable/dirt,
/turf/open/floor/plating,
/area/station/maintenance/department/crew_quarters/dorms)
"k" = (
/obj/effect/decal/cleanable/dirt,
/turf/open/floor/iron/smooth,
/area/station/maintenance/department/crew_quarters/dorms)
"l" = (
/obj/effect/decal/cleanable/dirt,
/obj/effect/spawner/random/trash/box,
/turf/open/floor/plating,
/area/station/maintenance/department/crew_quarters/dorms)
"s" = (
/obj/effect/decal/cleanable/dirt,
/obj/structure/rack,
/obj/effect/spawner/random/trash/soap,
/obj/effect/spawner/random/trash/soap,
/turf/open/floor/iron/smooth,
/area/station/maintenance/department/crew_quarters/dorms)
"w" = (
/obj/effect/decal/cleanable/dirt,
/obj/structure/table,
/obj/effect/spawner/random/trash/janitor_supplies,
/turf/open/floor/iron/smooth,
/area/station/maintenance/department/crew_quarters/dorms)
"C" = (
/obj/machinery/door/airlock/maintenance_hatch{
	name = "Dorm Storage"
	},
/obj/effect/mapping_helpers/airlock/access/all/engineering/maintenance,
/obj/effect/mapping_helpers/airlock/unres{
	dir = 8
	},
/obj/effect/decal/cleanable/dirt,
/obj/modular_map_connector,
/turf/open/floor/iron/smooth,
/area/station/maintenance/department/crew_quarters/dorms)
"I" = (
/obj/effect/decal/cleanable/dirt,
/obj/structure/table,
/obj/structure/bedsheetbin,
/turf/open/floor/iron/smooth,
/area/station/maintenance/department/crew_quarters/dorms)
"S" = (
/turf/template_noop,
/area/template_noop)
"W" = (
/obj/effect/decal/cleanable/dirt,
/obj/machinery/light/small/directional/north,
/obj/structure/mop_bucket/janitorialcart,
/obj/item/mop,
/turf/open/floor/iron/smooth,
/area/station/maintenance/department/crew_quarters/dorms)

(1,1,1) = {"
S
a
a
a
a
a
a
"}
(2,1,1) = {"
S
l
j
k
k
w
a
"}
(3,1,1) = {"
S
c
j
k
k
I
a
"}
(4,1,1) = {"
S
e
j
k
k
k
a
"}
(5,1,1) = {"
S
S
S
W
k
s
a
"}
(6,1,1) = {"
S
S
S
S
C
a
a
"}
