//MAP CONVERTED BY dmm2tgm.py THIS HEADER COMMENT PREVENTS RECONVERSION, DO NOT REMOVE
"a" = (
/turf/closed/wall,
/area/maintenance/port/fore)
"b" = (
/obj/effect/decal/cleanable/dirt,
/obj/effect/spawner/random/trash/cigbutt,
/turf/open/floor/iron/smooth,
/area/maintenance/port/fore)
"c" = (
/turf/template_noop,
/area/template_noop)
"k" = (
/obj/effect/decal/cleanable/dirt,
/obj/structure/table,
/obj/structure/window/reinforced/spawner/west,
/obj/effect/spawner/random/engineering/toolbox,
/obj/machinery/door/window/southleft{
	req_one_access_txt = "32;19"
	},
/turf/open/floor/iron/smooth,
/area/maintenance/port/fore)
"n" = (
/obj/modular_map_root/tramstation{
	key = "maintenance_lowarrivals_attachment"
	},
/turf/open/floor/plating,
/area/maintenance/port/fore)
"r" = (
/obj/effect/decal/cleanable/dirt,
/obj/structure/rack,
/obj/effect/spawner/random/maintenance/three,
/obj/effect/spawner/random/engineering/flashlight,
/turf/open/floor/iron/smooth,
/area/maintenance/port/fore)
"v" = (
/obj/effect/decal/cleanable/dirt,
/turf/open/floor/iron/smooth,
/area/maintenance/port/fore)
"z" = (
/obj/machinery/door/airlock/maintenance_hatch{
	req_one_access_txt = "12"
	},
/obj/effect/decal/cleanable/dirt,
/obj/modular_map_connector,
/obj/effect/decal/cleanable/dirt,
/turf/open/floor/iron/smooth,
/area/maintenance/port/fore)
"B" = (
/obj/effect/decal/cleanable/dirt,
/obj/structure/closet,
/obj/effect/spawner/random/maintenance/three,
/turf/open/floor/iron/smooth,
/area/maintenance/port/fore)
"E" = (
/obj/effect/decal/cleanable/dirt,
/obj/machinery/light/small/directional/west,
/turf/open/floor/iron/smooth,
/area/maintenance/port/fore)
"G" = (
/obj/effect/decal/cleanable/dirt,
/obj/structure/table,
/obj/structure/window/reinforced/spawner/east,
/obj/effect/spawner/random/engineering/toolbox,
/obj/machinery/door/window/southright{
	req_one_access_txt = "32;19"
	},
/turf/open/floor/iron/smooth,
/area/maintenance/port/fore)
"H" = (
/obj/effect/decal/cleanable/dirt,
/obj/structure/rack,
/obj/effect/spawner/random/maintenance/two,
/obj/effect/spawner/random/engineering/tool,
/turf/open/floor/iron/smooth,
/area/maintenance/port/fore)
"J" = (
/obj/effect/spawner/structure/window/reinforced,
/turf/open/floor/plating,
/area/maintenance/port/fore)
"M" = (
/obj/effect/decal/cleanable/dirt,
/obj/machinery/door/airlock/maintenance_hatch{
	name = "Water Closet";
	req_one_access_txt = "12"
	},
/turf/open/floor/iron/smooth,
/area/maintenance/port/fore)
"N" = (
/obj/effect/decal/cleanable/dirt,
/obj/effect/spawner/random/trash/food_packaging,
/turf/open/floor/iron/smooth,
/area/maintenance/port/fore)
"Q" = (
/obj/effect/decal/cleanable/dirt,
/obj/structure/extinguisher_cabinet/directional/east,
/turf/open/floor/iron/smooth,
/area/maintenance/port/fore)
"S" = (
/obj/effect/decal/cleanable/dirt,
/obj/machinery/door/airlock/maintenance/glass{
	req_access_txt = "12"
	},
/turf/open/floor/iron/smooth,
/area/maintenance/port/fore)
"Y" = (
/obj/effect/decal/cleanable/dirt,
/obj/structure/mirror/directional/north,
/obj/structure/sink/kitchen{
	desc = "A sink used for washing one's hands and face. It looks rusty and home-made";
	name = "old sink";
	pixel_y = 12
	},
/turf/open/floor/iron/smooth,
/area/maintenance/port/fore)

(1,1,1) = {"
a
a
a
a
a
a
a
a
a
"}
(2,1,1) = {"
a
r
E
v
a
Y
E
B
a
"}
(3,1,1) = {"
a
k
v
v
a
a
M
a
a
"}
(4,1,1) = {"
a
G
v
v
S
E
v
b
a
"}
(5,1,1) = {"
a
H
Q
v
J
N
v
v
a
"}
(6,1,1) = {"
a
a
a
n
a
c
c
z
c
"}
