//MAP CONVERTED BY dmm2tgm.py THIS HEADER COMMENT PREVENTS RECONVERSION, DO NOT REMOVE
"a" = (
/obj/effect/decal/cleanable/dirt,
/turf/open/floor/iron/smooth,
/area/station/maintenance/central/greater)
"f" = (
/turf/template_noop,
/area/template_noop)
"j" = (
/turf/closed/wall,
/area/station/maintenance/central/greater)
"o" = (
/obj/effect/decal/cleanable/dirt,
/obj/structure/closet/emcloset,
/turf/open/floor/iron/smooth,
/area/station/maintenance/central/greater)
"q" = (
/obj/effect/decal/cleanable/dirt,
/obj/structure/table,
/obj/effect/spawner/random/engineering/tool,
/obj/effect/spawner/random/engineering/flashlight,
/turf/open/floor/iron/smooth,
/area/station/maintenance/central/greater)
"u" = (
/obj/effect/decal/cleanable/dirt,
/obj/structure/rack,
/obj/effect/spawner/random/maintenance/three,
/turf/open/floor/iron/smooth,
/area/station/maintenance/central/greater)
"z" = (
/obj/modular_map_connector,
/obj/effect/decal/cleanable/dirt,
/obj/machinery/door/airlock/maintenance_hatch{
	name = "Security Maintenance Hatch"
	},
/obj/effect/mapping_helpers/airlock/access/any/engineering/maintenance,
/obj/effect/mapping_helpers/airlock/unres{
	dir = 4
	},
/turf/open/floor/iron/smooth,
/area/station/maintenance/central/greater)
"C" = (
/obj/effect/decal/cleanable/dirt,
/obj/machinery/door/airlock/maintenance_hatch{
	name = "Security Maintenance Hatch"
	},
/obj/effect/mapping_helpers/airlock/access/any/engineering/maintenance,
/turf/open/floor/iron/smooth,
/area/station/maintenance/central/greater)
"J" = (
/obj/effect/decal/cleanable/dirt,
/obj/structure/closet/firecloset,
/turf/open/floor/iron/smooth,
/area/station/maintenance/central/greater)
"P" = (
/obj/effect/decal/cleanable/dirt,
/obj/structure/grille,
/turf/open/floor/iron/smooth,
/area/station/maintenance/central/greater)

(1,1,1) = {"
f
f
f
f
z
f
"}
(2,1,1) = {"
j
o
j
a
a
f
"}
(3,1,1) = {"
j
P
C
a
a
f
"}
(4,1,1) = {"
j
J
j
u
q
f
"}
(5,1,1) = {"
j
j
j
j
j
f
"}
