//MAP CONVERTED BY dmm2tgm.py THIS HEADER COMMENT PREVENTS RECONVERSION, DO NOT REMOVE
"aV" = (
/obj/modular_map_connector,
/turf/template_noop,
/area/station/maintenance/department/crew_quarters/dorms)
"be" = (
/obj/effect/turf_decal/sand/plating,
/obj/item/shovel,
/turf/open/floor/plating,
/area/station/maintenance/department/crew_quarters/dorms)
"bo" = (
/obj/structure/disposalpipe/segment,
/obj/machinery/atmospherics/pipe/smart/manifold4w/scrubbers/hidden/layer2,
/obj/machinery/atmospherics/pipe/smart/manifold4w/supply/hidden/layer4,
/obj/structure/cable,
/obj/effect/turf_decal/sand/plating,
/turf/open/floor/plating,
/area/station/maintenance/central/lesser)
"bq" = (
/obj/effect/decal/cleanable/dirt,
/obj/machinery/duct,
/turf/open/floor/plating,
/area/station/maintenance/department/crew_quarters/dorms)
"by" = (
/obj/machinery/atmospherics/pipe/smart/manifold4w/scrubbers/hidden/layer2,
/obj/structure/cable,
/obj/machinery/atmospherics/pipe/smart/manifold4w/supply/hidden/layer4,
/obj/machinery/duct,
/obj/effect/turf_decal/sand/plating,
/obj/structure/holosign/barrier/engineering,
/turf/open/floor/plating,
/area/station/maintenance/department/crew_quarters/dorms)
"cS" = (
/obj/structure/disposalpipe/segment,
/obj/machinery/atmospherics/pipe/smart/manifold4w/scrubbers/hidden/layer2,
/obj/machinery/atmospherics/pipe/smart/manifold4w/supply/hidden/layer4,
/obj/structure/cable,
/obj/effect/decal/cleanable/dirt,
/turf/open/floor/catwalk_floor,
/area/station/maintenance/department/crew_quarters/dorms)
"do" = (
/obj/machinery/atmospherics/pipe/smart/manifold4w/scrubbers/hidden/layer2,
/obj/machinery/atmospherics/pipe/smart/manifold4w/supply/hidden/layer4,
/obj/effect/decal/cleanable/dirt,
/obj/structure/disposalpipe/segment{
	dir = 6
	},
/obj/structure/cable,
/turf/open/floor/catwalk_floor,
/area/station/maintenance/central/lesser)
"dp" = (
/obj/item/stack/ore/iron,
/turf/open/misc/asteroid,
/area/station/maintenance/department/crew_quarters/dorms)
"eM" = (
/turf/closed/mineral/random/stationside/asteroid/porus,
/area/station/maintenance/department/crew_quarters/dorms)
"fL" = (
/mob/living/basic/pet/dog/bullterrier{
	desc = "walter";
	name = "walter"
	},
/turf/open/misc/asteroid,
/area/misc/asteroid)
"fP" = (
/obj/effect/decal/cleanable/dirt,
/obj/structure/rack,
/obj/effect/spawner/random/maintenance/three,
/turf/open/floor/iron/smooth,
/area/station/maintenance/department/crew_quarters/dorms)
"gn" = (
/turf/closed/wall/rock/porous,
/area/station/maintenance/department/crew_quarters/dorms)
"gU" = (
/obj/effect/turf_decal/sand/plating,
/turf/open/floor/plating,
/area/station/maintenance/department/crew_quarters/dorms)
"is" = (
/obj/structure/disposalpipe/segment{
	dir = 5
	},
/obj/machinery/atmospherics/pipe/smart/manifold4w/scrubbers/hidden/layer2,
/obj/machinery/atmospherics/pipe/smart/manifold4w/supply/hidden/layer4,
/obj/structure/cable,
/obj/effect/decal/cleanable/dirt,
/turf/open/floor/catwalk_floor,
/area/station/maintenance/department/crew_quarters/dorms)
"jb" = (
/turf/open/misc/asteroid,
/area/station/maintenance/department/crew_quarters/dorms)
"kN" = (
/obj/effect/decal/cleanable/dirt,
/obj/structure/cable,
/obj/machinery/power/apc/auto_name/directional/south,
/turf/open/floor/catwalk_floor,
/area/station/maintenance/department/crew_quarters/dorms)
"kW" = (
/obj/machinery/duct,
/obj/machinery/atmospherics/pipe/smart/manifold4w/scrubbers/hidden/layer2,
/obj/structure/cable,
/obj/machinery/atmospherics/pipe/smart/manifold4w/supply/hidden/layer4,
/obj/effect/decal/cleanable/dirt,
/obj/structure/holosign/barrier/engineering,
/turf/open/floor/catwalk_floor,
/area/station/maintenance/department/crew_quarters/dorms)
"mj" = (
/obj/machinery/atmospherics/pipe/smart/manifold4w/scrubbers/hidden/layer2,
/obj/machinery/atmospherics/pipe/smart/manifold4w/supply/hidden/layer4,
/obj/effect/decal/cleanable/dirt,
/obj/structure/disposalpipe/segment{
	dir = 9
	},
/obj/structure/cable,
/turf/open/floor/catwalk_floor,
/area/station/maintenance/central/lesser)
"mo" = (
/turf/open/floor/iron/smooth,
/area/station/maintenance/central/lesser)
"mw" = (
/obj/effect/decal/cleanable/dirt,
/obj/machinery/atmospherics/components/unary/vent_pump/on/layer4{
	dir = 1
	},
/turf/open/floor/iron/smooth,
/area/station/maintenance/department/crew_quarters/dorms)
"oi" = (
/obj/structure/ore_box,
/turf/open/misc/asteroid,
/area/station/maintenance/department/crew_quarters/dorms)
"ol" = (
/turf/closed/wall/rust,
/area/station/maintenance/central/lesser)
"ro" = (
/obj/machinery/atmospherics/pipe/smart/manifold4w/scrubbers/hidden/layer2,
/obj/structure/cable,
/obj/machinery/atmospherics/pipe/smart/manifold4w/supply/hidden/layer4,
/obj/machinery/duct,
/obj/effect/turf_decal/sand/plating,
/obj/item/stack/ore/glass,
/turf/open/floor/plating,
/area/station/maintenance/department/crew_quarters/dorms)
"rw" = (
/obj/effect/decal/cleanable/dirt,
/obj/structure/closet/firecloset,
/turf/open/floor/iron/smooth,
/area/station/maintenance/department/crew_quarters/dorms)
"rF" = (
/turf/closed/wall/r_wall,
/area/station/maintenance/central/lesser)
"rQ" = (
/obj/structure/cable,
/obj/machinery/atmospherics/pipe/smart/manifold4w/scrubbers/hidden/layer2,
/obj/machinery/atmospherics/pipe/smart/manifold4w/supply/hidden/layer4,
/obj/effect/decal/cleanable/dirt,
/obj/structure/disposalpipe/segment{
	dir = 9
	},
/turf/open/floor/catwalk_floor,
/area/station/maintenance/central/lesser)
"so" = (
/obj/machinery/atmospherics/pipe/smart/manifold4w/scrubbers/hidden/layer2,
/obj/structure/cable,
/obj/machinery/atmospherics/pipe/smart/manifold4w/supply/hidden/layer4,
/obj/machinery/duct,
/obj/effect/turf_decal/sand/plating,
/obj/item/stack/ore/iron,
/turf/open/floor/plating,
/area/station/maintenance/department/crew_quarters/dorms)
"sq" = (
/obj/structure/disposalpipe/segment{
	dir = 6
	},
/obj/machinery/atmospherics/pipe/smart/manifold4w/scrubbers/hidden/layer2,
/obj/machinery/atmospherics/pipe/smart/manifold4w/supply/hidden/layer4,
/obj/structure/cable,
/obj/effect/turf_decal/sand/plating,
/obj/item/stack/ore/glass,
/turf/open/floor/plating,
/area/station/maintenance/central/lesser)
"sA" = (
/obj/effect/decal/cleanable/dirt,
/turf/open/floor/iron/smooth,
/area/station/maintenance/central/lesser)
"tx" = (
/obj/structure/disposalpipe/segment{
	dir = 9
	},
/obj/machinery/atmospherics/pipe/smart/manifold4w/scrubbers/hidden/layer2,
/obj/machinery/atmospherics/pipe/smart/manifold4w/supply/hidden/layer4,
/obj/structure/cable,
/obj/effect/decal/cleanable/dirt,
/turf/open/floor/catwalk_floor,
/area/station/maintenance/department/crew_quarters/dorms)
"tI" = (
/obj/machinery/atmospherics/pipe/smart/manifold4w/scrubbers/hidden/layer2,
/obj/structure/cable,
/obj/machinery/atmospherics/pipe/smart/manifold4w/supply/hidden/layer4,
/obj/effect/decal/cleanable/dirt,
/turf/open/floor/catwalk_floor,
/area/station/maintenance/department/crew_quarters/dorms)
"tL" = (
/obj/machinery/atmospherics/pipe/smart/manifold4w/scrubbers/hidden/layer2,
/obj/structure/cable,
/obj/machinery/atmospherics/pipe/smart/manifold4w/supply/hidden/layer4,
/obj/effect/decal/cleanable/dirt,
/obj/machinery/airalarm/directional/north,
/turf/open/floor/catwalk_floor,
/area/station/maintenance/department/crew_quarters/dorms)
"tN" = (
/turf/open/floor/catwalk_floor,
/area/template_noop)
"uZ" = (
/turf/open/misc/asteroid,
/area/misc/asteroid)
"vZ" = (
/obj/structure/disposalpipe/segment{
	dir = 4
	},
/obj/machinery/atmospherics/pipe/smart/manifold4w/scrubbers/hidden/layer2,
/obj/machinery/atmospherics/pipe/smart/manifold4w/supply/hidden/layer4,
/obj/structure/cable,
/obj/effect/decal/cleanable/dirt,
/turf/open/floor/catwalk_floor,
/area/station/maintenance/department/crew_quarters/dorms)
"we" = (
/obj/structure/disposalpipe/segment{
	dir = 4
	},
/obj/machinery/atmospherics/pipe/smart/manifold4w/scrubbers/hidden/layer2,
/obj/machinery/atmospherics/pipe/smart/manifold4w/supply/hidden/layer4,
/obj/structure/cable,
/obj/effect/turf_decal/sand/plating,
/turf/open/floor/plating,
/area/station/maintenance/central/lesser)
"xl" = (
/turf/closed/wall,
/area/station/maintenance/central/lesser)
"xu" = (
/turf/closed/mineral/random/stationside/asteroid/porus,
/area/misc/asteroid)
"yj" = (
/obj/structure/cable,
/obj/machinery/atmospherics/pipe/smart/manifold4w/scrubbers/hidden/layer2,
/obj/machinery/atmospherics/pipe/smart/manifold4w/supply/hidden/layer4,
/obj/effect/decal/cleanable/dirt,
/obj/structure/disposalpipe/segment{
	dir = 4
	},
/turf/open/floor/catwalk_floor,
/area/station/maintenance/central/lesser)
"yt" = (
/obj/item/stack/ore/glass,
/turf/open/misc/asteroid,
/area/station/maintenance/department/crew_quarters/dorms)
"yu" = (
/obj/item/relic,
/turf/open/misc/asteroid/dug,
/area/misc/asteroid)
"yw" = (
/obj/item/stack/ore/glass,
/turf/open/misc/asteroid,
/area/misc/asteroid)
"yD" = (
/obj/effect/decal/cleanable/dirt,
/obj/effect/landmark/blobstart,
/turf/open/floor/iron/smooth,
/area/station/maintenance/department/crew_quarters/dorms)
"zk" = (
/obj/structure/cable,
/obj/machinery/atmospherics/pipe/smart/manifold4w/scrubbers/hidden/layer2,
/obj/machinery/atmospherics/pipe/smart/manifold4w/supply/hidden/layer4,
/obj/effect/decal/cleanable/dirt,
/obj/structure/disposalpipe/junction{
	dir = 1
	},
/turf/open/floor/catwalk_floor,
/area/station/maintenance/central/lesser)
"Al" = (
/turf/open/floor/catwalk_floor,
/area/station/maintenance/central/lesser)
"CK" = (
/obj/machinery/atmospherics/pipe/smart/manifold4w/scrubbers/hidden/layer2,
/obj/structure/cable,
/obj/machinery/atmospherics/pipe/smart/manifold4w/supply/hidden/layer4,
/obj/machinery/duct,
/obj/effect/turf_decal/sand/plating,
/turf/open/floor/plating,
/area/station/maintenance/department/crew_quarters/dorms)
"CO" = (
/turf/template_noop,
/area/station/maintenance/department/crew_quarters/dorms)
"DS" = (
/turf/closed/wall/rock/porous,
/area/station/maintenance/central/lesser)
"Ef" = (
/obj/effect/decal/cleanable/dirt,
/obj/effect/spawner/random/trash/moisture_trap,
/turf/open/floor/plating,
/area/station/maintenance/department/crew_quarters/dorms)
"En" = (
/obj/structure/disposalpipe/segment{
	dir = 4
	},
/obj/machinery/atmospherics/pipe/smart/manifold4w/scrubbers/hidden/layer2,
/obj/machinery/atmospherics/pipe/smart/manifold4w/supply/hidden/layer4,
/obj/structure/cable,
/obj/effect/decal/cleanable/dirt,
/obj/structure/holosign/barrier/engineering,
/turf/open/floor/catwalk_floor,
/area/station/maintenance/department/crew_quarters/dorms)
"Fb" = (
/obj/effect/decal/cleanable/dirt,
/turf/open/floor/plating,
/area/station/maintenance/department/crew_quarters/dorms)
"GJ" = (
/obj/effect/turf_decal/sand/plating,
/turf/open/floor/plating,
/area/station/maintenance/central/lesser)
"HC" = (
/obj/effect/decal/cleanable/dirt,
/obj/structure/rack,
/obj/effect/spawner/random/maintenance/three,
/turf/open/floor/iron/smooth,
/area/station/maintenance/central/lesser)
"HW" = (
/obj/structure/cable,
/obj/machinery/atmospherics/pipe/smart/manifold4w/scrubbers/hidden/layer2,
/obj/machinery/atmospherics/pipe/smart/manifold4w/supply/hidden/layer4,
/obj/effect/decal/cleanable/dirt,
/obj/structure/disposalpipe/segment,
/turf/open/floor/catwalk_floor,
/area/station/maintenance/central/lesser)
"Ii" = (
/turf/closed/wall,
/area/station/maintenance/department/crew_quarters/dorms)
"Il" = (
/obj/structure/cable,
/obj/machinery/atmospherics/pipe/smart/manifold4w/scrubbers/hidden/layer2,
/obj/machinery/atmospherics/pipe/smart/manifold4w/supply/hidden/layer4,
/obj/effect/decal/cleanable/dirt,
/obj/structure/disposalpipe/segment{
	dir = 6
	},
/turf/open/floor/catwalk_floor,
/area/station/maintenance/central/lesser)
"IZ" = (
/obj/machinery/atmospherics/pipe/smart/manifold4w/scrubbers/hidden/layer2,
/obj/machinery/atmospherics/pipe/smart/manifold4w/supply/hidden/layer4,
/obj/structure/cable,
/obj/structure/disposalpipe/segment,
/obj/effect/decal/cleanable/dirt,
/turf/open/floor/catwalk_floor,
/area/station/maintenance/central/lesser)
"JP" = (
/obj/machinery/atmospherics/pipe/smart/manifold4w/scrubbers/hidden/layer2,
/obj/structure/cable,
/obj/machinery/atmospherics/pipe/smart/manifold4w/supply/hidden/layer4,
/obj/effect/turf_decal/sand/plating,
/obj/structure/disposalpipe/segment{
	dir = 6
	},
/turf/open/floor/plating,
/area/station/maintenance/department/crew_quarters/dorms)
"Ka" = (
/obj/machinery/plumbing/synthesizer{
	reagent_id = /datum/reagent/water
	},
/obj/effect/decal/cleanable/dirt,
/obj/effect/decal/cleanable/cobweb/cobweb2,
/turf/open/floor/plating,
/area/station/maintenance/department/crew_quarters/dorms)
"KD" = (
/obj/machinery/atmospherics/pipe/smart/manifold4w/scrubbers/hidden/layer2,
/obj/structure/cable,
/obj/machinery/atmospherics/pipe/smart/manifold4w/supply/hidden/layer4,
/obj/effect/turf_decal/sand/plating,
/obj/structure/disposalpipe/segment{
	dir = 4
	},
/turf/open/floor/plating,
/area/station/maintenance/department/crew_quarters/dorms)
"Lm" = (
/obj/effect/decal/cleanable/dirt,
/obj/effect/turf_decal/bot,
/obj/structure/reagent_dispensers/watertank,
/turf/open/floor/plating,
/area/station/maintenance/department/crew_quarters/dorms)
"Lq" = (
/obj/machinery/atmospherics/pipe/smart/manifold4w/scrubbers/hidden/layer2,
/obj/machinery/atmospherics/pipe/smart/manifold4w/supply/hidden/layer4,
/obj/structure/cable,
/obj/machinery/door/airlock/maintenance_hatch,
/obj/structure/disposalpipe/segment,
/obj/effect/decal/cleanable/dirt,
/obj/effect/mapping_helpers/airlock/access/any/engineering/maintenance/departmental,
/turf/open/floor/catwalk_floor,
/area/station/maintenance/department/crew_quarters/dorms)
"LA" = (
/obj/machinery/atmospherics/pipe/smart/manifold4w/supply/hidden/layer4,
/obj/machinery/atmospherics/pipe/smart/manifold4w/scrubbers/hidden/layer2,
/obj/effect/decal/cleanable/dirt,
/obj/structure/disposalpipe/segment{
	dir = 4
	},
/obj/structure/cable,
/turf/open/floor/catwalk_floor,
/area/station/maintenance/central/lesser)
"Ma" = (
/obj/effect/decal/cleanable/dirt,
/obj/structure/closet/emcloset,
/turf/open/floor/iron/smooth,
/area/station/maintenance/department/crew_quarters/dorms)
"Mq" = (
/obj/machinery/duct,
/obj/machinery/atmospherics/pipe/smart/manifold4w/scrubbers/hidden/layer2,
/obj/structure/cable,
/obj/machinery/atmospherics/pipe/smart/manifold4w/supply/hidden/layer4,
/obj/effect/decal/cleanable/dirt,
/obj/structure/barricade/wooden,
/turf/open/floor/catwalk_floor,
/area/station/maintenance/department/crew_quarters/dorms)
"ML" = (
/obj/machinery/atmospherics/pipe/smart/manifold4w/scrubbers/hidden/layer2,
/obj/structure/cable,
/obj/machinery/atmospherics/pipe/smart/manifold4w/supply/hidden/layer4,
/obj/effect/turf_decal/sand/plating,
/turf/open/floor/plating,
/area/station/maintenance/department/crew_quarters/dorms)
"MN" = (
/obj/effect/decal/cleanable/dirt,
/obj/machinery/duct,
/obj/machinery/door/airlock{
	name = "Water Closet"
	},
/obj/effect/mapping_helpers/airlock/access/all/engineering/maintenance,
/turf/open/floor/plating,
/area/station/maintenance/department/crew_quarters/dorms)
"Nd" = (
/obj/effect/turf_decal/sand/plating,
/obj/structure/ore_box,
/turf/open/floor/plating,
/area/station/maintenance/department/crew_quarters/dorms)
"Nj" = (
/obj/structure/disposalpipe/segment{
	dir = 4
	},
/obj/machinery/atmospherics/pipe/smart/manifold4w/scrubbers/hidden/layer2,
/obj/machinery/atmospherics/pipe/smart/manifold4w/supply/hidden/layer4,
/obj/structure/cable,
/obj/effect/decal/cleanable/dirt,
/obj/structure/barricade/wooden,
/turf/open/floor/catwalk_floor,
/area/station/maintenance/department/crew_quarters/dorms)
"Nx" = (
/obj/machinery/atmospherics/pipe/smart/manifold4w/scrubbers/hidden/layer2,
/obj/structure/cable,
/obj/machinery/atmospherics/pipe/smart/manifold4w/supply/hidden/layer4,
/obj/machinery/duct,
/obj/effect/turf_decal/sand/plating,
/obj/structure/barricade/wooden,
/turf/open/floor/plating,
/area/station/maintenance/department/crew_quarters/dorms)
"Oi" = (
/obj/item/stack/ore/silver,
/turf/open/misc/asteroid,
/area/misc/asteroid)
"OF" = (
/obj/item/pickaxe/emergency,
/turf/open/misc/asteroid,
/area/misc/asteroid)
"OI" = (
/turf/template_noop,
/area/template_noop)
"PO" = (
/obj/effect/decal/cleanable/dirt,
/obj/machinery/atmospherics/components/unary/vent_scrubber/on/layer2{
	dir = 1
	},
/turf/open/floor/iron/smooth,
/area/station/maintenance/department/crew_quarters/dorms)
"PP" = (
/obj/machinery/atmospherics/pipe/smart/manifold4w/scrubbers/hidden/layer2,
/obj/structure/cable,
/obj/machinery/atmospherics/pipe/smart/manifold4w/supply/hidden/layer4,
/obj/effect/turf_decal/sand/plating,
/obj/structure/disposalpipe/segment{
	dir = 9
	},
/turf/open/floor/plating,
/area/station/maintenance/department/crew_quarters/dorms)
"Rt" = (
/obj/effect/decal/cleanable/dirt,
/obj/effect/spawner/random/trash/moisture_trap,
/turf/open/floor/iron/smooth,
/area/station/maintenance/central/lesser)
"RA" = (
/obj/effect/decal/cleanable/dirt,
/obj/structure/grille,
/turf/open/floor/iron/smooth,
/area/station/maintenance/department/crew_quarters/dorms)
"Se" = (
/obj/machinery/atmospherics/pipe/smart/manifold4w/scrubbers/hidden/layer2,
/obj/structure/cable,
/obj/machinery/atmospherics/pipe/smart/manifold4w/supply/hidden/layer4,
/obj/effect/turf_decal/sand/plating,
/obj/structure/disposalpipe/segment,
/turf/open/floor/plating,
/area/station/maintenance/department/crew_quarters/dorms)
"Sr" = (
/obj/machinery/duct,
/obj/machinery/atmospherics/pipe/smart/manifold4w/scrubbers/hidden/layer2,
/obj/structure/cable,
/obj/machinery/atmospherics/pipe/smart/manifold4w/supply/hidden/layer4,
/obj/effect/decal/cleanable/dirt,
/turf/open/floor/catwalk_floor,
/area/station/maintenance/department/crew_quarters/dorms)
"UT" = (
/obj/effect/decal/cleanable/dirt,
/obj/effect/landmark/xeno_spawn,
/turf/open/floor/iron/smooth,
/area/station/maintenance/department/crew_quarters/dorms)
"VA" = (
/obj/effect/decal/cleanable/dirt,
/turf/closed/wall,
/area/station/maintenance/department/crew_quarters/dorms)
"WK" = (
/obj/machinery/atmospherics/pipe/smart/manifold4w/scrubbers/hidden/layer2,
/obj/structure/cable,
/obj/machinery/atmospherics/pipe/smart/manifold4w/supply/hidden/layer4,
/obj/machinery/duct,
/turf/open/floor/plating,
/area/station/maintenance/department/crew_quarters/dorms)
"XU" = (
/obj/structure/barricade/wooden,
/turf/open/misc/asteroid,
/area/misc/asteroid)
"Ya" = (
/obj/effect/decal/cleanable/dirt,
/turf/open/floor/iron/smooth,
/area/station/maintenance/department/crew_quarters/dorms)
"Yh" = (
/obj/effect/decal/cleanable/dirt,
/obj/structure/cable,
/obj/effect/landmark/event_spawn,
/turf/open/floor/catwalk_floor,
/area/station/maintenance/department/crew_quarters/dorms)
"Yw" = (
/turf/closed/wall/rust,
/area/station/maintenance/department/crew_quarters/dorms)
"ZJ" = (
/obj/effect/decal/cleanable/dirt,
/obj/structure/closet/crate,
/obj/effect/spawner/random/maintenance/two,
/obj/effect/spawner/random/engineering/tool,
/obj/effect/spawner/random/engineering/material_cheap,
/turf/open/floor/iron/smooth,
/area/station/maintenance/department/crew_quarters/dorms)

(1,1,1) = {"
OI
OI
OI
xu
xu
xu
gU
gn
Nd
jb
jb
jb
gU
Yw
Yw
jb
gU
gn
Ii
Ii
Ii
Ii
Yw
Yw
Ii
Ii
xu
xu
xu
OI
OI
OI
"}
(2,1,1) = {"
xu
xu
xu
xu
xu
xu
jb
so
CK
CK
CK
CK
ro
CK
Nx
by
CK
Sr
tI
tI
tI
tI
tI
ML
ML
gU
xu
xu
xu
xu
xu
xu
"}
(3,1,1) = {"
xu
xu
xu
xu
xu
uZ
jb
CK
OI
OI
OI
OI
OI
OI
OI
OI
OI
tN
OI
OI
OI
OI
OI
OI
ML
jb
yw
uZ
uZ
xu
xu
xu
"}
(4,1,1) = {"
xu
xu
xu
xu
uZ
yw
gU
CK
OI
OI
OI
OI
OI
OI
OI
OI
OI
OI
OI
OI
OI
OI
OI
OI
ML
jb
OF
xu
uZ
yw
uZ
xu
"}
(5,1,1) = {"
xu
xu
uZ
uZ
uZ
uZ
be
CK
OI
OI
OI
OI
OI
OI
OI
OI
OI
OI
OI
OI
OI
OI
OI
OI
ML
gU
uZ
xu
xu
xu
xu
xu
"}
(6,1,1) = {"
xu
xu
xu
xu
uZ
uZ
Yw
CK
OI
OI
OI
OI
OI
OI
OI
OI
OI
OI
OI
OI
OI
OI
OI
OI
ML
Ii
xu
xu
xu
xu
xu
xu
"}
(7,1,1) = {"
xu
xu
xu
uZ
uZ
xu
Yw
WK
OI
OI
OI
OI
OI
OI
OI
OI
OI
OI
OI
OI
OI
OI
OI
OI
tI
gn
xu
xu
xu
xu
xu
xu
"}
(8,1,1) = {"
xu
xu
xu
uZ
xu
xu
gn
Mq
OI
OI
OI
OI
OI
OI
OI
OI
OI
OI
OI
OI
OI
OI
OI
OI
tI
Yw
xu
xu
xu
xu
xu
xu
"}
(9,1,1) = {"
xu
xu
xu
uZ
uZ
Ii
Ii
kW
OI
OI
OI
OI
OI
OI
OI
OI
OI
OI
OI
OI
OI
OI
OI
OI
tI
Ii
xu
xu
xu
xu
xu
xu
"}
(10,1,1) = {"
xu
xu
uZ
uZ
Lm
Fb
VA
Sr
OI
OI
OI
OI
OI
OI
OI
OI
OI
OI
OI
OI
OI
OI
OI
OI
tI
Ii
xu
xu
xu
xu
xu
xu
"}
(11,1,1) = {"
xu
Oi
uZ
uZ
Ef
bq
MN
Sr
OI
OI
OI
OI
OI
OI
OI
OI
OI
OI
OI
OI
OI
OI
OI
OI
tI
Ii
xu
xu
xu
xu
xu
xu
"}
(12,1,1) = {"
xu
xu
xu
Ii
Ka
bq
Ii
tI
OI
OI
OI
OI
OI
OI
OI
OI
OI
OI
OI
OI
OI
OI
OI
OI
tI
Yw
xu
xu
xu
xu
xu
xu
"}
(13,1,1) = {"
Ii
Ii
Yw
Yw
Ii
Ii
Ii
tI
OI
OI
OI
OI
OI
OI
OI
OI
OI
OI
OI
OI
OI
OI
OI
OI
tI
Yw
Yw
Ii
xu
xu
xu
xu
"}
(14,1,1) = {"
aV
CO
CO
CO
CO
tI
tI
tI
OI
OI
OI
OI
OI
OI
OI
OI
OI
OI
OI
OI
OI
OI
OI
OI
tI
tI
tI
Ii
Ii
Ya
Ii
Ii
"}
(15,1,1) = {"
OI
OI
OI
OI
OI
OI
OI
OI
OI
OI
OI
OI
OI
OI
OI
OI
OI
OI
OI
OI
OI
OI
OI
OI
OI
OI
tI
tI
tI
tI
tI
Ii
"}
(16,1,1) = {"
OI
OI
OI
OI
OI
OI
OI
OI
OI
OI
OI
OI
OI
OI
OI
OI
OI
OI
OI
OI
OI
OI
OI
OI
OI
OI
OI
OI
OI
OI
tI
Yw
"}
(17,1,1) = {"
OI
OI
OI
OI
OI
OI
OI
OI
OI
OI
OI
OI
OI
OI
OI
OI
OI
OI
OI
OI
OI
OI
OI
OI
OI
OI
OI
OI
OI
OI
tI
Yw
"}
(18,1,1) = {"
OI
OI
OI
OI
OI
OI
OI
OI
OI
OI
OI
OI
OI
OI
OI
OI
OI
OI
OI
OI
OI
OI
OI
OI
OI
OI
OI
OI
OI
OI
tI
Ii
"}
(19,1,1) = {"
OI
OI
OI
OI
OI
OI
OI
OI
OI
OI
OI
OI
OI
OI
OI
OI
OI
OI
OI
OI
OI
OI
OI
OI
OI
OI
OI
OI
OI
OI
tI
Ii
"}
(20,1,1) = {"
OI
OI
OI
OI
OI
OI
OI
OI
OI
OI
OI
OI
OI
OI
OI
OI
OI
OI
OI
OI
OI
OI
OI
OI
OI
OI
OI
OI
OI
OI
tI
Ii
"}
(21,1,1) = {"
OI
OI
OI
OI
OI
OI
OI
OI
OI
OI
OI
OI
OI
OI
OI
OI
OI
OI
OI
OI
OI
OI
OI
OI
OI
OI
tN
tI
tI
tI
tI
Ii
"}
(22,1,1) = {"
OI
OI
OI
OI
OI
OI
OI
OI
OI
OI
OI
OI
OI
OI
OI
OI
OI
OI
OI
OI
OI
OI
OI
OI
OI
OI
OI
Ya
tI
Ii
Ii
Ii
"}
(23,1,1) = {"
OI
OI
OI
OI
OI
OI
OI
OI
OI
OI
OI
OI
OI
OI
OI
OI
OI
OI
OI
OI
OI
OI
OI
OI
OI
OI
OI
OI
tI
PO
Yw
xu
"}
(24,1,1) = {"
OI
OI
OI
OI
OI
OI
OI
OI
OI
OI
OI
OI
OI
OI
OI
OI
OI
OI
OI
OI
OI
OI
OI
OI
OI
OI
OI
OI
tI
Ya
Ii
Ii
"}
(25,1,1) = {"
OI
OI
OI
OI
OI
OI
OI
OI
OI
OI
OI
OI
OI
OI
OI
OI
OI
OI
OI
OI
OI
OI
OI
OI
OI
OI
OI
OI
tI
Yh
kN
Ii
"}
(26,1,1) = {"
OI
OI
OI
OI
OI
OI
OI
OI
OI
OI
OI
OI
OI
OI
OI
OI
OI
OI
OI
OI
OI
OI
OI
OI
OI
OI
OI
OI
tI
Ya
rw
Ii
"}
(27,1,1) = {"
OI
OI
OI
OI
OI
OI
OI
OI
OI
OI
OI
OI
OI
OI
OI
OI
OI
OI
OI
OI
OI
OI
OI
OI
OI
OI
OI
OI
tI
Ya
ZJ
Ii
"}
(28,1,1) = {"
OI
OI
OI
OI
OI
OI
OI
OI
OI
OI
OI
OI
OI
OI
OI
OI
OI
OI
OI
OI
OI
OI
OI
OI
OI
OI
OI
OI
tL
Ya
RA
gn
"}
(29,1,1) = {"
OI
OI
OI
OI
OI
OI
OI
OI
OI
OI
OI
OI
OI
OI
OI
OI
OI
OI
OI
OI
OI
OI
OI
OI
OI
OI
OI
OI
tI
Ya
fP
gn
"}
(30,1,1) = {"
OI
OI
OI
OI
OI
OI
OI
OI
OI
OI
OI
OI
OI
OI
OI
OI
OI
OI
OI
OI
OI
OI
OI
OI
OI
OI
OI
OI
tI
Ya
Ma
Ii
"}
(31,1,1) = {"
OI
OI
OI
OI
OI
OI
OI
OI
OI
OI
OI
OI
OI
OI
OI
OI
OI
OI
OI
OI
OI
OI
OI
OI
OI
OI
OI
OI
tI
yD
Ya
Ii
"}
(32,1,1) = {"
OI
OI
OI
OI
OI
OI
OI
OI
OI
OI
OI
OI
OI
OI
OI
OI
OI
OI
OI
OI
OI
OI
OI
OI
OI
OI
OI
OI
tI
UT
Ii
Ii
"}
(33,1,1) = {"
OI
OI
OI
OI
OI
OI
OI
OI
OI
OI
OI
OI
OI
OI
OI
OI
OI
OI
OI
OI
OI
OI
OI
OI
OI
OI
OI
OI
tI
mw
Yw
xu
"}
(34,1,1) = {"
OI
OI
OI
OI
OI
OI
OI
OI
OI
OI
OI
OI
OI
OI
OI
OI
OI
OI
OI
OI
OI
OI
OI
OI
OI
OI
OI
Ya
tI
Ii
Ii
Ii
"}
(35,1,1) = {"
OI
OI
OI
OI
OI
OI
OI
OI
OI
OI
OI
OI
OI
OI
OI
OI
OI
OI
OI
OI
OI
OI
OI
OI
OI
OI
tN
cS
cS
cS
is
Ii
"}
(36,1,1) = {"
OI
OI
OI
OI
OI
OI
OI
OI
OI
OI
OI
OI
OI
OI
OI
OI
OI
OI
OI
OI
OI
OI
OI
OI
OI
OI
OI
OI
OI
OI
vZ
Ii
"}
(37,1,1) = {"
OI
OI
OI
OI
OI
OI
OI
OI
OI
OI
OI
OI
OI
OI
OI
OI
OI
OI
OI
OI
OI
OI
OI
OI
OI
OI
OI
OI
OI
OI
vZ
Yw
"}
(38,1,1) = {"
OI
OI
OI
OI
OI
OI
OI
OI
OI
OI
OI
OI
OI
OI
OI
OI
OI
OI
OI
OI
OI
OI
OI
OI
OI
OI
OI
OI
OI
OI
En
Yw
"}
(39,1,1) = {"
xu
xu
OI
OI
OI
OI
OI
OI
OI
OI
OI
OI
OI
OI
OI
OI
OI
OI
OI
OI
OI
OI
OI
OI
OI
OI
OI
OI
OI
OI
Nj
Yw
"}
(40,1,1) = {"
xu
xu
OI
OI
OI
OI
OI
OI
OI
OI
OI
OI
OI
OI
OI
OI
OI
OI
OI
OI
OI
OI
OI
OI
OI
OI
OI
OI
OI
OI
vZ
gn
"}
(41,1,1) = {"
xu
xu
OI
OI
OI
OI
OI
OI
OI
OI
OI
OI
OI
OI
OI
OI
OI
OI
OI
OI
OI
OI
OI
OI
OI
OI
JP
Se
Se
Se
PP
Ii
"}
(42,1,1) = {"
xu
xu
xu
xu
xu
xu
xu
xu
OI
OI
OI
OI
OI
OI
OI
OI
OI
OI
OI
OI
OI
OI
OI
OI
JP
Se
PP
Yw
jb
gU
gU
Ii
"}
(43,1,1) = {"
xu
xu
xu
xu
xu
xu
xu
xu
OI
OI
OI
OI
OI
OI
OI
OI
OI
OI
OI
OI
OI
OI
OI
OI
KD
gU
jb
gU
dp
jb
jb
eM
"}
(44,1,1) = {"
xu
xu
uZ
yw
xu
xu
xu
xu
OI
OI
OI
OI
OI
OI
OI
OI
OI
OI
OI
OI
OI
OI
OI
OI
KD
Ii
oi
yt
jb
jb
jb
eM
"}
(45,1,1) = {"
xu
uZ
fL
yu
yw
xu
xu
xu
OI
OI
OI
OI
OI
OI
OI
OI
OI
OI
OI
OI
OI
OI
OI
OI
vZ
Ii
eM
eM
gn
eM
jb
gn
"}
(46,1,1) = {"
xu
xu
yw
uZ
uZ
xu
xu
xu
OI
OI
OI
OI
OI
OI
OI
OI
OI
OI
OI
OI
OI
OI
OI
OI
Nj
OI
OI
OI
OI
eM
jb
eM
"}
(47,1,1) = {"
xu
xu
uZ
uZ
xu
xu
xu
xu
OI
OI
OI
OI
OI
OI
OI
OI
OI
OI
OI
OI
OI
OI
OI
OI
En
OI
OI
OI
OI
eM
eM
eM
"}
(48,1,1) = {"
OI
xu
xu
uZ
xu
xu
xu
xu
xu
xu
xu
OI
OI
OI
OI
OI
OI
OI
OI
OI
OI
sA
xl
Ya
vZ
OI
OI
OI
OI
xu
xu
xu
"}
(49,1,1) = {"
OI
xu
xu
uZ
uZ
xu
xu
xu
xu
xu
xu
xu
OI
OI
OI
OI
OI
OI
OI
OI
Il
IZ
Lq
cS
tx
OI
OI
OI
OI
xu
xu
xu
"}
(50,1,1) = {"
OI
xu
xu
xu
uZ
xu
xu
xu
xu
xu
xu
xu
xu
xu
xu
xu
xu
xu
xu
xl
yj
OI
OI
OI
OI
OI
OI
OI
OI
OI
OI
OI
"}
(51,1,1) = {"
OI
xu
xu
xu
XU
xu
xu
xu
xu
xu
xu
xu
xu
xu
xu
xu
xu
xu
xu
xl
yj
OI
OI
OI
OI
OI
OI
OI
OI
OI
OI
OI
"}
(52,1,1) = {"
OI
xu
xu
uZ
uZ
xu
xu
xu
xu
xu
xu
xu
xu
xu
xu
xu
xu
xu
xu
mo
yj
OI
OI
OI
OI
OI
OI
OI
OI
OI
OI
OI
"}
(53,1,1) = {"
OI
xu
uZ
uZ
uZ
uZ
xu
xu
xu
xu
xu
xu
xu
xu
xu
xu
xu
xu
xu
xl
yj
OI
OI
OI
OI
OI
OI
OI
OI
OI
OI
OI
"}
(54,1,1) = {"
OI
xu
xu
xu
uZ
uZ
xu
xu
xu
xu
xu
xl
xl
xl
ol
xl
xu
xu
xu
xl
yj
OI
OI
OI
OI
OI
OI
OI
OI
OI
OI
OI
"}
(55,1,1) = {"
OI
xu
xu
uZ
uZ
uZ
yw
uZ
xu
xu
xl
xl
sA
Rt
sA
xl
xl
ol
ol
DS
yj
OI
OI
OI
OI
OI
OI
OI
OI
OI
OI
OI
"}
(56,1,1) = {"
xu
xu
xu
xu
xu
xu
uZ
uZ
uZ
xu
ol
Il
HW
HW
HW
HW
HW
HW
HW
zk
rQ
OI
OI
OI
OI
OI
OI
OI
OI
OI
OI
OI
"}
(57,1,1) = {"
xu
OI
OI
OI
OI
OI
OI
uZ
uZ
uZ
xl
yj
OI
OI
OI
OI
OI
OI
OI
OI
OI
OI
OI
OI
OI
OI
OI
OI
OI
OI
OI
OI
"}
(58,1,1) = {"
xu
OI
OI
OI
OI
OI
rF
ol
GJ
GJ
DS
yj
OI
OI
OI
OI
OI
OI
OI
OI
OI
OI
OI
OI
OI
OI
OI
OI
OI
OI
OI
OI
"}
(59,1,1) = {"
xu
OI
OI
OI
OI
OI
rF
HC
sq
bo
bo
rQ
OI
OI
OI
OI
OI
OI
OI
OI
OI
OI
OI
OI
OI
OI
OI
OI
OI
OI
OI
OI
"}
(60,1,1) = {"
OI
OI
OI
OI
OI
OI
rF
xl
we
OI
OI
OI
OI
OI
OI
OI
OI
OI
OI
OI
OI
OI
OI
OI
OI
OI
OI
OI
OI
OI
OI
OI
"}
(61,1,1) = {"
OI
OI
OI
OI
OI
OI
OI
xl
we
OI
OI
OI
OI
OI
OI
OI
OI
OI
OI
OI
OI
OI
OI
OI
OI
OI
OI
OI
OI
OI
OI
OI
"}
(62,1,1) = {"
OI
OI
OI
OI
OI
OI
OI
xl
LA
OI
OI
OI
OI
OI
OI
OI
OI
OI
OI
OI
OI
OI
OI
OI
OI
OI
OI
OI
OI
OI
OI
OI
"}
(63,1,1) = {"
OI
OI
OI
OI
OI
OI
OI
xl
LA
OI
OI
OI
OI
OI
OI
OI
OI
OI
OI
OI
OI
OI
OI
OI
OI
OI
OI
OI
OI
OI
OI
OI
"}
(64,1,1) = {"
OI
OI
OI
OI
OI
OI
OI
xl
LA
OI
OI
OI
OI
OI
OI
OI
OI
OI
OI
OI
OI
OI
OI
OI
OI
OI
OI
OI
OI
OI
OI
OI
"}
(65,1,1) = {"
OI
OI
OI
OI
OI
OI
xl
xl
LA
OI
OI
OI
OI
OI
OI
OI
OI
OI
OI
OI
OI
OI
OI
OI
OI
OI
OI
OI
OI
OI
OI
OI
"}
(66,1,1) = {"
OI
OI
OI
OI
OI
OI
xl
do
mj
OI
OI
OI
OI
OI
OI
OI
OI
OI
OI
OI
OI
OI
OI
OI
OI
OI
OI
OI
OI
OI
OI
OI
"}
(67,1,1) = {"
xu
OI
OI
OI
OI
OI
xl
Al
xl
OI
OI
OI
OI
OI
OI
OI
OI
OI
OI
OI
OI
OI
OI
OI
OI
OI
OI
OI
OI
OI
OI
OI
"}
