//MAP CONVERTED BY dmm2tgm.py THIS HEADER COMMENT PREVENTS RECONVERSION, DO NOT REMOVE
"a" = (
/turf/template_noop,
/area/template_noop)
"b" = (
/obj/machinery/light/small/blacklight/directional/west,
/turf/open/floor/iron,
/area/virtual_domain)
"c" = (
/obj/structure/table,
/obj/effect/spawner/random/engineering/toolbox,
/turf/open/floor/iron,
/area/virtual_domain)
"i" = (
/obj/effect/spawner/random/vending/colavend,
/turf/open/floor/iron/cafeteria,
/area/virtual_domain)
"j" = (
/obj/effect/turf_decal/stripes/line{
	dir = 4
	},
/obj/effect/decal/cleanable/dirt/dust,
/turf/open/floor/iron,
/area/virtual_domain)
"o" = (
/obj/effect/turf_decal/stripes/line{
	dir = 1
	},
/turf/open/floor/iron/cafeteria,
/area/virtual_domain)
"r" = (
/turf/closed/wall,
/area/virtual_domain)
"z" = (
/obj/effect/spawner/random/trash/graffiti,
/turf/open/floor/iron/cafeteria,
/area/virtual_domain)
"A" = (
/obj/effect/spawner/random/vending/snackvend,
/turf/open/floor/iron/cafeteria,
/area/virtual_domain)
"B" = (
/obj/machinery/light/small/blacklight/directional/north,
/turf/template_noop,
/area/template_noop)
"C" = (
/obj/effect/spawner/random/trash/bin,
/obj/machinery/light/small/blacklight/directional/north,
/turf/open/floor/iron,
/area/virtual_domain)
"F" = (
/obj/effect/baseturf_helper/virtual_domain,
/turf/closed/wall,
/area/virtual_domain)
"G" = (
/obj/structure/sign/poster/random/directional/north,
/obj/effect/decal/cleanable/dirt/dust,
/turf/open/floor/iron,
/area/virtual_domain)
"I" = (
/obj/structure/table,
/turf/open/floor/iron,
/area/virtual_domain)
"M" = (
/obj/machinery/light/small/blacklight/directional/south,
/turf/template_noop,
/area/template_noop)
"N" = (
/obj/effect/spawner/structure/window,
/turf/open/floor/plating,
/area/virtual_domain)
"O" = (
/obj/effect/spawner/random/trash/mess,
/turf/open/floor/iron/cafeteria,
/area/virtual_domain)
"P" = (
/obj/effect/spawner/random/structure/chair_maintenance{
	dir = 1
	},
/turf/open/floor/iron,
/area/virtual_domain)
"Q" = (
/obj/effect/spawner/random/structure/crate,
/obj/machinery/light/small/blacklight/directional/north,
/turf/open/floor/iron,
/area/virtual_domain)
"R" = (
/turf/open/floor/iron,
/area/virtual_domain)
"S" = (
/obj/effect/decal/cleanable/dirt/dust,
/turf/open/floor/iron,
/area/virtual_domain)
"T" = (
/obj/structure/sign/poster/random/directional/east,
/obj/machinery/light/small/blacklight/directional/east,
/turf/open/floor/iron/cafeteria,
/area/virtual_domain)
"U" = (
/obj/effect/spawner/random/trash/caution_sign,
/turf/open/floor/iron/cafeteria,
/area/virtual_domain)
"V" = (
/obj/effect/turf_decal/stripes/corner{
	dir = 4
	},
/obj/effect/decal/cleanable/dirt/dust,
/obj/effect/turf_decal/stripes/corner{
	dir = 4
	},
/turf/open/floor/iron,
/area/virtual_domain)
"W" = (
/obj/effect/spawner/random/structure/crate,
/turf/open/floor/iron,
/area/virtual_domain)
"Y" = (
/obj/machinery/door/airlock,
/turf/open/floor/plating,
/area/virtual_domain)

(1,1,1) = {"
a
a
a
a
a
a
a
a
a
"}
(2,1,1) = {"
a
r
r
r
N
r
r
F
a
"}
(3,1,1) = {"
a
r
C
I
c
b
P
r
a
"}
(4,1,1) = {"
M
r
G
R
S
S
P
r
a
"}
(5,1,1) = {"
a
Y
j
V
S
S
S
Y
a
"}
(6,1,1) = {"
a
r
W
o
A
i
O
r
B
"}
(7,1,1) = {"
a
r
Q
o
z
T
U
r
a
"}
(8,1,1) = {"
a
r
r
r
N
r
r
r
a
"}
(9,1,1) = {"
a
a
a
a
a
a
a
a
a
"}
