//MAP CONVERTED BY dmm2tgm.py THIS HEADER COMMENT PREVENTS RECONVERSION, DO NOT REMOVE
"a" = (
/turf/template_noop,
/area/template_noop)
"d" = (
/obj/effect/turf_decal/stripes/line,
/turf/open/floor/iron,
/area/virtual_domain)
"e" = (
/obj/machinery/computer{
	dir = 8;
	name = "shuttle console";
	icon_screen = "shuttle"
	},
/turf/open/floor/iron/white/textured_large,
/area/virtual_domain)
"f" = (
/turf/open/floor/plating/rust,
/area/virtual_domain)
"h" = (
/obj/effect/turf_decal/siding/dark{
	dir = 8
	},
/obj/effect/turf_decal/tile/brown{
	dir = 8
	},
/obj/effect/turf_decal/tile/brown/half{
	dir = 1
	},
/obj/effect/decal/cleanable/dirt,
/obj/item/stack/ore/gold,
/turf/open/floor/iron/white/textured_edge{
	dir = 1
	},
/area/virtual_domain)
"i" = (
/obj/effect/decal/cleanable/glass/titanium,
/obj/effect/decal/cleanable/dirt,
/obj/item/stack/ore/titanium,
/turf/open/floor/iron/white/textured_large,
/area/virtual_domain)
"k" = (
/obj/modular_map_connector,
/turf/template_noop,
/area/template_noop)
"l" = (
/obj/effect/mapping_helpers/burnt_floor,
/obj/structure/broken_flooring/side/directional/north,
/turf/open/floor/plating/rust,
/area/virtual_domain)
"m" = (
/obj/structure/grille/broken,
/turf/open/floor/plating,
/area/virtual_domain)
"n" = (
/obj/effect/mapping_helpers/burnt_floor,
/turf/open/floor/iron,
/area/virtual_domain)
"o" = (
/obj/effect/decal/cleanable/dirt/dust,
/obj/item/crowbar/red,
/turf/open/floor/iron/white/textured_large,
/area/virtual_domain)
"q" = (
/obj/structure/broken_flooring/corner/directional/east,
/turf/open/floor/plating,
/area/virtual_domain)
"s" = (
/obj/effect/turf_decal/trimline/brown,
/obj/effect/turf_decal/trimline/brown/mid_joiner,
/obj/effect/turf_decal/trimline/brown/mid_joiner{
	dir = 1
	},
/turf/open/floor/iron/white/textured_large,
/area/virtual_domain)
"t" = (
/obj/effect/mapping_helpers/broken_floor,
/turf/open/floor/iron,
/area/virtual_domain)
"u" = (
/turf/closed/wall/mineral/titanium,
/area/virtual_domain)
"v" = (
/obj/machinery/power/shuttle_engine/heater{
	dir = 8
	},
/obj/effect/turf_decal/stripes/line{
	dir = 4
	},
/turf/open/floor/plating,
/area/virtual_domain)
"x" = (
/turf/open/floor/iron,
/area/virtual_domain)
"z" = (
/obj/structure/table/reinforced,
/obj/item/climbing_hook/emergency,
/obj/item/pickaxe/emergency,
/turf/open/floor/iron/white/textured_large,
/area/virtual_domain)
"A" = (
/obj/machinery/door/airlock/shuttle/glass,
/turf/open/floor/iron/white/textured_large,
/area/virtual_domain)
"C" = (
/obj/structure/grille,
/obj/item/shard/titanium,
/turf/open/floor/plating,
/area/virtual_domain)
"G" = (
/obj/machinery/power/shuttle_engine/propulsion/burst{
	dir = 8
	},
/obj/structure/window/reinforced/spawner/directional/east,
/turf/open/floor/plating,
/area/virtual_domain)
"H" = (
/obj/structure/chair/comfy/shuttle{
	dir = 4
	},
/turf/open/floor/iron/white/textured_large,
/area/virtual_domain)
"I" = (
/obj/effect/turf_decal/tile/brown{
	dir = 1
	},
/obj/effect/mob_spawn/corpse/human/miner,
/obj/effect/decal/cleanable/blood/old,
/turf/open/floor/iron/white/textured_corner{
	dir = 1
	},
/area/virtual_domain)
"K" = (
/obj/effect/spawner/structure/window/reinforced/shuttle,
/turf/open/floor/plating,
/area/virtual_domain)
"M" = (
/obj/effect/turf_decal/tile/brown/half{
	dir = 1
	},
/turf/open/floor/iron/white/textured_half,
/area/virtual_domain)
"N" = (
/obj/effect/turf_decal/stripes/line{
	dir = 4
	},
/obj/structure/ore_box,
/turf/open/floor/plating,
/area/virtual_domain)
"O" = (
/turf/open/floor/plating,
/area/virtual_domain)
"P" = (
/turf/closed/wall/mineral/titanium/nodiagonal,
/area/virtual_domain)
"T" = (
/obj/machinery/computer{
	dir = 1;
	name = "shuttle console";
	icon_screen = "shuttle"
	},
/obj/structure/broken_flooring/corner/directional/south,
/turf/open/floor/plating,
/area/virtual_domain)
"V" = (
/obj/effect/turf_decal/siding/dark{
	dir = 8
	},
/obj/effect/turf_decal/tile/brown{
	dir = 1
	},
/obj/effect/decal/cleanable/plasma,
/turf/open/floor/iron/white/textured_corner{
	dir = 1
	},
/area/virtual_domain)
"W" = (
/obj/effect/turf_decal/siding/dark{
	dir = 8
	},
/obj/effect/turf_decal/tile/brown/half{
	dir = 8
	},
/obj/effect/decal/cleanable/dirt,
/obj/effect/decal/cleanable/generic,
/obj/item/stack/ore/plasma,
/turf/open/floor/iron/white/textured_half{
	dir = 1
	},
/area/virtual_domain)
"X" = (
/obj/structure/table/reinforced,
/obj/item/flashlight/glowstick,
/obj/item/flashlight/glowstick{
	pixel_y = 3;
	pixel_x = 3
	},
/turf/open/floor/iron/white/textured_large,
/area/virtual_domain)
"Y" = (
/obj/effect/turf_decal/stripes/corner{
	dir = 8
	},
/obj/effect/mapping_helpers/broken_floor,
/turf/open/floor/iron,
/area/virtual_domain)

(1,1,1) = {"
a
a
a
a
a
a
a
a
k
"}
(2,1,1) = {"
a
O
u
G
K
G
u
x
a
"}
(3,1,1) = {"
a
f
P
v
N
v
P
q
a
"}
(4,1,1) = {"
a
T
P
h
W
V
K
f
a
"}
(5,1,1) = {"
a
d
A
M
s
o
C
f
a
"}
(6,1,1) = {"
a
Y
P
I
H
i
m
t
a
"}
(7,1,1) = {"
a
l
P
z
e
X
P
n
a
"}
(8,1,1) = {"
a
n
u
K
K
K
u
f
a
"}
(9,1,1) = {"
a
a
a
a
a
a
a
a
a
"}
