//MAP CONVERTED BY dmm2tgm.py THIS HEADER COMMENT PREVENTS RECONVERSION, DO NOT REMOVE
"a" = (
/obj/machinery/atmospherics/pipe/smart/manifold4w/scrubbers/hidden/layer2,
/obj/machinery/atmospherics/pipe/smart/manifold4w/supply/hidden/layer4,
/obj/structure/cable,
/obj/effect/decal/cleanable/blood/tracks{
	dir = 6
	},
/turf/open/floor/iron/dark/corner{
	dir = 8
	},
/area/template_noop)
"b" = (
/obj/structure/chair/sofa/bench/tram/left{
	dir = 1
	},
/obj/effect/decal/cleanable/dirt/dust,
/obj/machinery/light_switch/directional/south,
/turf/open/floor/iron,
/area/template_noop)
"c" = (
/obj/machinery/atmospherics/pipe/smart/manifold4w/scrubbers/hidden/layer2,
/obj/machinery/atmospherics/pipe/smart/manifold4w/supply/hidden/layer4,
/obj/structure/cable,
/turf/open/floor/plating,
/area/template_noop)
"d" = (
/obj/effect/spawner/random/vending/colavend,
/obj/effect/decal/cleanable/dirt/dust,
/turf/open/floor/iron,
/area/template_noop)
"i" = (
/obj/machinery/atmospherics/pipe/smart/manifold4w/scrubbers/hidden/layer2,
/obj/machinery/atmospherics/pipe/smart/manifold4w/supply/hidden/layer4,
/obj/structure/cable,
/obj/effect/decal/cleanable/blood/gibs/down,
/turf/open/floor/plating,
/area/template_noop)
"j" = (
/obj/effect/decal/cleanable/glass,
/obj/effect/spawner/random/trash/box,
/turf/open/floor/iron/dark/side,
/area/template_noop)
"k" = (
/obj/effect/decal/cleanable/glass,
/obj/item/shard,
/obj/effect/turf_decal/stripes/line{
	dir = 1
	},
/obj/effect/decal/cleanable/blood/tracks,
/turf/open/floor/iron,
/area/template_noop)
"l" = (
/obj/effect/decal/cleanable/dirt,
/obj/effect/spawner/random/trash/moisture,
/turf/open/floor/iron/dark/side{
	dir = 1
	},
/area/template_noop)
"m" = (
/obj/machinery/atmospherics/pipe/smart/manifold4w/scrubbers/hidden/layer2,
/obj/machinery/atmospherics/pipe/smart/manifold4w/supply/hidden/layer4,
/obj/structure/cable,
/turf/open/floor/iron/dark/side{
	dir = 1
	},
/area/template_noop)
"n" = (
/obj/machinery/light/small/directional/west,
/turf/template_noop,
/area/template_noop)
"o" = (
/obj/structure/window/spawner/directional/north,
/obj/effect/turf_decal/stripes/line{
	dir = 1
	},
/obj/structure/broken_flooring/pile/directional/west,
/turf/open/floor/iron,
/area/template_noop)
"q" = (
/obj/structure/window/spawner/directional/north,
/obj/effect/turf_decal/stripes/line{
	dir = 1
	},
/obj/effect/decal/cleanable/dirt,
/turf/open/floor/iron,
/area/template_noop)
"u" = (
/obj/effect/decal/cleanable/dirt,
/obj/effect/spawner/random/trash/crushed_can{
	pixel_x = -6;
	pixel_y = 5
	},
/turf/open/floor/iron/dark/corner,
/area/template_noop)
"v" = (
/obj/modular_map_connector,
/turf/template_noop,
/area/template_noop)
"w" = (
/obj/structure/chair/sofa/bench/tram/right{
	dir = 1
	},
/obj/structure/sign/poster/random/directional/south,
/obj/effect/decal/cleanable/dirt,
/turf/open/floor/iron,
/area/template_noop)
"y" = (
/obj/effect/spawner/random/decoration/showcase,
/obj/structure/sign/poster/random/directional/north,
/obj/effect/turf_decal/box,
/turf/open/floor/iron/dark,
/area/template_noop)
"z" = (
/turf/template_noop,
/area/template_noop)
"A" = (
/obj/machinery/door/airlock/command{
	name = "Corporate Showroom"
	},
/turf/open/floor/iron,
/area/template_noop)
"B" = (
/obj/structure/sign/poster/random/directional/west,
/obj/structure/broken_flooring/corner/directional/west,
/obj/effect/spawner/random/trash/cigbutt,
/obj/structure/railing,
/turf/open/floor/plating,
/area/template_noop)
"C" = (
/obj/machinery/atmospherics/pipe/smart/manifold4w/scrubbers/hidden/layer2,
/obj/machinery/atmospherics/pipe/smart/manifold4w/supply/hidden/layer4,
/obj/structure/cable,
/obj/effect/decal/cleanable/blood/tracks{
	dir = 4
	},
/turf/open/floor/plating,
/area/template_noop)
"D" = (
/obj/machinery/atmospherics/pipe/smart/manifold4w/scrubbers/hidden/layer2,
/obj/machinery/atmospherics/pipe/smart/manifold4w/supply/hidden/layer4,
/obj/structure/cable,
/obj/structure/broken_flooring/pile/directional/east,
/turf/open/floor/plating,
/area/template_noop)
"E" = (
/obj/item/shard,
/obj/effect/decal/cleanable/glass,
/obj/structure/table_frame,
/obj/effect/spawner/random/entertainment/cigarette_pack,
/turf/open/floor/iron,
/area/template_noop)
"H" = (
/obj/structure/sign/poster/random/directional/north,
/obj/effect/spawner/random/structure/crate,
/obj/effect/turf_decal/box,
/turf/open/floor/iron/dark,
/area/template_noop)
"K" = (
/turf/closed/wall,
/area/template_noop)
"L" = (
/obj/effect/decal/cleanable/plastic,
/obj/structure/rack,
/obj/effect/turf_decal/box,
/obj/effect/spawner/random/exotic/antag_gear,
/obj/machinery/light/directional/north,
/obj/structure/sign/flag/terragov/directional/north,
/turf/open/floor/iron/dark,
/area/template_noop)
"N" = (
/obj/structure/chair/stool/directional/west{
	pixel_x = 5
	},
/obj/structure/sign/warning/yes_smoking/circle/directional/east,
/turf/open/floor/iron/dark/corner{
	dir = 1
	},
/area/template_noop)
"O" = (
/obj/effect/decal/cleanable/blood/tracks{
	dir = 1
	},
/obj/effect/spawner/random/trash/garbage,
/obj/structure/sign/calendar/directional/east,
/obj/effect/decal/cleanable/dirt/dust,
/obj/structure/railing,
/turf/open/floor/iron,
/area/template_noop)
"R" = (
/obj/effect/spawner/random/trash/bin,
/obj/effect/decal/cleanable/dirt,
/turf/open/floor/iron,
/area/template_noop)
"T" = (
/obj/machinery/atmospherics/pipe/smart/manifold4w/scrubbers/hidden/layer2,
/obj/machinery/atmospherics/pipe/smart/manifold4w/supply/hidden/layer4,
/obj/structure/cable,
/obj/machinery/door/airlock/command{
	name = "Corporate Showroom"
	},
/turf/open/floor/iron,
/area/template_noop)
"V" = (
/obj/structure/window/spawner/directional/west,
/obj/effect/turf_decal/stripes/line{
	dir = 8
	},
/obj/item/kirbyplants/random/dead,
/obj/effect/decal/remains/human,
/turf/open/floor/iron,
/area/template_noop)
"Y" = (
/obj/structure/window/spawner/directional/east,
/obj/effect/turf_decal/stripes/line{
	dir = 4
	},
/obj/effect/spawner/random/structure/closet_maintenance,
/obj/effect/decal/cleanable/dirt,
/obj/effect/decal/cleanable/cobweb,
/turf/open/floor/iron,
/area/template_noop)

(1,1,1) = {"
z
z
z
z
z
z
z
z
v
"}
(2,1,1) = {"
z
K
K
K
K
T
K
K
z
"}
(3,1,1) = {"
z
K
Y
B
u
c
R
K
z
"}
(4,1,1) = {"
z
K
H
q
j
m
b
K
z
"}
(5,1,1) = {"
z
K
L
k
i
D
w
K
z
"}
(6,1,1) = {"
z
K
y
o
C
l
E
K
z
"}
(7,1,1) = {"
z
K
V
O
a
N
d
K
z
"}
(8,1,1) = {"
z
K
K
K
A
K
K
K
z
"}
(9,1,1) = {"
z
z
z
n
z
z
z
z
z
"}
