//MAP CONVERTED BY dmm2tgm.py THIS HEADER COMMENT PREVENTS RECONVERSION, DO NOT REMOVE
"a" = (
/turf/template_noop,
/area/template_noop)
"b" = (
/obj/structure/table/reinforced,
/obj/effect/turf_decal/tile/neutral{
	dir = 8
	},
/obj/effect/turf_decal/tile/neutral,
/obj/effect/turf_decal/tile/neutral{
	dir = 1
	},
/obj/effect/turf_decal/tile/neutral{
	dir = 4
	},
/obj/effect/turf_decal/siding/white{
	dir = 1
	},
/obj/machinery/light/cold/no_nightlight/directional/west,
/obj/machinery/door/poddoor/shutters/preopen{
	id = "kitchen";
	name = "Kitchen Shutters";
	dir = 1
	},
/turf/open/floor/iron/dark/textured,
/area/virtual_domain)
"c" = (
/obj/effect/turf_decal/tile/neutral{
	dir = 8
	},
/obj/effect/turf_decal/tile/neutral{
	dir = 1
	},
/obj/effect/turf_decal/tile/neutral,
/obj/effect/turf_decal/tile/neutral{
	dir = 4
	},
/obj/machinery/grill,
/turf/open/floor/iron/dark/textured,
/area/virtual_domain)
"d" = (
/obj/structure/table/reinforced,
/obj/effect/turf_decal/tile/neutral{
	dir = 8
	},
/obj/effect/turf_decal/tile/neutral,
/obj/effect/turf_decal/tile/neutral{
	dir = 1
	},
/obj/effect/turf_decal/tile/neutral{
	dir = 4
	},
/obj/effect/turf_decal/siding/white{
	dir = 1
	},
/obj/machinery/door/poddoor/shutters/preopen{
	id = "kitchen";
	name = "Kitchen Shutters";
	dir = 1
	},
/obj/effect/spawner/random/entertainment/musical_instrument,
/turf/open/floor/iron/dark/textured,
/area/virtual_domain)
"e" = (
/obj/effect/turf_decal/tile/neutral{
	dir = 8
	},
/obj/effect/turf_decal/tile/neutral{
	dir = 1
	},
/obj/effect/turf_decal/tile/neutral,
/obj/effect/turf_decal/tile/neutral{
	dir = 4
	},
/obj/effect/turf_decal/siding/white{
	dir = 5
	},
/obj/machinery/griddle,
/turf/open/floor/iron/dark/textured,
/area/virtual_domain)
"f" = (
/turf/open/floor/iron/kitchen,
/area/virtual_domain)
"g" = (
/obj/structure/table/reinforced,
/obj/effect/turf_decal/tile/neutral{
	dir = 8
	},
/obj/effect/turf_decal/tile/neutral,
/obj/effect/turf_decal/tile/neutral{
	dir = 1
	},
/obj/effect/turf_decal/tile/neutral{
	dir = 4
	},
/obj/effect/turf_decal/siding/white{
	dir = 1
	},
/obj/machinery/door/poddoor/shutters/preopen{
	id = "kitchen";
	name = "Kitchen Shutters"
	},
/obj/effect/spawner/random/food_or_drink/donkpockets,
/turf/open/floor/iron/dark/textured,
/area/virtual_domain)
"h" = (
/obj/machinery/smartfridge/food,
/turf/open/floor/iron/dark/textured_half{
	dir = 1
	},
/area/virtual_domain)
"i" = (
/obj/structure/table/reinforced,
/obj/effect/turf_decal/tile/neutral{
	dir = 8
	},
/obj/effect/turf_decal/tile/neutral,
/obj/effect/turf_decal/tile/neutral{
	dir = 1
	},
/obj/effect/turf_decal/tile/neutral{
	dir = 4
	},
/obj/effect/turf_decal/siding/white{
	dir = 1
	},
/obj/machinery/door/poddoor/shutters/preopen{
	id = "kitchen";
	name = "Kitchen Shutters";
	dir = 1
	},
/turf/open/floor/iron/dark/textured,
/area/virtual_domain)
"k" = (
/obj/effect/turf_decal/tile/neutral{
	dir = 8
	},
/obj/effect/turf_decal/tile/neutral{
	dir = 1
	},
/obj/effect/turf_decal/tile/neutral,
/obj/effect/turf_decal/tile/neutral{
	dir = 4
	},
/obj/effect/turf_decal/siding/white{
	dir = 4
	},
/obj/machinery/grill,
/turf/open/floor/iron/dark/textured,
/area/virtual_domain)
"l" = (
/obj/structure/table/reinforced,
/obj/effect/turf_decal/tile/neutral/half{
	dir = 8
	},
/obj/effect/turf_decal/tile/neutral/half{
	dir = 4
	},
/obj/effect/turf_decal/siding/white{
	dir = 4
	},
/obj/effect/turf_decal/siding/white{
	dir = 8
	},
/obj/machinery/door/poddoor/shutters/preopen{
	dir = 8;
	id = "kitchen";
	name = "Kitchen Shutters"
	},
/turf/open/floor/iron/dark/textured_half{
	dir = 1
	},
/area/virtual_domain)
"n" = (
/obj/effect/turf_decal/tile/neutral/fourcorners,
/obj/effect/turf_decal/siding/white{
	dir = 10
	},
/obj/structure/closet/secure_closet/freezer/fridge{
	locked = 0
	},
/obj/item/storage/box/ingredients/wildcard,
/obj/item/storage/box/ingredients/wildcard,
/obj/item/storage/box/ingredients/wildcard,
/obj/item/storage/box/ingredients/wildcard,
/turf/open/floor/iron/dark/textured,
/area/virtual_domain)
"o" = (
/obj/machinery/door/airlock/public/glass{
	name = "Kitchen"
	},
/turf/open/floor/iron/kitchen,
/area/virtual_domain)
"p" = (
/obj/effect/turf_decal/tile/neutral{
	dir = 8
	},
/obj/effect/turf_decal/tile/neutral{
	dir = 1
	},
/obj/effect/turf_decal/tile/neutral,
/obj/effect/turf_decal/tile/neutral{
	dir = 4
	},
/obj/effect/turf_decal/siding/white{
	dir = 1
	},
/obj/machinery/griddle,
/obj/item/food/raw_patty{
	pixel_y = 4
	},
/turf/open/floor/iron/dark/textured,
/area/virtual_domain)
"q" = (
/obj/structure/table/reinforced,
/obj/effect/turf_decal/tile/neutral{
	dir = 8
	},
/obj/effect/turf_decal/tile/neutral,
/obj/effect/turf_decal/tile/neutral{
	dir = 1
	},
/obj/effect/turf_decal/tile/neutral{
	dir = 4
	},
/obj/effect/turf_decal/siding/white{
	dir = 1
	},
/obj/machinery/light/cold/no_nightlight/directional/east,
/obj/machinery/door/poddoor/shutters/preopen{
	id = "kitchen";
	name = "Kitchen Shutters"
	},
/obj/effect/spawner/random/food_or_drink/donuts{
	pixel_x = -6
	},
/turf/open/floor/iron/dark/textured,
/area/virtual_domain)
"r" = (
/obj/machinery/deepfryer,
/obj/effect/turf_decal/tile/neutral{
	dir = 8
	},
/obj/effect/turf_decal/tile/neutral{
	dir = 4
	},
/obj/effect/turf_decal/tile/neutral,
/obj/effect/turf_decal/tile/neutral{
	dir = 1
	},
/obj/effect/turf_decal/siding/white,
/turf/open/floor/iron/dark/textured,
/area/virtual_domain)
"s" = (
/obj/structure/table/reinforced,
/obj/effect/turf_decal/tile/neutral{
	dir = 8
	},
/obj/effect/turf_decal/tile/neutral{
	dir = 4
	},
/obj/effect/turf_decal/tile/neutral,
/obj/effect/turf_decal/tile/neutral{
	dir = 1
	},
/obj/effect/turf_decal/siding/white{
	dir = 10
	},
/obj/item/reagent_containers/condiment/enzyme{
	pixel_x = -2;
	pixel_y = 6
	},
/obj/item/reagent_containers/cup/beaker/large{
	pixel_x = 5
	},
/obj/item/kitchen/rollingpin,
/turf/open/floor/iron/dark/textured,
/area/virtual_domain)
"t" = (
/obj/structure/table/reinforced,
/obj/effect/turf_decal/tile/neutral/half{
	dir = 8
	},
/obj/effect/turf_decal/tile/neutral/half{
	dir = 4
	},
/obj/machinery/door/poddoor/shutters/preopen{
	dir = 8;
	id = "kitchen";
	name = "Kitchen Shutters"
	},
/obj/effect/turf_decal/siding/white{
	dir = 4
	},
/obj/effect/turf_decal/siding/white{
	dir = 8
	},
/obj/effect/spawner/random/entertainment/deck,
/obj/effect/spawner/random/entertainment/gambling,
/turf/open/floor/iron/dark/textured_half{
	dir = 1
	},
/area/virtual_domain)
"u" = (
/obj/effect/spawner/structure/window,
/turf/open/floor/plating,
/area/virtual_domain)
"v" = (
/obj/structure/table/reinforced,
/obj/effect/turf_decal/tile/neutral{
	dir = 8
	},
/obj/effect/turf_decal/tile/neutral,
/obj/effect/turf_decal/tile/neutral{
	dir = 1
	},
/obj/effect/turf_decal/tile/neutral{
	dir = 4
	},
/obj/effect/turf_decal/siding/white{
	dir = 1
	},
/obj/machinery/door/poddoor/shutters/preopen{
	id = "kitchen";
	name = "Kitchen Shutters"
	},
/obj/effect/spawner/random/food_or_drink/donuts{
	pixel_x = 11
	},
/turf/open/floor/iron/dark/textured,
/area/virtual_domain)
"w" = (
/obj/structure/table/reinforced,
/obj/effect/turf_decal/tile/neutral/half{
	dir = 8
	},
/obj/effect/turf_decal/tile/neutral/half{
	dir = 4
	},
/obj/effect/turf_decal/siding/white{
	dir = 4
	},
/obj/effect/turf_decal/siding/white{
	dir = 8
	},
/obj/machinery/door/poddoor/shutters/preopen{
	dir = 8;
	id = "kitchen";
	name = "Kitchen Shutters"
	},
/obj/item/radio{
	desc = "An old handheld radio. Tuned to the outpost's hit radio station.";
	frequency = 1475;
	icon_state = "radio";
	name = "old radio"
	},
/turf/open/floor/iron/dark/textured_half{
	dir = 1
	},
/area/virtual_domain)
"x" = (
/turf/closed/wall,
/area/virtual_domain)
"y" = (
/obj/effect/turf_decal/tile/neutral{
	dir = 8
	},
/obj/effect/turf_decal/tile/neutral{
	dir = 4
	},
/obj/effect/turf_decal/tile/neutral,
/obj/effect/turf_decal/tile/neutral{
	dir = 1
	},
/obj/effect/turf_decal/siding/white,
/obj/structure/table/reinforced,
/obj/machinery/microwave{
	pixel_y = 5
	},
/turf/open/floor/iron/dark/textured,
/area/virtual_domain)
"z" = (
/obj/effect/turf_decal/tile/neutral/fourcorners,
/obj/effect/turf_decal/siding/white{
	dir = 8
	},
/obj/structure/closet/secure_closet/freezer/fridge{
	locked = 0
	},
/obj/item/storage/box/ingredients/wildcard,
/obj/item/storage/box/ingredients/wildcard,
/obj/item/storage/box/ingredients/wildcard,
/turf/open/floor/iron/dark/textured,
/area/virtual_domain)
"A" = (
/obj/machinery/chem_dispenser/drinks/fullupgrade{
	dir = 8;
	pixel_x = 16
	},
/turf/open/floor/iron/kitchen,
/area/virtual_domain)
"B" = (
/obj/effect/turf_decal/tile/neutral{
	dir = 8
	},
/obj/effect/turf_decal/tile/neutral{
	dir = 4
	},
/obj/effect/turf_decal/tile/neutral{
	dir = 1
	},
/obj/effect/turf_decal/tile/neutral,
/obj/effect/turf_decal/siding/white{
	dir = 8
	},
/obj/machinery/vending/wardrobe/chef_wardrobe,
/obj/machinery/light/cold/no_nightlight/directional/east,
/turf/open/floor/iron/dark/textured,
/area/virtual_domain)
"C" = (
/obj/effect/turf_decal/tile/neutral{
	dir = 8
	},
/obj/effect/turf_decal/tile/neutral{
	dir = 4
	},
/obj/effect/turf_decal/tile/neutral,
/obj/effect/turf_decal/tile/neutral{
	dir = 1
	},
/obj/effect/turf_decal/siding/white{
	dir = 8
	},
/turf/open/floor/iron/dark/textured,
/area/virtual_domain)
"D" = (
/obj/modular_map_connector,
/turf/template_noop,
/area/template_noop)
"E" = (
/obj/machinery/deepfryer,
/obj/effect/turf_decal/tile/neutral{
	dir = 8
	},
/obj/effect/turf_decal/tile/neutral{
	dir = 4
	},
/obj/effect/turf_decal/tile/neutral,
/obj/effect/turf_decal/tile/neutral{
	dir = 1
	},
/obj/effect/turf_decal/siding/white{
	dir = 6
	},
/turf/open/floor/iron/dark/textured,
/area/virtual_domain)
"F" = (
/obj/structure/table/reinforced,
/obj/effect/turf_decal/tile/neutral{
	dir = 8
	},
/obj/effect/turf_decal/tile/neutral{
	dir = 1
	},
/obj/effect/turf_decal/tile/neutral,
/obj/effect/turf_decal/tile/neutral{
	dir = 4
	},
/obj/effect/turf_decal/siding/white{
	dir = 8
	},
/obj/item/clothing/suit/apron/chef,
/obj/item/clothing/head/utility/chefhat,
/obj/item/clothing/mask/fakemoustache/italian,
/turf/open/floor/iron/dark/textured,
/area/virtual_domain)
"G" = (
/obj/effect/turf_decal/tile/neutral{
	dir = 8
	},
/obj/effect/turf_decal/tile/neutral{
	dir = 4
	},
/obj/effect/turf_decal/tile/neutral,
/obj/effect/turf_decal/tile/neutral{
	dir = 1
	},
/turf/open/floor/iron/dark/textured,
/area/virtual_domain)
"I" = (
/obj/effect/turf_decal/tile/neutral{
	dir = 8
	},
/obj/effect/turf_decal/tile/neutral,
/obj/effect/turf_decal/tile/neutral{
	dir = 1
	},
/obj/effect/turf_decal/tile/neutral{
	dir = 4
	},
/obj/effect/turf_decal/siding/white{
	dir = 9
	},
/obj/machinery/vending/dinnerware,
/turf/open/floor/iron/dark/textured,
/area/virtual_domain)
"J" = (
/obj/effect/turf_decal/tile/neutral{
	dir = 8
	},
/obj/effect/turf_decal/tile/neutral{
	dir = 4
	},
/obj/effect/turf_decal/tile/neutral,
/obj/effect/turf_decal/tile/neutral{
	dir = 1
	},
/obj/effect/turf_decal/siding/white{
	dir = 4
	},
/turf/open/floor/iron/dark/textured,
/area/virtual_domain)
"K" = (
/obj/structure/table/reinforced,
/obj/effect/turf_decal/tile/neutral{
	dir = 8
	},
/obj/effect/turf_decal/tile/neutral,
/obj/effect/turf_decal/tile/neutral{
	dir = 1
	},
/obj/effect/turf_decal/tile/neutral{
	dir = 4
	},
/obj/effect/turf_decal/siding/white{
	dir = 1
	},
/obj/machinery/light/cold/no_nightlight/directional/west,
/obj/machinery/door/poddoor/shutters/preopen{
	id = "kitchen";
	name = "Kitchen Shutters"
	},
/turf/open/floor/iron/dark/textured,
/area/virtual_domain)
"L" = (
/obj/machinery/button/door/directional/west{
	id = "kitchen";
	name = "Counter Shutters Control"
	},
/obj/structure/sink/kitchen/directional/east{
	pixel_y = 3
	},
/turf/open/floor/iron/kitchen,
/area/virtual_domain)
"M" = (
/obj/structure/table/reinforced,
/obj/effect/turf_decal/tile/neutral/half{
	dir = 8
	},
/obj/effect/turf_decal/tile/neutral/half{
	dir = 4
	},
/obj/machinery/door/poddoor/shutters/preopen{
	dir = 8;
	id = "kitchen";
	name = "Kitchen Shutters"
	},
/obj/effect/turf_decal/siding/white{
	dir = 4
	},
/obj/effect/turf_decal/siding/white{
	dir = 8
	},
/obj/effect/spawner/random/entertainment/dice,
/obj/effect/spawner/random/entertainment/coin,
/turf/open/floor/iron/dark/textured_half{
	dir = 1
	},
/area/virtual_domain)
"N" = (
/obj/effect/turf_decal/tile/neutral{
	dir = 8
	},
/obj/effect/turf_decal/tile/neutral{
	dir = 4
	},
/obj/effect/turf_decal/tile/neutral,
/obj/effect/turf_decal/tile/neutral{
	dir = 1
	},
/obj/effect/turf_decal/siding/white{
	dir = 1
	},
/obj/structure/table/reinforced,
/obj/machinery/processor{
	pixel_y = 7
	},
/turf/open/floor/iron/dark/textured,
/area/virtual_domain)
"O" = (
/obj/structure/table/reinforced,
/obj/effect/turf_decal/tile/neutral{
	dir = 8
	},
/obj/effect/turf_decal/tile/neutral,
/obj/effect/turf_decal/tile/neutral{
	dir = 1
	},
/obj/effect/turf_decal/tile/neutral{
	dir = 4
	},
/obj/effect/turf_decal/siding/white{
	dir = 1
	},
/obj/machinery/door/poddoor/shutters/preopen{
	id = "kitchen";
	name = "Kitchen Shutters"
	},
/obj/item/storage/bag/tray{
	pixel_y = 6
	},
/turf/open/floor/iron/dark/textured,
/area/virtual_domain)
"P" = (
/obj/effect/turf_decal/tile/neutral{
	dir = 8
	},
/obj/effect/turf_decal/tile/neutral{
	dir = 1
	},
/obj/effect/turf_decal/tile/neutral,
/obj/effect/turf_decal/tile/neutral{
	dir = 4
	},
/obj/effect/turf_decal/siding/white{
	dir = 9
	},
/obj/structure/table/reinforced,
/obj/machinery/reagentgrinder{
	pixel_x = -10;
	pixel_y = 4
	},
/obj/item/book/manual/chef_recipes{
	pixel_x = 5
	},
/turf/open/floor/iron/dark/textured,
/area/virtual_domain)
"Q" = (
/obj/structure/table/reinforced,
/obj/effect/turf_decal/tile/neutral{
	dir = 8
	},
/obj/effect/turf_decal/tile/neutral,
/obj/effect/turf_decal/tile/neutral{
	dir = 1
	},
/obj/effect/turf_decal/tile/neutral{
	dir = 4
	},
/obj/effect/turf_decal/siding/white{
	dir = 1
	},
/obj/machinery/door/poddoor/shutters/preopen{
	id = "kitchen";
	name = "Kitchen Shutters";
	dir = 1
	},
/obj/effect/spawner/random/entertainment/plushie,
/turf/open/floor/iron/dark/textured,
/area/virtual_domain)
"S" = (
/obj/structure/table/reinforced,
/obj/effect/turf_decal/tile/neutral{
	dir = 8
	},
/obj/effect/turf_decal/tile/neutral,
/obj/effect/turf_decal/tile/neutral{
	dir = 1
	},
/obj/effect/turf_decal/tile/neutral{
	dir = 4
	},
/obj/effect/turf_decal/siding/white{
	dir = 1
	},
/obj/machinery/light/cold/no_nightlight/directional/east,
/obj/machinery/door/poddoor/shutters/preopen{
	id = "kitchen";
	name = "Kitchen Shutters";
	dir = 1
	},
/turf/open/floor/iron/dark/textured,
/area/virtual_domain)
"T" = (
/obj/structure/table/reinforced,
/obj/effect/turf_decal/tile/neutral{
	dir = 8
	},
/obj/effect/turf_decal/tile/neutral,
/obj/effect/turf_decal/tile/neutral{
	dir = 1
	},
/obj/effect/turf_decal/tile/neutral{
	dir = 4
	},
/obj/effect/turf_decal/siding/white{
	dir = 1
	},
/obj/machinery/door/poddoor/shutters/preopen{
	id = "kitchen";
	name = "Kitchen Shutters";
	dir = 1
	},
/obj/effect/spawner/random/entertainment/lighter,
/obj/effect/spawner/random/entertainment/cigarette_pack,
/turf/open/floor/iron/dark/textured,
/area/virtual_domain)
"W" = (
/obj/structure/table/reinforced,
/obj/effect/turf_decal/tile/neutral{
	dir = 8
	},
/obj/effect/turf_decal/tile/neutral,
/obj/effect/turf_decal/tile/neutral{
	dir = 1
	},
/obj/effect/turf_decal/tile/neutral{
	dir = 4
	},
/obj/effect/turf_decal/siding/white{
	dir = 1
	},
/obj/machinery/door/poddoor/shutters/preopen{
	id = "kitchen";
	name = "Kitchen Shutters"
	},
/obj/effect/spawner/random/food_or_drink/refreshing_beverage{
	pixel_x = -7;
	pixel_y = 4
	},
/obj/effect/spawner/random/food_or_drink/salad{
	pixel_x = 7
	},
/turf/open/floor/iron/dark/textured,
/area/virtual_domain)
"Y" = (
/obj/effect/turf_decal/tile/neutral{
	dir = 8
	},
/obj/effect/turf_decal/tile/neutral{
	dir = 4
	},
/obj/effect/turf_decal/tile/neutral,
/obj/effect/turf_decal/tile/neutral{
	dir = 1
	},
/obj/structure/table/reinforced,
/obj/item/storage/box/ingredients/wildcard{
	pixel_y = 5
	},
/obj/item/stack/sheet/mineral/coal/ten,
/turf/open/floor/iron/dark/textured,
/area/virtual_domain)

(1,1,1) = {"
a
a
a
a
a
a
a
a
a
a
D
"}
(2,1,1) = {"
a
x
o
h
t
M
w
l
x
x
a
"}
(3,1,1) = {"
a
b
f
f
f
f
f
f
L
K
a
"}
(4,1,1) = {"
a
T
f
P
C
F
C
s
f
O
a
"}
(5,1,1) = {"
a
d
f
N
G
Y
G
y
f
g
a
"}
(6,1,1) = {"
a
i
f
p
G
c
G
r
f
W
a
"}
(7,1,1) = {"
a
Q
f
e
J
k
J
E
f
v
a
"}
(8,1,1) = {"
a
S
f
f
f
f
f
f
f
q
a
"}
(9,1,1) = {"
a
x
z
n
A
f
f
I
B
x
a
"}
(10,1,1) = {"
a
x
x
x
x
u
o
u
x
x
a
"}
(11,1,1) = {"
a
a
a
a
a
a
a
a
a
a
a
"}
