//MAP CONVERTED BY dmm2tgm.py THIS HEADER COMMENT PREVENTS RECONVERSION, DO NOT REMOVE
"a" = (
/obj/machinery/light/directional/east,
/turf/open/floor/wood,
/area/deathmatch)
"b" = (
/obj/structure/chair/office{
	dir = 4
	},
/obj/effect/landmark/deathmatch_player_spawn,
/turf/open/floor/wood/large,
/area/deathmatch)
"c" = (
/obj/effect/turf_decal/siding/wood{
	dir = 1
	},
/obj/effect/spawner/structure/window,
/turf/open/floor/wood/large,
/area/deathmatch)
"d" = (
/obj/item/ammo_box/magazine/m9mm/ap,
/turf/open/floor/wood,
/area/deathmatch)
"e" = (
/obj/effect/decal/cleanable/blood/old,
/turf/open/floor/wood,
/area/deathmatch)
"f" = (
/obj/machinery/light/directional/west,
/obj/structure/barricade/sandbags,
/turf/open/floor/wood,
/area/deathmatch)
"g" = (
/turf/closed/indestructible/iron,
/area/deathmatch)
"h" = (
/obj/structure/barricade/wooden,
/obj/effect/turf_decal/siding/wood{
	dir = 4
	},
/turf/open/floor/wood/tile,
/area/deathmatch)
"i" = (
/obj/structure/extinguisher_cabinet/directional/east,
/turf/open/floor/wood,
/area/deathmatch)
"j" = (
/obj/effect/decal/cleanable/blood/old,
/obj/effect/turf_decal/siding/wood{
	dir = 4
	},
/turf/open/floor/wood/tile,
/area/deathmatch)
"k" = (
/obj/structure/table/reinforced,
/obj/item/ammo_box/magazine/m9mm/fire,
/turf/open/floor/wood/large,
/area/deathmatch)
"l" = (
/obj/structure/table/reinforced,
/obj/item/ammo_box/magazine/m9mm,
/obj/item/ammo_box/magazine/m9mm,
/obj/item/ammo_box/magazine/m9mm,
/obj/item/ammo_box/magazine/m9mm,
/obj/item/ammo_box/magazine/m9mm,
/obj/item/ammo_box/magazine/m9mm,
/obj/item/ammo_box/magazine/m9mm,
/obj/item/ammo_box/magazine/m9mm,
/obj/item/ammo_box/magazine/m9mm,
/obj/item/ammo_box/magazine/m9mm,
/obj/item/ammo_box/magazine/m9mm,
/turf/open/floor/wood/large,
/area/deathmatch)
"m" = (
/obj/effect/turf_decal/siding/wood{
	dir = 1
	},
/turf/open/floor/wood/tile,
/area/deathmatch)
"n" = (
/obj/structure/extinguisher_cabinet/directional/west,
/turf/open/floor/wood,
/area/deathmatch)
"o" = (
/obj/item/ammo_box/magazine/m9mm/ap,
/obj/structure/closet/crate/secure/weapon{
	locked = 0
	},
/obj/effect/turf_decal/siding/wood/corner{
	dir = 4
	},
/turf/open/floor/wood/tile,
/area/deathmatch)
"p" = (
/obj/effect/turf_decal/siding/wood/corner{
	dir = 1
	},
/turf/open/floor/wood/tile,
/area/deathmatch)
"q" = (
/obj/effect/turf_decal/siding/wood{
	dir = 4
	},
/turf/open/floor/wood/tile,
/area/deathmatch)
"r" = (
/obj/item/flashlight/flare,
/turf/open/floor/wood,
/area/deathmatch)
"s" = (
/obj/machinery/light/directional/south,
/turf/open/floor/wood,
/area/deathmatch)
"t" = (
/obj/effect/decal/cleanable/blood/old,
/obj/effect/turf_decal/siding/wood{
	dir = 1
	},
/turf/open/floor/wood/tile,
/area/deathmatch)
"u" = (
/obj/structure/barricade/sandbags,
/obj/structure/extinguisher_cabinet/directional/west,
/turf/open/floor/wood,
/area/deathmatch)
"v" = (
/obj/item/reagent_containers/hypospray/medipen,
/turf/open/floor/wood,
/area/deathmatch)
"x" = (
/obj/item/ammo_box/magazine/m9mm/fire,
/turf/open/floor/wood,
/area/deathmatch)
"y" = (
/obj/item/ammo_box/magazine/m9mm/fire,
/obj/structure/closet/crate/secure/weapon{
	locked = 0
	},
/obj/effect/turf_decal/siding/wood/corner{
	dir = 8
	},
/turf/open/floor/wood/tile,
/area/deathmatch)
"z" = (
/turf/open/floor/wood,
/area/deathmatch)
"A" = (
/obj/effect/landmark/deathmatch_player_spawn,
/obj/effect/turf_decal/siding/wood{
	dir = 8
	},
/turf/open/floor/wood/tile,
/area/deathmatch)
"B" = (
/obj/machinery/light/directional/west,
/turf/open/floor/wood,
/area/deathmatch)
"C" = (
/obj/structure/table/reinforced,
/obj/item/flashlight/lamp,
/turf/open/floor/wood/large,
/area/deathmatch)
"D" = (
/obj/effect/turf_decal/siding/wood{
	dir = 8
	},
/turf/open/floor/wood/tile,
/area/deathmatch)
"E" = (
/obj/effect/turf_decal/siding/wood/corner,
/turf/open/floor/wood/tile,
/area/deathmatch)
"F" = (
/obj/structure/barricade/wooden,
/obj/effect/turf_decal/siding/wood,
/turf/open/floor/wood/tile,
/area/deathmatch)
"I" = (
/obj/effect/turf_decal/siding/wood,
/turf/open/floor/wood/tile,
/area/deathmatch)
"K" = (
/turf/closed/wall,
/area/deathmatch)
"M" = (
/obj/structure/barricade/sandbags,
/turf/open/floor/wood,
/area/deathmatch)
"O" = (
/obj/structure/barricade/wooden,
/turf/open/floor/wood,
/area/deathmatch)
"Q" = (
/obj/item/ammo_box/magazine/m9mm/hp,
/obj/structure/closet/crate/secure/weapon{
	locked = 0
	},
/obj/effect/turf_decal/siding/wood{
	dir = 4
	},
/turf/open/floor/wood/tile,
/area/deathmatch)
"T" = (
/obj/effect/landmark/deathmatch_player_spawn,
/turf/open/floor/wood,
/area/deathmatch)
"U" = (
/turf/open/floor/wood/large,
/area/deathmatch)
"W" = (
/obj/machinery/light/directional/north,
/turf/open/floor/wood,
/area/deathmatch)
"X" = (
/obj/effect/turf_decal/siding/wood,
/turf/open/floor/wood/large,
/area/deathmatch)
"Y" = (
/obj/structure/extinguisher_cabinet/directional/north,
/turf/open/floor/wood,
/area/deathmatch)

(1,1,1) = {"
g
g
g
g
g
g
g
g
g
g
g
g
g
g
g
g
g
g
g
g
g
g
"}
(2,1,1) = {"
g
E
j
q
q
h
q
q
q
q
q
q
Q
q
q
q
j
q
q
q
o
g
"}
(3,1,1) = {"
g
I
z
z
T
K
z
z
M
z
z
z
z
z
z
i
z
z
z
z
m
g
"}
(4,1,1) = {"
g
I
z
z
z
K
M
M
M
z
z
z
z
z
O
K
z
z
K
O
m
g
"}
(5,1,1) = {"
g
I
z
a
z
K
z
z
z
z
z
z
e
z
O
z
z
z
z
K
m
g
"}
(6,1,1) = {"
g
F
O
K
z
n
z
z
z
a
z
e
z
z
K
W
e
z
z
z
t
g
"}
(7,1,1) = {"
g
I
z
f
e
z
r
K
K
K
O
O
K
z
K
z
z
T
z
z
m
g
"}
(8,1,1) = {"
g
I
z
M
M
M
z
c
U
U
U
U
X
z
O
z
z
z
z
K
m
g
"}
(9,1,1) = {"
g
I
e
z
v
z
z
K
U
l
b
U
X
z
O
K
K
K
K
O
m
g
"}
(10,1,1) = {"
g
I
z
z
z
z
z
K
U
C
k
U
K
z
z
z
z
M
z
z
m
g
"}
(11,1,1) = {"
g
I
z
z
z
z
z
c
U
U
U
U
O
e
v
z
z
M
x
z
m
g
"}
(12,1,1) = {"
g
I
z
M
M
z
z
K
O
O
K
K
K
z
z
z
z
M
M
z
t
g
"}
(13,1,1) = {"
g
I
z
e
M
z
z
B
z
z
z
u
d
z
z
r
z
z
z
z
m
g
"}
(14,1,1) = {"
g
I
z
z
M
z
z
z
z
M
z
M
z
z
s
K
K
O
O
K
m
g
"}
(15,1,1) = {"
g
I
K
O
O
K
O
z
z
M
z
z
z
z
z
K
T
z
z
K
m
g
"}
(16,1,1) = {"
g
I
z
z
z
z
O
z
K
K
z
K
O
z
z
O
z
z
s
K
m
g
"}
(17,1,1) = {"
g
I
e
z
T
s
K
z
K
z
z
z
O
z
z
O
e
z
z
K
m
g
"}
(18,1,1) = {"
g
I
z
z
z
z
K
Y
K
W
z
z
O
z
z
K
z
z
z
z
m
g
"}
(19,1,1) = {"
g
I
z
z
z
z
K
e
K
z
e
z
K
z
z
K
K
K
K
K
m
g
"}
(20,1,1) = {"
g
I
z
K
K
z
K
z
K
K
z
z
K
e
z
z
z
z
z
z
m
g
"}
(21,1,1) = {"
g
y
D
D
D
D
D
D
D
A
D
D
D
D
D
D
D
D
D
D
p
g
"}
(22,1,1) = {"
g
g
g
g
g
g
g
g
g
g
g
g
g
g
g
g
g
g
g
g
g
g
"}
