//MAP CONVERTED BY dmm2tgm.py THIS HEADER COMMENT PREVENTS RECONVERSION, DO NOT REMOVE
"a" = (
/turf/template_noop,
/area/template_noop)
"b" = (
/obj/effect/decal/cleanable/dirt,
/obj/structure/closet/crate,
/obj/effect/spawner/random/engineering/material_cheap,
/obj/effect/spawner/random/engineering/material_cheap,
/obj/effect/spawner/random/engineering/flashlight,
/obj/effect/spawner/random/engineering/tool,
/obj/effect/decal/cleanable/cobweb/cobweb2,
/turf/open/floor/iron/smooth,
/area/station/maintenance/department/eva)
"d" = (
/obj/effect/decal/cleanable/dirt,
/obj/structure/girder,
/obj/structure/window/spawner/east,
/obj/structure/grille,
/turf/open/floor/iron/smooth,
/area/station/maintenance/department/eva)
"e" = (
/obj/effect/decal/cleanable/dirt,
/turf/open/floor/iron/smooth,
/area/station/maintenance/department/eva)
"f" = (
/obj/modular_map_connector,
/turf/closed/wall,
/area/station/maintenance/department/eva)
"g" = (
/obj/effect/decal/cleanable/dirt,
/obj/effect/spawner/random/engineering/atmospherics_portable,
/turf/open/floor/iron/smooth,
/area/station/maintenance/department/eva)
"k" = (
/obj/effect/turf_decal/sand,
/obj/structure/closet,
/obj/effect/spawner/random/maintenance/two,
/obj/item/clothing/suit/armor/vest/old,
/obj/item/clothing/head/helmet/old,
/turf/open/floor/iron/smooth,
/area/station/maintenance/department/eva)
"r" = (
/obj/effect/decal/cleanable/dirt,
/obj/structure/closet/crate,
/obj/effect/spawner/random/maintenance/two,
/obj/effect/spawner/random/mod/maint,
/obj/item/clothing/suit/armor/vest/old,
/obj/item/clothing/head/helmet/old,
/turf/open/floor/iron/smooth,
/area/station/maintenance/department/eva)
"t" = (
/turf/closed/wall,
/area/station/maintenance/department/eva)
"u" = (
/obj/item/stack/ore/glass,
/turf/open/misc/asteroid/dug,
/area/station/asteroid)
"E" = (
/turf/open/misc/asteroid,
/area/station/asteroid)
"G" = (
/turf/open/misc/asteroid/dug,
/area/station/asteroid)
"H" = (
/obj/effect/decal/cleanable/dirt,
/obj/structure/closet/emcloset,
/turf/open/floor/iron/smooth,
/area/station/maintenance/department/eva)
"I" = (
/turf/template_noop,
/area/station/maintenance/department/eva)
"J" = (
/obj/effect/decal/cleanable/dirt,
/obj/structure/girder,
/turf/open/floor/iron/smooth,
/area/station/maintenance/department/eva)
"K" = (
/obj/effect/decal/cleanable/dirt,
/obj/machinery/door/airlock/maintenance_hatch{
	name = "Security Maintenance Hatch"
	},
/obj/effect/mapping_helpers/airlock/access/any/security/maintenance,
/turf/open/floor/iron/smooth,
/area/station/maintenance/department/eva)
"L" = (
/obj/effect/turf_decal/sand/plating,
/obj/structure/falsewall,
/turf/open/floor/plating,
/area/station/maintenance/department/eva)
"N" = (
/obj/effect/decal/cleanable/dirt,
/obj/structure/cable,
/turf/open/floor/catwalk_floor,
/area/station/maintenance/department/eva)
"T" = (
/turf/closed/mineral/random/stationside/asteroid/porus,
/area/station/asteroid)
"U" = (
/obj/effect/decal/cleanable/dirt,
/obj/structure/cable,
/obj/machinery/power/apc/auto_name/directional/west,
/turf/open/floor/catwalk_floor,
/area/station/maintenance/department/eva)
"W" = (
/obj/effect/decal/cleanable/dirt,
/obj/structure/cable,
/obj/effect/landmark/event_spawn,
/turf/open/floor/catwalk_floor,
/area/station/maintenance/department/eva)
"Y" = (
/obj/effect/decal/cleanable/dirt,
/obj/structure/table,
/obj/structure/reagent_dispensers/wall/peppertank/directional/north,
/obj/item/reagent_containers/spray/pepper/empty{
	pixel_x = 5;
	pixel_y = 8
	},
/obj/item/restraints/handcuffs/cable/zipties,
/turf/open/floor/iron/smooth,
/area/station/maintenance/department/eva)
"Z" = (
/obj/effect/decal/cleanable/dirt,
/obj/effect/decal/cleanable/cobweb,
/turf/open/floor/iron/smooth,
/area/station/maintenance/department/eva)

(1,1,1) = {"
a
a
a
a
a
a
T
T
T
T
T
a
a
"}
(2,1,1) = {"
a
a
a
a
a
a
T
T
T
T
T
a
a
"}
(3,1,1) = {"
a
a
a
a
a
a
T
T
T
T
T
a
a
"}
(4,1,1) = {"
a
a
a
a
T
T
T
T
T
T
T
a
a
"}
(5,1,1) = {"
a
a
T
T
T
T
T
T
T
T
t
g
N
"}
(6,1,1) = {"
a
a
T
T
T
T
T
T
T
T
t
H
N
"}
(7,1,1) = {"
a
T
T
T
E
G
T
T
T
T
t
J
N
"}
(8,1,1) = {"
T
T
T
E
G
u
G
T
T
T
t
b
W
"}
(9,1,1) = {"
T
T
E
E
E
E
t
t
t
t
f
t
N
"}
(10,1,1) = {"
T
T
E
t
t
t
t
U
N
N
N
N
N
"}
(11,1,1) = {"
t
t
L
t
Z
e
e
e
a
a
a
a
a
"}
(12,1,1) = {"
t
r
k
t
e
a
a
a
a
a
a
a
a
"}
(13,1,1) = {"
t
d
d
t
e
a
a
a
a
a
a
a
a
"}
(14,1,1) = {"
t
e
e
K
e
a
a
a
a
a
a
a
a
"}
(15,1,1) = {"
t
Y
e
t
e
a
a
a
a
a
a
a
a
"}
(16,1,1) = {"
I
I
I
I
e
a
a
a
a
a
a
a
a
"}
