//MAP CONVERTED BY dmm2tgm.py THIS HEADER COMMENT PREVENTS RECONVERSION, DO NOT REMOVE
"a" = (
/turf/template_noop,
/area/template_noop)
"b" = (
/obj/effect/decal/cleanable/dirt,
/obj/structure/table,
/turf/open/floor/iron/smooth,
/area/station/maintenance/department/eva)
"c" = (
/obj/effect/decal/cleanable/dirt,
/obj/structure/girder,
/turf/open/floor/iron/smooth,
/area/station/maintenance/department/eva)
"d" = (
/obj/effect/decal/cleanable/dirt,
/obj/effect/spawner/random/trash/food_packaging,
/obj/structure/cable,
/turf/open/floor/catwalk_floor,
/area/station/maintenance/department/eva)
"e" = (
/obj/effect/decal/cleanable/dirt,
/obj/effect/landmark/event_spawn,
/turf/open/floor/iron/smooth,
/area/station/maintenance/department/eva)
"g" = (
/obj/effect/decal/cleanable/dirt,
/obj/structure/closet/crate,
/obj/effect/spawner/random/maintenance/four,
/obj/effect/spawner/random/engineering/material_cheap,
/turf/open/floor/iron/smooth,
/area/station/maintenance/department/eva)
"j" = (
/obj/effect/decal/cleanable/dirt,
/turf/open/floor/iron/smooth,
/area/station/maintenance/department/eva)
"m" = (
/obj/effect/decal/cleanable/dirt,
/obj/effect/spawner/random/engineering/atmospherics_portable,
/obj/effect/decal/cleanable/cobweb,
/turf/open/floor/iron/smooth,
/area/station/maintenance/department/eva)
"o" = (
/obj/effect/decal/cleanable/dirt,
/obj/structure/closet,
/obj/effect/spawner/random/engineering/flashlight,
/obj/effect/spawner/random/engineering/tool,
/obj/effect/spawner/random/maintenance/three,
/turf/open/floor/iron/smooth,
/area/station/maintenance/department/eva)
"s" = (
/turf/closed/wall,
/area/station/maintenance/department/eva)
"v" = (
/obj/modular_map_connector,
/obj/effect/decal/cleanable/dirt,
/obj/structure/girder,
/turf/open/floor/iron/smooth,
/area/station/maintenance/department/eva)
"w" = (
/turf/closed/mineral/random/stationside/asteroid/porus,
/area/station/asteroid)
"y" = (
/obj/effect/decal/cleanable/dirt,
/obj/structure/closet/firecloset,
/turf/open/floor/iron/smooth,
/area/station/maintenance/department/eva)
"z" = (
/obj/effect/decal/cleanable/dirt,
/obj/structure/girder,
/obj/structure/grille,
/turf/open/floor/iron/smooth,
/area/station/maintenance/department/eva)
"C" = (
/obj/effect/decal/cleanable/dirt,
/obj/structure/chair{
	dir = 8
	},
/turf/open/floor/iron/smooth,
/area/station/maintenance/department/eva)
"D" = (
/obj/effect/decal/cleanable/dirt,
/obj/structure/closet/crate,
/obj/effect/spawner/random/maintenance/six,
/obj/effect/decal/cleanable/cobweb,
/turf/open/floor/iron/smooth,
/area/station/maintenance/department/eva)
"G" = (
/obj/effect/decal/cleanable/dirt,
/obj/structure/reagent_dispensers/fueltank,
/turf/open/floor/iron/smooth,
/area/station/maintenance/department/eva)
"H" = (
/obj/effect/decal/cleanable/dirt,
/obj/machinery/door/airlock/maintenance_hatch{
	name = "Maintenance Hatch"
	},
/obj/effect/mapping_helpers/airlock/access/all/engineering/maintenance,
/turf/open/floor/iron/smooth,
/area/station/maintenance/department/eva)
"L" = (
/obj/effect/decal/cleanable/dirt,
/obj/structure/reagent_dispensers/watertank,
/turf/open/floor/iron/smooth,
/area/station/maintenance/department/eva)
"M" = (
/obj/effect/decal/cleanable/dirt,
/obj/structure/cable,
/turf/open/floor/catwalk_floor,
/area/station/maintenance/department/eva)
"Q" = (
/obj/effect/decal/cleanable/dirt,
/obj/effect/landmark/blobstart,
/turf/open/floor/iron/smooth,
/area/station/maintenance/department/eva)
"R" = (
/obj/effect/decal/cleanable/dirt,
/obj/structure/cable,
/obj/machinery/power/apc/auto_name/directional/north,
/turf/open/floor/catwalk_floor,
/area/station/maintenance/department/eva)
"V" = (
/obj/effect/decal/cleanable/dirt,
/obj/structure/extinguisher_cabinet/directional/north,
/obj/structure/cable,
/turf/open/floor/catwalk_floor,
/area/station/maintenance/department/eva)

(1,1,1) = {"
a
a
a
a
a
a
w
w
w
w
w
a
a
"}
(2,1,1) = {"
a
a
a
a
a
a
w
w
w
w
w
a
a
"}
(3,1,1) = {"
a
a
a
a
a
a
w
w
w
w
w
a
a
"}
(4,1,1) = {"
a
a
a
a
w
w
w
w
w
w
w
a
a
"}
(5,1,1) = {"
a
a
w
w
w
w
w
w
w
w
w
s
M
"}
(6,1,1) = {"
a
a
s
s
s
s
s
w
w
w
w
s
M
"}
(7,1,1) = {"
a
w
s
D
j
b
s
s
s
s
s
s
V
"}
(8,1,1) = {"
w
w
s
z
Q
C
s
m
L
G
c
y
M
"}
(9,1,1) = {"
w
w
s
g
j
j
s
R
e
j
v
o
M
"}
(10,1,1) = {"
w
w
s
s
s
H
s
M
M
d
M
M
M
"}
(11,1,1) = {"
a
w
w
s
j
j
j
j
a
a
a
a
a
"}
(12,1,1) = {"
a
w
w
s
j
a
a
a
a
a
a
a
a
"}
(13,1,1) = {"
a
w
w
s
j
a
a
a
a
a
a
a
a
"}
(14,1,1) = {"
a
w
w
s
j
a
a
a
a
a
a
a
a
"}
(15,1,1) = {"
a
w
w
s
j
a
a
a
a
a
a
a
a
"}
(16,1,1) = {"
a
a
a
a
j
a
a
a
a
a
a
a
a
"}
