//MAP CONVERTED BY dmm2tgm.py THIS HEADER COMMENT PREVENTS RECONVERSION, DO NOT REMOVE
"a" = (
/obj/effect/decal/cleanable/dirt,
/turf/open/floor/plating,
/area/station/maintenance/starboard/lesser)
"b" = (
/obj/effect/decal/cleanable/dirt,
/obj/machinery/light/small/directional/west,
/turf/open/floor/iron/smooth,
/area/station/maintenance/starboard/lesser)
"c" = (
/obj/effect/decal/cleanable/dirt,
/obj/effect/decal/cleanable/oil,
/obj/item/stock_parts/cell/empty,
/obj/item/screwdriver{
	pixel_y = -10;
	pixel_x = 7
	},
/turf/open/floor/plating,
/area/station/maintenance/starboard/lesser)
"f" = (
/obj/effect/decal/cleanable/dirt,
/obj/structure/girder,
/turf/open/floor/iron/smooth,
/area/station/maintenance/starboard/lesser)
"g" = (
/obj/modular_map_connector,
/obj/effect/turf_decal/stripes/white/corner,
/obj/effect/decal/cleanable/dirt,
/turf/open/floor/iron/smooth,
/area/station/maintenance/starboard/lesser)
"h" = (
/turf/template_noop,
/area/station/maintenance/starboard/lesser)
"k" = (
/obj/effect/decal/cleanable/dirt,
/obj/item/mecha_parts/chassis/ripley,
/obj/item/mecha_parts/part/ripley_left_arm{
	pixel_y = -2;
	pixel_x = -9
	},
/obj/item/mecha_parts/part/ripley_right_leg{
	pixel_x = 7;
	pixel_y = -5
	},
/turf/open/floor/plating,
/area/station/maintenance/starboard/lesser)
"l" = (
/obj/effect/decal/cleanable/dirt,
/obj/structure/chair/stool/directional/north,
/turf/open/floor/iron/smooth,
/area/station/maintenance/starboard/lesser)
"p" = (
/obj/structure/shipping_container/nthi,
/obj/effect/decal/cleanable/dirt,
/turf/open/floor/plating,
/area/station/maintenance/starboard/lesser)
"q" = (
/obj/effect/decal/cleanable/dirt,
/obj/machinery/door/airlock/maintenance_hatch{
	name = "Maintenance Hatch"
	},
/obj/effect/mapping_helpers/airlock/access/all/engineering/maintenance,
/turf/open/floor/iron/smooth,
/area/station/maintenance/starboard/lesser)
"w" = (
/obj/effect/decal/cleanable/dirt,
/turf/open/floor/iron/smooth,
/area/station/maintenance/starboard/lesser)
"z" = (
/obj/effect/decal/cleanable/dirt,
/obj/effect/decal/cleanable/cobweb/cobweb2,
/obj/effect/spawner/random/engineering/atmospherics_portable,
/turf/open/floor/iron/smooth,
/area/station/maintenance/starboard/lesser)
"A" = (
/obj/effect/decal/cleanable/dirt,
/obj/effect/spawner/random/structure/crate_empty,
/turf/open/floor/iron/smooth,
/area/station/maintenance/starboard/lesser)
"B" = (
/obj/effect/decal/cleanable/dirt,
/obj/vehicle/sealed/mecha/working/ripley,
/obj/effect/decal/cleanable/oil,
/turf/open/floor/plating,
/area/station/maintenance/starboard/lesser)
"C" = (
/obj/effect/decal/cleanable/dirt,
/obj/item/wrench,
/turf/open/floor/plating,
/area/station/maintenance/starboard/lesser)
"D" = (
/obj/effect/decal/cleanable/dirt,
/obj/effect/spawner/random/engineering/atmospherics_portable,
/turf/open/floor/iron/smooth,
/area/station/maintenance/starboard/lesser)
"F" = (
/obj/effect/decal/cleanable/dirt,
/turf/open/floor/catwalk_floor,
/area/station/maintenance/starboard/lesser)
"H" = (
/obj/effect/turf_decal/stripes/white/line{
	dir = 4
	},
/obj/effect/decal/cleanable/dirt,
/turf/open/floor/iron/smooth,
/area/station/maintenance/starboard/lesser)
"K" = (
/turf/closed/wall,
/area/station/maintenance/starboard/lesser)
"L" = (
/obj/effect/turf_decal/stripes/white/line{
	dir = 4
	},
/obj/effect/decal/cleanable/dirt,
/obj/effect/spawner/random/structure/crate_empty,
/turf/open/floor/iron/smooth,
/area/station/maintenance/starboard/lesser)
"M" = (
/obj/effect/decal/cleanable/dirt,
/obj/structure/table,
/obj/item/clothing/gloves/cargo_gauntlet,
/obj/item/clothing/gloves/cargo_gauntlet,
/turf/open/floor/iron/smooth,
/area/station/maintenance/starboard/lesser)
"N" = (
/obj/structure/shipping_container,
/obj/effect/decal/cleanable/dirt,
/turf/open/floor/plating,
/area/station/maintenance/starboard/lesser)
"P" = (
/obj/structure/shipping_container/nanotrasen,
/obj/effect/decal/cleanable/dirt,
/turf/open/floor/plating,
/area/station/maintenance/starboard/lesser)
"S" = (
/obj/effect/turf_decal/stripes/white/corner,
/obj/effect/turf_decal/stripes/white/corner{
	dir = 4
	},
/obj/effect/decal/cleanable/dirt,
/turf/open/floor/iron/smooth,
/area/station/maintenance/starboard/lesser)
"U" = (
/obj/effect/decal/cleanable/dirt,
/obj/structure/rack,
/obj/effect/spawner/random/engineering/material,
/obj/effect/spawner/random/engineering/toolbox,
/turf/open/floor/iron/smooth,
/area/station/maintenance/starboard/lesser)
"V" = (
/obj/effect/decal/cleanable/dirt,
/obj/structure/rack,
/obj/effect/decal/cleanable/cobweb,
/obj/effect/spawner/random/engineering/material_cheap,
/obj/effect/spawner/random/engineering/flashlight,
/turf/open/floor/iron/smooth,
/area/station/maintenance/starboard/lesser)
"W" = (
/turf/template_noop,
/area/template_noop)
"Y" = (
/obj/effect/decal/cleanable/dirt,
/obj/structure/table,
/obj/structure/noticeboard/directional/west,
/obj/item/paper{
	default_raw_text = "Mark this room off as long-term storage, isn't worth trying to retrieve the containers before closing off the halls.";
	name = "Equipment Notice"
	},
/obj/item/paper{
	default_raw_text = "Please make sure all heavy equipment and tools are stored properly between sessions to prevent on-site accidents! All current workers comp filings will have a minimal delay of 3 months to be reviewed from date of entry. If you are unable to work during those months, we will NOT be paying compensation until legally required. This isn't a threat.";
	name = "Storage Units"
	},
/turf/open/floor/iron/smooth,
/area/station/maintenance/starboard/lesser)

(1,1,1) = {"
W
W
W
W
W
W
W
W
W
W
W
W
W
W
W
W
"}
(2,1,1) = {"
K
K
K
K
K
K
K
K
K
K
K
K
K
K
K
K
"}
(3,1,1) = {"
w
w
w
b
w
w
w
w
Y
M
l
w
b
w
A
K
"}
(4,1,1) = {"
g
H
H
S
H
H
S
H
H
S
H
H
S
H
L
K
"}
(5,1,1) = {"
F
a
P
F
a
p
F
a
N
F
a
P
F
a
a
K
"}
(6,1,1) = {"
F
a
a
F
a
a
F
a
a
F
a
a
F
C
c
K
"}
(7,1,1) = {"
F
a
a
F
a
a
F
a
a
F
a
a
F
k
B
K
"}
(8,1,1) = {"
K
K
K
q
K
K
q
K
K
K
K
K
K
K
K
K
"}
(9,1,1) = {"
K
V
w
w
K
w
w
w
K
W
W
W
W
W
W
W
"}
(10,1,1) = {"
K
U
w
w
K
z
f
D
h
W
W
W
W
W
W
W
"}
(11,1,1) = {"
K
K
K
K
K
K
K
K
h
W
W
W
W
W
W
W
"}
