//MAP CONVERTED BY dmm2tgm.py THIS HEADER COMMENT PREVENTS RECONVERSION, DO NOT REMOVE
"bA" = (
/obj/effect/decal/cleanable/dirt,
/obj/structure/disposalpipe/segment{
	dir = 10
	},
/obj/machinery/atmospherics/pipe/smart/manifold4w/scrubbers/hidden/layer2,
/obj/machinery/atmospherics/pipe/smart/manifold4w/supply/hidden/layer4,
/obj/structure/cable,
/turf/open/floor/catwalk_floor,
/area/station/maintenance/starboard/central)
"cD" = (
/obj/machinery/light/small/broken/directional/north,
/obj/effect/decal/cleanable/dirt,
/turf/open/floor/iron,
/area/station/maintenance/starboard/central)
"cG" = (
/obj/structure/frame/machine,
/obj/item/stack/cable_coil{
	amount = 3
	},
/obj/effect/decal/cleanable/dirt,
/turf/open/floor/iron,
/area/station/maintenance/starboard/central)
"dL" = (
/obj/effect/mapping_helpers/airlock/access/all/engineering/maintenance,
/obj/effect/decal/cleanable/dirt,
/obj/structure/disposalpipe/segment,
/obj/machinery/atmospherics/pipe/smart/manifold4w/scrubbers/hidden/layer2,
/obj/machinery/atmospherics/pipe/smart/manifold4w/supply/hidden/layer4,
/obj/structure/cable,
/obj/modular_map_connector,
/obj/machinery/door/airlock/maintenance_hatch{
	name = "Maintenance Hatch"
	},
/turf/open/floor/catwalk_floor,
/area/station/maintenance/starboard/central)
"dM" = (
/obj/effect/turf_decal/trimline/purple/filled/line,
/obj/effect/decal/cleanable/dirt,
/obj/machinery/button/door/directional/south{
	id = "assemblymeme";
	name = "Privacy Shutters Toggle"
	},
/obj/machinery/atmospherics/pipe/smart/manifold4w/scrubbers/hidden/layer2,
/turf/open/floor/iron,
/area/station/maintenance/starboard/central)
"er" = (
/obj/effect/turf_decal/trimline/purple/filled/line,
/obj/effect/decal/cleanable/dirt,
/obj/effect/decal/cleanable/oil,
/obj/machinery/atmospherics/components/unary/vent_scrubber/on/layer2{
	dir = 4
	},
/turf/open/floor/iron,
/area/station/maintenance/starboard/central)
"gA" = (
/obj/effect/decal/cleanable/dirt,
/obj/structure/chair/stool/directional/north,
/turf/open/floor/iron/smooth,
/area/station/maintenance/starboard/central)
"gP" = (
/obj/machinery/conveyor{
	dir = 4;
	id = "oldassemblyrobo"
	},
/obj/machinery/conveyor{
	dir = 4;
	id = "oldassemblyrobo"
	},
/obj/machinery/conveyor{
	dir = 4;
	id = "oldassemblyrobo"
	},
/obj/effect/decal/cleanable/dirt,
/turf/open/floor/plating,
/area/station/maintenance/starboard/central)
"gS" = (
/obj/effect/decal/cleanable/dirt,
/obj/effect/spawner/random/engineering/atmospherics_portable,
/turf/open/floor/iron/smooth,
/area/station/maintenance/starboard/central)
"kv" = (
/obj/effect/decal/cleanable/dirt,
/obj/effect/spawner/random/engineering/tank,
/turf/open/floor/iron/smooth,
/area/station/maintenance/starboard/central)
"la" = (
/obj/structure/table,
/obj/effect/turf_decal/trimline/purple/filled/line{
	dir = 6
	},
/obj/effect/decal/cleanable/dirt,
/obj/item/storage/belt/utility,
/obj/item/clothing/glasses/welding,
/turf/open/floor/iron,
/area/station/maintenance/starboard/central)
"mR" = (
/obj/effect/decal/cleanable/dirt,
/obj/structure/disposalpipe/segment,
/obj/machinery/atmospherics/pipe/smart/manifold4w/scrubbers/hidden/layer2,
/obj/machinery/atmospherics/pipe/smart/manifold4w/supply/hidden/layer4,
/obj/structure/cable,
/turf/open/floor/catwalk_floor,
/area/station/maintenance/starboard/central)
"nl" = (
/obj/effect/decal/cleanable/dirt,
/obj/structure/disposalpipe/segment{
	dir = 6
	},
/obj/machinery/atmospherics/pipe/smart/manifold4w/scrubbers/hidden/layer2,
/obj/machinery/atmospherics/pipe/smart/manifold4w/supply/hidden/layer4,
/obj/structure/cable,
/turf/open/floor/catwalk_floor,
/area/station/maintenance/starboard/central)
"nY" = (
/obj/effect/turf_decal/trimline/purple/filled/line,
/obj/effect/decal/cleanable/dirt,
/obj/machinery/atmospherics/pipe/smart/manifold4w/scrubbers/hidden/layer2,
/turf/open/floor/iron,
/area/station/maintenance/starboard/central)
"ou" = (
/obj/modular_map_root/tramstation{
	key = "cargoscilower_attachment_b";
	name = "cargoscilower_attachment_b"
	},
/turf/open/floor/plating,
/area/station/maintenance/starboard/central)
"pQ" = (
/obj/effect/spawner/structure/window/reinforced,
/obj/machinery/door/poddoor/shutters/preopen{
	id = "assemblymeme";
	name = "Assembly Line Shutters"
	},
/turf/open/floor/plating,
/area/station/maintenance/starboard/central)
"sD" = (
/obj/effect/turf_decal/trimline/purple/filled/corner,
/obj/effect/turf_decal/trimline/purple/filled/corner{
	dir = 8
	},
/obj/effect/decal/cleanable/dirt,
/obj/item/chair/stool,
/obj/machinery/atmospherics/pipe/smart/manifold4w/supply/hidden/layer4,
/obj/machinery/atmospherics/pipe/smart/manifold4w/scrubbers/hidden/layer2,
/turf/open/floor/iron,
/area/station/maintenance/starboard/central)
"sH" = (
/obj/effect/decal/cleanable/dirt,
/obj/structure/disposalpipe/segment{
	dir = 5
	},
/obj/machinery/atmospherics/pipe/smart/manifold4w/scrubbers/hidden/layer2,
/obj/machinery/atmospherics/pipe/smart/manifold4w/supply/hidden/layer4,
/turf/open/floor/catwalk_floor,
/area/station/maintenance/starboard/central)
"tG" = (
/turf/closed/wall,
/area/station/maintenance/starboard/central)
"uo" = (
/obj/effect/decal/cleanable/dirt,
/obj/structure/closet/firecloset,
/turf/open/floor/iron/smooth,
/area/station/maintenance/starboard/central)
"uJ" = (
/obj/machinery/door/airlock/research/glass{
	name = "Aseembly Lab"
	},
/obj/effect/mapping_helpers/airlock/access/all/science/robotics,
/obj/effect/turf_decal/trimline/purple/filled/line{
	dir = 4
	},
/obj/effect/turf_decal/trimline/purple/filled/line{
	dir = 8
	},
/obj/effect/decal/cleanable/dirt,
/obj/structure/barricade/wooden,
/obj/machinery/atmospherics/pipe/smart/manifold4w/supply/hidden/layer4,
/obj/machinery/atmospherics/pipe/smart/manifold4w/scrubbers/hidden/layer2,
/turf/open/floor/iron,
/area/station/maintenance/starboard/central)
"ve" = (
/turf/closed/mineral/random/stationside/asteroid/porus,
/area/station/asteroid)
"vK" = (
/obj/effect/decal/cleanable/dirt,
/obj/machinery/power/apc/auto_name/directional/south,
/obj/structure/cable,
/turf/open/floor/catwalk_floor,
/area/station/maintenance/starboard/central)
"wt" = (
/obj/effect/decal/cleanable/dirt,
/obj/effect/mapping_helpers/mail_sorting/science/ordnance,
/obj/structure/disposalpipe/sorting/mail/flip{
	dir = 8
	},
/obj/effect/mapping_helpers/mail_sorting/science/experimentor_lab,
/obj/machinery/atmospherics/pipe/smart/manifold4w/scrubbers/hidden/layer2,
/obj/machinery/atmospherics/pipe/smart/manifold4w/supply/hidden/layer4,
/obj/structure/cable,
/turf/open/floor/catwalk_floor,
/area/station/maintenance/starboard/central)
"wU" = (
/obj/structure/table,
/obj/machinery/cell_charger,
/obj/item/stock_parts/cell/high/empty,
/obj/effect/turf_decal/trimline/purple/filled/line{
	dir = 4
	},
/obj/effect/decal/cleanable/dirt,
/turf/open/floor/iron,
/area/station/maintenance/starboard/central)
"yc" = (
/obj/effect/decal/cleanable/dirt,
/turf/open/floor/iron/smooth,
/area/station/maintenance/starboard/central)
"yM" = (
/obj/structure/frame/machine,
/obj/effect/decal/cleanable/dirt,
/turf/open/floor/iron,
/area/station/maintenance/starboard/central)
"yN" = (
/obj/structure/disposalpipe/segment{
	dir = 10
	},
/obj/machinery/atmospherics/pipe/smart/manifold4w/scrubbers/hidden/layer2,
/obj/machinery/atmospherics/pipe/smart/manifold4w/supply/hidden/layer4,
/turf/open/floor/catwalk_floor,
/area/station/maintenance/starboard/central)
"zM" = (
/obj/effect/decal/cleanable/dirt,
/obj/structure/closet/wardrobe/mixed,
/turf/open/floor/iron/smooth,
/area/station/maintenance/starboard/central)
"zN" = (
/obj/effect/turf_decal/trimline/purple/filled/line,
/obj/effect/decal/cleanable/dirt,
/obj/item/stack/sheet/plasteel{
	amount = 5
	},
/obj/machinery/conveyor_switch/oneway{
	id = "oldassemblyrobo";
	name = "Unloading Conveyor";
	pixel_x = -10;
	pixel_y = 24
	},
/turf/open/floor/iron,
/area/station/maintenance/starboard/central)
"zY" = (
/obj/structure/closet/emcloset,
/obj/effect/decal/cleanable/dirt,
/obj/effect/decal/cleanable/cobweb/cobweb2,
/turf/open/floor/iron/smooth,
/area/station/maintenance/starboard/central)
"Aj" = (
/obj/machinery/conveyor{
	dir = 4;
	id = "oldassemblyrobo"
	},
/obj/item/crowbar,
/obj/effect/decal/cleanable/dirt,
/turf/open/floor/plating,
/area/station/maintenance/starboard/central)
"Ca" = (
/obj/modular_map_root/tramstation{
	key = "cargoscilower_attachment_a";
	name = "cargoscilower_attachment_a"
	},
/turf/open/floor/plating,
/area/station/maintenance/starboard/central)
"Dx" = (
/obj/effect/decal/cleanable/dirt,
/obj/effect/decal/cleanable/dirt,
/obj/structure/disposalpipe/segment{
	dir = 6
	},
/obj/machinery/atmospherics/pipe/smart/manifold4w/scrubbers/hidden/layer2,
/obj/machinery/atmospherics/pipe/smart/manifold4w/supply/hidden/layer4,
/obj/structure/cable,
/turf/open/floor/catwalk_floor,
/area/station/maintenance/starboard/central)
"DG" = (
/obj/effect/decal/cleanable/dirt,
/obj/structure/disposalpipe/segment{
	dir = 4
	},
/obj/machinery/atmospherics/pipe/smart/manifold4w/scrubbers/hidden/layer2,
/obj/machinery/atmospherics/pipe/smart/manifold4w/supply/hidden/layer4,
/obj/structure/cable,
/turf/open/floor/catwalk_floor,
/area/station/maintenance/starboard/central)
"Ei" = (
/obj/effect/decal/cleanable/dirt,
/obj/structure/closet/cardboard,
/obj/effect/spawner/random/maintenance/three,
/obj/effect/spawner/random/engineering/tool,
/obj/effect/spawner/random/engineering/material_cheap,
/turf/open/floor/iron/smooth,
/area/station/maintenance/starboard/central)
"Hi" = (
/obj/effect/decal/cleanable/dirt,
/obj/structure/chair/stool/directional/south,
/turf/open/floor/iron/smooth,
/area/station/maintenance/starboard/central)
"HD" = (
/obj/effect/decal/cleanable/dirt,
/obj/structure/cable,
/obj/machinery/atmospherics/pipe/smart/manifold4w/scrubbers/hidden/layer2,
/obj/machinery/atmospherics/pipe/smart/manifold4w/supply/hidden/layer4,
/turf/open/floor/catwalk_floor,
/area/station/maintenance/starboard/central)
"HF" = (
/obj/effect/decal/cleanable/dirt,
/obj/structure/disposalpipe/segment{
	dir = 4
	},
/obj/machinery/atmospherics/pipe/smart/manifold4w/scrubbers/hidden/layer2,
/obj/machinery/atmospherics/pipe/smart/manifold4w/supply/hidden/layer4,
/obj/structure/cable,
/obj/effect/spawner/random/trash/food_packaging,
/turf/open/floor/catwalk_floor,
/area/station/maintenance/starboard/central)
"Il" = (
/obj/effect/decal/cleanable/dirt,
/obj/effect/spawner/random/trash/cigbutt,
/turf/open/floor/iron/smooth,
/area/station/maintenance/starboard/central)
"Io" = (
/obj/effect/decal/cleanable/dirt,
/obj/structure/cable,
/turf/open/floor/catwalk_floor,
/area/station/maintenance/starboard/central)
"IV" = (
/obj/effect/decal/cleanable/dirt,
/obj/structure/disposalpipe/segment{
	dir = 10
	},
/obj/machinery/atmospherics/pipe/smart/manifold4w/scrubbers/hidden/layer2,
/obj/machinery/atmospherics/pipe/smart/manifold4w/supply/hidden/layer4,
/obj/structure/cable,
/obj/effect/decal/cleanable/cobweb/cobweb2,
/turf/open/floor/catwalk_floor,
/area/station/maintenance/starboard/central)
"Ji" = (
/obj/effect/decal/cleanable/dirt,
/obj/machinery/atmospherics/pipe/smart/manifold4w/supply/hidden/layer4,
/obj/machinery/atmospherics/pipe/smart/manifold4w/scrubbers/hidden/layer2,
/turf/open/floor/catwalk_floor,
/area/station/maintenance/starboard/central)
"Ko" = (
/obj/effect/turf_decal/trimline/purple/filled/line,
/obj/effect/decal/cleanable/dirt,
/obj/effect/decal/cleanable/robot_debris/limb,
/obj/machinery/atmospherics/pipe/smart/manifold4w/scrubbers/hidden/layer2,
/turf/open/floor/iron,
/area/station/maintenance/starboard/central)
"Kr" = (
/obj/effect/decal/cleanable/dirt,
/obj/structure/table,
/turf/open/floor/iron/smooth,
/area/station/maintenance/starboard/central)
"Lg" = (
/obj/effect/decal/cleanable/dirt,
/obj/structure/disposalpipe/segment{
	dir = 9
	},
/obj/machinery/atmospherics/pipe/smart/manifold4w/scrubbers/hidden/layer2,
/obj/machinery/atmospherics/pipe/smart/manifold4w/supply/hidden/layer4,
/obj/structure/cable,
/turf/open/floor/catwalk_floor,
/area/station/maintenance/starboard/central)
"Lw" = (
/obj/machinery/mecha_part_fabricator/maint,
/obj/effect/decal/cleanable/dirt,
/obj/effect/decal/cleanable/cobweb,
/turf/open/floor/iron,
/area/station/maintenance/starboard/central)
"LO" = (
/obj/effect/decal/cleanable/dirt,
/obj/structure/disposalpipe/segment,
/obj/machinery/atmospherics/pipe/smart/manifold4w/scrubbers/hidden/layer2,
/obj/machinery/atmospherics/pipe/smart/manifold4w/supply/hidden/layer4,
/turf/open/floor/catwalk_floor,
/area/station/maintenance/starboard/central)
"Mt" = (
/obj/effect/decal/cleanable/dirt,
/obj/machinery/atmospherics/components/unary/portables_connector/visible{
	dir = 8
	},
/obj/machinery/portable_atmospherics/canister/oxygen,
/turf/open/floor/iron/smooth,
/area/station/maintenance/starboard/central)
"Ne" = (
/turf/open/misc/asteroid/airless,
/area/station/asteroid)
"ND" = (
/turf/template_noop,
/area/template_noop)
"OM" = (
/obj/effect/spawner/structure/window/reinforced,
/turf/open/floor/plating,
/area/station/maintenance/starboard/central)
"OS" = (
/obj/effect/decal/cleanable/dirt,
/obj/machinery/atmospherics/components/trinary/mixer{
	dir = 8
	},
/turf/open/floor/iron/smooth,
/area/station/maintenance/starboard/central)
"Qt" = (
/obj/effect/decal/cleanable/dirt,
/obj/structure/disposalpipe/segment{
	dir = 5
	},
/obj/machinery/atmospherics/pipe/smart/manifold4w/scrubbers/hidden/layer2,
/obj/machinery/atmospherics/pipe/smart/manifold4w/supply/hidden/layer4,
/obj/structure/cable,
/turf/open/floor/catwalk_floor,
/area/station/maintenance/starboard/central)
"QG" = (
/obj/effect/turf_decal/loading_area{
	dir = 4
	},
/obj/effect/decal/cleanable/dirt,
/obj/item/bodypart/leg/left/robot,
/obj/item/bodypart/arm/right/robot,
/obj/machinery/atmospherics/components/unary/vent_pump/on/layer4,
/turf/open/floor/iron,
/area/station/maintenance/starboard/central)
"Ue" = (
/turf/closed/wall/r_wall,
/area/station/maintenance/starboard/central)
"UN" = (
/obj/effect/decal/cleanable/dirt,
/obj/effect/spawner/random/structure/steam_vent,
/obj/structure/window/spawner,
/obj/structure/window/spawner/north,
/turf/open/floor/plating,
/area/station/maintenance/starboard/central)
"Vq" = (
/obj/machinery/conveyor{
	dir = 4;
	id = "oldassemblyrobo"
	},
/obj/effect/decal/cleanable/dirt,
/turf/open/floor/plating,
/area/station/maintenance/starboard/central)
"XI" = (
/obj/effect/decal/cleanable/dirt,
/obj/machinery/atmospherics/components/unary/portables_connector/visible,
/turf/open/floor/iron/smooth,
/area/station/maintenance/starboard/central)
"Yt" = (
/obj/effect/decal/cleanable/dirt,
/obj/machinery/atmospherics/components/unary/portables_connector/visible{
	dir = 4
	},
/obj/machinery/portable_atmospherics/canister,
/turf/open/floor/iron/smooth,
/area/station/maintenance/starboard/central)
"Zy" = (
/obj/effect/decal/cleanable/dirt,
/obj/effect/spawner/random/engineering/canister,
/turf/open/floor/iron/smooth,
/area/station/maintenance/starboard/central)

(1,1,1) = {"
ND
ND
ND
ND
ND
ND
ND
ND
ND
ND
ND
ND
ND
ND
ND
ND
ND
ND
ND
ND
ND
ND
ND
ve
ve
ve
ve
ve
ve
ve
ve
ve
ve
ve
ve
ND
ND
"}
(2,1,1) = {"
ND
ND
ND
ND
ND
ND
ND
ND
ND
ND
ND
ND
ND
ND
ND
ND
ND
ND
ND
ND
ND
ND
ND
ve
ve
ve
ve
ve
ve
ve
ve
ve
ve
ve
ve
ND
ND
"}
(3,1,1) = {"
ND
ND
ND
ND
ND
ND
ND
ND
ND
ND
ND
ND
ND
ND
ND
ND
ND
ND
ND
ND
ND
ND
ve
ve
ve
ve
ve
ve
ve
ve
ve
ve
ve
ve
ve
ND
ND
"}
(4,1,1) = {"
ND
ND
ND
ND
ND
ND
ND
ND
ND
ND
ND
ND
ND
ND
ND
ND
ND
ND
ND
ND
ND
ND
ve
ve
ve
ve
ve
ve
ve
ve
ve
ve
ve
ve
ve
ND
ND
"}
(5,1,1) = {"
ND
ND
ND
ND
ND
ND
ND
ND
ND
ND
ND
ND
ND
ND
ND
ND
ND
ND
ND
ND
ND
ND
ve
ve
ve
ve
ve
ve
ve
ve
ve
ve
ve
ve
ve
ND
ND
"}
(6,1,1) = {"
ND
ND
ND
ND
ND
ND
ND
ND
ND
ND
ND
ND
ND
ND
ND
ND
ND
ND
ND
ND
ND
ND
ve
ve
ve
ve
ve
ve
ve
ve
ve
ve
ve
ve
ve
ND
ND
"}
(7,1,1) = {"
ND
ND
ND
ND
ND
ND
ND
ND
ND
ND
ND
ND
ND
ND
ND
ND
ND
ND
ND
ND
ND
ND
ve
ve
ve
ve
ve
ve
tG
tG
tG
tG
tG
tG
Ca
tG
tG
"}
(8,1,1) = {"
ND
ND
ND
ND
ND
ND
ND
ND
ND
ND
ND
ND
ND
ND
ND
ND
ND
ND
ND
ND
ND
ND
tG
tG
tG
tG
tG
tG
tG
nl
mR
mR
mR
mR
mR
mR
dL
"}
(9,1,1) = {"
ND
ND
ND
ND
ND
ND
ND
ND
ND
ND
ND
ND
ND
ND
ND
ND
ND
ND
ND
ND
ND
ND
Lw
gP
zN
tG
nl
mR
mR
Lg
ND
ND
ND
ND
ND
ND
ND
"}
(10,1,1) = {"
ND
ND
ND
ND
ND
ND
ND
ND
ND
ND
ND
ND
ND
ND
ND
ND
ND
ND
ND
ND
ND
ND
cD
Vq
er
pQ
DG
ND
ND
ND
ND
ND
ND
ND
ND
ND
ND
"}
(11,1,1) = {"
ND
ND
ND
ND
ND
ND
ND
ND
ND
ND
ND
ND
ND
ND
ND
ND
ND
ND
ND
ND
ND
ND
yM
Vq
nY
pQ
DG
ND
ND
ND
ND
ND
ND
ND
ND
ND
ND
"}
(12,1,1) = {"
ND
ND
ND
ND
ND
ND
ND
ND
ND
ND
ND
ND
ND
ND
ND
ND
ND
ND
ND
ND
ND
ND
cD
Aj
nY
pQ
DG
ND
ND
ND
ND
ND
ND
ND
ND
ND
ND
"}
(13,1,1) = {"
ND
ND
ND
ND
ND
ND
ND
ND
ND
ND
ND
ND
ND
ND
ND
ND
ND
ND
ND
ND
ND
ND
cG
Vq
Ko
pQ
DG
ND
ND
ND
ND
ND
ND
ND
ND
ND
ND
"}
(14,1,1) = {"
ND
ND
ND
ND
ND
ND
ND
ND
ND
ND
ND
ND
ND
ND
ND
ND
ND
ND
ND
ND
ND
ND
tG
Vq
dM
tG
DG
ND
ND
ND
ND
ND
ND
ND
ND
ND
ND
"}
(15,1,1) = {"
ND
ND
ND
ND
ND
ND
ND
ND
ND
ND
ND
ND
ND
ND
ND
ND
ND
ND
ND
ND
ND
ve
tG
QG
sD
uJ
HF
ND
ND
ND
ND
ND
ND
ND
ND
ND
ND
"}
(16,1,1) = {"
ND
ND
ND
ND
ND
ND
ND
ND
ND
ND
ND
ND
ND
ND
ND
ND
ND
ND
ND
ND
ve
ve
tG
wU
la
tG
DG
ND
ND
ND
ND
ND
ND
ND
ND
ND
ND
"}
(17,1,1) = {"
ND
ND
ND
ND
ND
ND
ND
ND
ND
ND
ND
ND
ND
ND
ND
ND
ND
ND
ND
ND
tG
tG
tG
tG
tG
tG
DG
ND
ND
ND
ND
ND
ND
ND
ND
ND
ND
"}
(18,1,1) = {"
ND
ND
ND
ND
ND
ND
ND
ND
ND
ND
ND
ND
ND
ND
ND
ND
ND
ND
ND
ND
Ji
Ji
Ji
Zy
UN
gS
wt
LO
sH
ND
ND
ND
ND
ND
ND
ND
ND
"}
(19,1,1) = {"
ND
ND
ND
ND
ND
ND
ND
ND
ND
ND
ND
ND
ND
ND
ND
ND
ND
ND
ND
ND
tG
tG
nl
mR
mR
mR
Lg
yc
yN
ND
ND
ND
ND
ND
ND
ND
ND
"}
(20,1,1) = {"
ND
ND
ND
ND
ND
ND
ND
ND
ND
ND
ND
ND
ND
ND
ND
ND
ND
ND
ND
ND
ve
tG
DG
ND
ND
ND
ND
ND
ND
ND
ND
ND
ND
ND
ND
ND
ND
"}
(21,1,1) = {"
ND
ND
ND
ND
ND
ND
ND
ND
ND
ND
ND
ND
ND
ND
ND
ND
ND
ND
ND
ND
ve
tG
DG
ND
ND
ND
ND
ND
ND
ND
ND
ND
ND
ND
ND
ND
ND
"}
(22,1,1) = {"
ND
ND
ND
ND
ND
ND
ND
ND
ND
ND
ND
ND
ND
ND
ND
ND
ND
ND
ND
ND
ve
tG
DG
ND
ND
ND
ND
ND
ND
ND
ND
ND
ND
ND
ND
ND
ND
"}
(23,1,1) = {"
ND
ND
ND
ND
ND
ND
ND
ND
ND
ND
ND
ND
ND
ND
ND
ND
ND
ND
ND
ND
ve
tG
DG
ND
ND
ND
ND
ND
ND
ND
ND
ND
ND
ND
ND
ND
ND
"}
(24,1,1) = {"
ND
ND
ND
ND
ND
ND
ND
ND
ND
ND
ND
ND
ND
ND
ND
ND
ND
ND
ND
ND
ve
tG
DG
ND
ND
ND
ND
ND
ND
ND
ND
ND
ND
ND
ND
ND
ND
"}
(25,1,1) = {"
ND
ND
ND
ND
ND
ND
ND
ND
ND
ND
ND
ND
ND
ND
ND
ND
ND
ND
ND
ND
ve
tG
DG
ND
ND
ND
ND
ND
ND
ND
ND
ND
ND
ND
ND
ND
ND
"}
(26,1,1) = {"
ND
ND
DG
ND
ND
ND
ND
ND
nl
mR
Qt
ND
ND
ND
ND
ND
ND
ND
ND
ND
ve
tG
DG
ND
ND
ND
ND
ND
ND
ND
ND
ND
ND
ND
ND
ND
ND
"}
(27,1,1) = {"
ND
HD
bA
mR
mR
mR
mR
mR
Lg
tG
DG
ND
ND
ND
ND
ND
ND
ND
ND
ND
tG
tG
DG
tG
ve
ve
ND
ND
ND
ND
ND
ND
ND
ND
ND
ND
ND
"}
(28,1,1) = {"
ND
ND
ND
ND
ND
tG
tG
tG
tG
tG
DG
ND
ND
ND
ND
ND
ND
ND
ND
ND
Io
Io
DG
tG
Ue
ND
ND
ND
ND
ND
ND
ND
ND
ND
ND
ND
ND
"}
(29,1,1) = {"
ND
ND
ND
ND
ND
ve
ve
ve
tG
Dx
Lg
ND
ND
ND
ND
ND
ND
ND
ND
ND
tG
tG
DG
vK
Ue
ND
ND
ND
ND
ND
ND
ND
ND
ND
ND
ND
ND
"}
(30,1,1) = {"
ND
ND
ND
ND
ND
ve
ve
tG
tG
DG
ND
ND
ND
ND
ND
ND
ND
ND
ND
ND
ND
uo
DG
tG
Ue
ND
ND
ND
ND
ND
ND
ND
ND
ND
ND
ND
ND
"}
(31,1,1) = {"
ND
ND
ND
ND
ND
ve
ve
ou
nl
Lg
ND
ND
ND
ND
ND
ND
ND
ND
ND
ND
ND
zY
DG
yc
kv
ND
ND
ND
ND
ND
ND
ND
ND
ND
ND
ND
ND
"}
(32,1,1) = {"
ND
ND
ND
ND
ND
ve
ve
tG
DG
ND
ND
ND
ND
ND
ND
ND
ND
ND
ND
ND
ND
ND
DG
yc
yc
ND
ND
ND
ND
ND
ND
ND
ND
ND
ND
ND
ND
"}
(33,1,1) = {"
ND
ND
ND
ND
ND
ve
ve
tG
HF
ND
ND
ND
ND
ND
ND
ND
ND
ND
ND
ND
ND
ND
DG
yc
Yt
ND
ND
ND
ND
ND
ND
ND
ND
ND
ND
ND
ND
"}
(34,1,1) = {"
ND
ND
ND
ND
ND
ve
ve
tG
DG
ND
ND
ND
ND
ND
ND
ND
ND
ND
ND
ND
ND
ND
DG
XI
OS
ND
ND
ND
ND
ND
ND
ND
ND
ND
ND
ND
ND
"}
(35,1,1) = {"
ND
ND
ND
ND
ND
ve
ve
tG
DG
ND
ND
ND
ND
ND
ND
ND
ND
ND
ND
ND
ND
ND
DG
yc
Mt
ND
ND
ND
ND
ND
ND
ND
ND
ND
ND
ND
ND
"}
(36,1,1) = {"
ND
ND
ND
ND
ND
ND
ve
tG
IV
mR
mR
Qt
ND
ND
ND
ND
ND
ND
ND
nl
mR
mR
Lg
tG
tG
ND
ND
ND
ND
ND
ND
ND
ND
ND
ND
ND
ND
"}
(37,1,1) = {"
ND
ND
ND
ND
ND
ND
ve
tG
tG
tG
tG
bA
mR
mR
mR
mR
mR
mR
mR
Lg
tG
tG
tG
tG
ve
ND
ND
ND
ND
ND
ND
ND
ND
ND
ND
ND
ND
"}
(38,1,1) = {"
ND
ND
ND
ND
ND
ND
ve
ve
ve
ve
tG
yc
yc
yc
Il
yc
yc
yc
yc
yc
tG
ve
ve
ve
ve
ND
ND
ND
ND
ND
ND
ND
ND
ND
ND
ND
ND
"}
(39,1,1) = {"
ND
ND
ND
ND
ND
ND
ND
ve
ve
ve
tG
tG
Ei
yc
Hi
Kr
gA
yc
zM
tG
tG
ve
ve
ve
ve
ND
ND
ND
ND
ND
ND
ND
ND
ND
ND
ND
ND
"}
(40,1,1) = {"
ND
ND
ND
ND
ND
ND
ND
ve
ve
ve
ve
tG
tG
OM
OM
OM
OM
OM
tG
tG
ve
ve
ve
ve
ve
ND
ND
ND
ND
ND
ND
ND
ND
ND
ND
ND
ND
"}
(41,1,1) = {"
ND
ND
ND
ND
ND
ND
ND
ve
ve
ve
ve
ve
Ne
Ne
Ne
Ne
Ne
Ne
Ne
Ne
ve
ve
ve
ve
ve
ND
ND
ND
ND
ND
ND
ND
ND
ND
ND
ND
ND
"}
(42,1,1) = {"
ND
ND
ND
ND
ND
ND
ND
Ne
ve
ve
ve
Ne
Ne
Ne
Ne
Ne
Ne
Ne
Ne
Ne
Ne
ve
ve
ve
ve
ND
ND
ND
ND
ND
ND
ND
ND
ND
ND
ND
ND
"}
(43,1,1) = {"
ND
ND
ND
ND
ND
ND
ND
Ne
ve
ve
Ne
Ne
Ne
Ne
Ne
Ne
Ne
Ne
Ne
Ne
Ne
Ne
ve
Ne
ve
ND
ND
ND
ND
ND
ND
ND
ND
ND
ND
ND
ND
"}
(44,1,1) = {"
ND
ND
ND
ND
ND
ND
ND
Ne
ve
ve
Ne
Ne
Ne
Ne
Ne
Ne
Ne
Ne
Ne
Ne
Ne
Ne
Ne
Ne
Ne
ND
ND
ND
ND
ND
ND
ND
ND
ND
ND
ND
ND
"}
(45,1,1) = {"
ND
ND
ND
ND
ND
ND
ND
ve
ve
ve
ve
Ne
Ne
Ne
Ne
Ne
Ne
Ne
Ne
Ne
Ne
Ne
Ne
Ne
Ne
ND
ND
ND
ND
ND
ND
ND
ND
ND
ND
ND
ND
"}
(46,1,1) = {"
ND
ND
ND
ND
ND
ND
ND
ve
ve
ve
Ne
Ne
Ne
Ne
Ne
Ne
Ne
Ne
Ne
Ne
Ne
Ne
Ne
Ne
ND
ND
ND
ND
ND
ND
ND
ND
ND
ND
ND
ND
ND
"}
(47,1,1) = {"
ND
ND
ND
ND
ND
ND
ND
ve
ve
ve
Ne
Ne
Ne
Ne
Ne
Ne
Ne
Ne
Ne
Ne
Ne
Ne
Ne
Ne
ND
ND
ND
ND
ND
ND
ND
ND
ND
ND
ND
ND
ND
"}
(48,1,1) = {"
ND
ND
ND
ND
ND
ND
ve
ve
ve
ve
Ne
Ne
Ne
Ne
Ne
Ne
Ne
Ne
Ne
Ne
Ne
Ne
Ne
ND
ND
ND
ND
ND
ND
ND
ND
ND
ND
ND
ND
ND
ND
"}
(49,1,1) = {"
ND
ND
ND
ND
ND
ND
ve
ve
ve
ve
Ne
Ne
Ne
Ne
Ne
Ne
Ne
Ne
Ne
Ne
Ne
Ne
ND
ND
ND
ND
ND
ND
ND
ND
ND
ND
ND
ND
ND
ND
ND
"}
(50,1,1) = {"
ND
ND
ND
ND
ND
ND
ve
ve
ve
ve
Ne
Ne
Ne
Ne
Ne
Ne
Ne
Ne
Ne
Ne
Ne
Ne
ND
ND
ND
ND
ND
ND
ND
ND
ND
ND
ND
ND
ND
ND
ND
"}
(51,1,1) = {"
ND
ND
ND
ND
ND
ND
ve
ve
Ne
Ne
Ne
Ne
Ne
Ne
Ne
Ne
Ne
Ne
Ne
Ne
Ne
Ne
ND
ND
ND
ND
ND
ND
ND
ND
ND
ND
ND
ND
ND
ND
ND
"}
(52,1,1) = {"
ND
ND
ND
ND
ND
ve
ve
ve
Ne
Ne
Ne
Ne
Ne
Ne
Ne
Ne
Ne
Ne
Ne
Ne
Ne
ND
ND
ND
ND
ND
ND
ND
ND
ND
ND
ND
ND
ND
ND
ND
ND
"}
(53,1,1) = {"
ND
ND
ND
ND
ND
ve
ve
ve
ve
Ne
Ne
Ne
Ne
Ne
Ne
Ne
Ne
Ne
Ne
Ne
Ne
ND
ND
ND
ND
ND
ND
ND
ND
ND
ND
ND
ND
ND
ND
ND
ND
"}
(54,1,1) = {"
ND
ND
ND
ND
ND
ve
ve
ve
ve
ve
Ne
Ne
Ne
Ne
Ne
Ne
Ne
Ne
Ne
Ne
ND
ND
ND
ND
ND
ND
ND
ND
ND
ND
ND
ND
ND
ND
ND
ND
ND
"}
(55,1,1) = {"
ND
ND
ND
ND
ND
ve
ve
ve
ve
ve
Ne
Ne
Ne
Ne
Ne
Ne
Ne
Ne
Ne
Ne
ND
ND
ND
ND
ND
ND
ND
ND
ND
ND
ND
ND
ND
ND
ND
ND
ND
"}
