//MAP CONVERTED BY dmm2tgm.py THIS HEADER COMMENT PREVENTS RECONVERSION, DO NOT REMOVE
"a" = (
/turf/template_noop,
/area/template_noop)
"c" = (
/obj/item/shovel,
/turf/open/misc/asteroid/dug,
/area/station/asteroid)
"f" = (
/obj/item/relic,
/turf/open/misc/asteroid/dug,
/area/station/asteroid)
"g" = (
/turf/open/misc/asteroid/dug,
/area/station/asteroid)
"h" = (
/obj/modular_map_connector,
/obj/effect/decal/cleanable/dirt,
/turf/open/floor/iron/smooth,
/area/station/maintenance/starboard/central)
"i" = (
/obj/effect/decal/cleanable/dirt,
/turf/open/floor/iron/smooth,
/area/station/maintenance/starboard/central)
"p" = (
/obj/item/stack/ore/glass,
/turf/open/misc/asteroid,
/area/station/asteroid)
"q" = (
/obj/item/clothing/suit/hazardvest,
/obj/item/clothing/head/utility/hardhat/orange,
/turf/open/misc/asteroid,
/area/station/asteroid)
"t" = (
/obj/structure/rack,
/obj/effect/spawner/random/maintenance/two,
/obj/effect/spawner/random/engineering/toolbox,
/obj/effect/turf_decal/sand,
/turf/open/floor/iron/smooth,
/area/station/maintenance/starboard/central)
"u" = (
/obj/item/stack/ore/glass,
/turf/open/misc/asteroid/dug,
/area/station/asteroid)
"v" = (
/turf/closed/wall,
/area/station/maintenance/starboard/central)
"C" = (
/turf/open/misc/asteroid,
/area/station/asteroid)
"F" = (
/turf/closed/mineral/random/stationside/asteroid/porus,
/area/station/asteroid)
"J" = (
/obj/effect/decal/cleanable/dirt,
/obj/effect/spawner/random/engineering/atmospherics_portable,
/turf/open/floor/iron/smooth,
/area/station/maintenance/starboard/central)
"Q" = (
/obj/effect/turf_decal/sand/plating,
/obj/structure/falsewall,
/turf/open/floor/plating,
/area/station/maintenance/starboard/central)
"R" = (
/obj/effect/decal/cleanable/dirt,
/obj/effect/spawner/random/engineering/canister,
/turf/open/floor/iron/smooth,
/area/station/maintenance/starboard/central)
"W" = (
/obj/effect/decal/cleanable/dirt,
/obj/effect/spawner/random/engineering/tank,
/turf/open/floor/iron/smooth,
/area/station/maintenance/starboard/central)
"Z" = (
/obj/effect/decal/cleanable/dirt,
/obj/structure/rack,
/obj/effect/spawner/random/maintenance/three,
/obj/effect/spawner/random/engineering/flashlight,
/turf/open/floor/iron/smooth,
/area/station/maintenance/starboard/central)

(1,1,1) = {"
a
F
F
F
F
C
p
C
q
F
C
F
F
a
"}
(2,1,1) = {"
a
F
F
F
F
c
g
g
C
C
C
F
F
a
"}
(3,1,1) = {"
F
F
F
C
C
u
f
F
p
C
C
C
F
a
"}
(4,1,1) = {"
F
F
C
C
F
C
F
F
F
F
C
C
F
a
"}
(5,1,1) = {"
F
F
C
F
F
F
v
v
v
v
Q
v
v
a
"}
(6,1,1) = {"
F
F
F
F
F
F
v
R
J
Z
t
W
W
a
"}
(7,1,1) = {"
F
F
F
F
F
F
a
i
i
i
i
i
h
a
"}
(8,1,1) = {"
a
a
a
a
a
a
a
a
a
a
a
a
a
a
"}
(9,1,1) = {"
a
a
a
a
a
a
a
a
a
a
a
a
a
a
"}
(10,1,1) = {"
a
a
a
a
a
a
a
a
a
a
a
a
a
a
"}
(11,1,1) = {"
a
a
a
a
a
a
a
a
a
a
a
a
a
a
"}
(12,1,1) = {"
a
a
a
a
a
a
a
a
a
a
a
a
a
a
"}
(13,1,1) = {"
a
a
a
a
a
a
a
a
a
a
a
a
a
a
"}
(14,1,1) = {"
a
a
a
a
a
a
a
a
a
a
a
a
a
a
"}
(15,1,1) = {"
a
a
a
a
a
a
a
a
a
a
a
a
a
a
"}
(16,1,1) = {"
a
a
a
a
a
a
a
a
a
a
a
a
a
a
"}
(17,1,1) = {"
a
a
a
a
a
a
a
a
a
a
a
a
a
a
"}
