//MAP CONVERTED BY dmm2tgm.py THIS HEADER COMMENT PREVENTS RECONVERSION, DO NOT REMOVE
"a" = (
/obj/effect/decal/cleanable/dirt,
/obj/effect/spawner/random/trash/cigbutt,
/turf/open/floor/plating,
/area/station/maintenance/department/medical)
"b" = (
/obj/effect/decal/cleanable/dirt,
/obj/effect/turf_decal/trimline/blue/filled/line{
	dir = 8
	},
/turf/open/floor/iron/white,
/area/station/maintenance/department/medical)
"m" = (
/obj/effect/decal/cleanable/dirt,
/obj/structure/table/glass,
/obj/effect/spawner/random/medical/minor_healing,
/obj/effect/turf_decal/tile/blue/fourcorners,
/turf/open/floor/iron/white,
/area/station/maintenance/department/medical)
"p" = (
/turf/template_noop,
/area/template_noop)
"q" = (
/obj/effect/decal/cleanable/dirt,
/turf/open/floor/plating,
/area/station/maintenance/department/medical)
"x" = (
/obj/effect/decal/cleanable/dirt,
/obj/effect/mapping_helpers/broken_floor,
/obj/effect/decal/cleanable/blood/drip,
/turf/open/floor/plating,
/area/station/maintenance/department/medical)
"H" = (
/obj/effect/decal/cleanable/dirt,
/obj/machinery/door/airlock/maintenance_hatch{
	name = "Morgue Maintenance"
	},
/obj/modular_map_connector,
/obj/effect/mapping_helpers/airlock/access/all/engineering/maintenance,
/turf/open/floor/iron/smooth,
/area/station/maintenance/department/medical)
"L" = (
/obj/effect/decal/cleanable/dirt,
/obj/machinery/iv_drip,
/turf/open/floor/plating,
/area/station/maintenance/department/medical)
"Q" = (
/obj/effect/decal/cleanable/dirt,
/obj/structure/table/glass,
/obj/effect/spawner/random/medical/medkit,
/obj/machinery/light/small/directional/west,
/obj/effect/turf_decal/tile/blue/fourcorners,
/turf/open/floor/iron/white,
/area/station/maintenance/department/medical)
"U" = (
/obj/effect/decal/cleanable/dirt,
/obj/effect/mapping_helpers/broken_floor,
/turf/open/floor/iron/white,
/area/station/maintenance/department/medical)
"X" = (
/obj/effect/decal/cleanable/dirt,
/obj/effect/spawner/random/medical/patient_stretcher,
/obj/effect/decal/cleanable/blood/old,
/obj/effect/landmark/xeno_spawn,
/turf/open/floor/iron/smooth,
/area/station/maintenance/department/medical)

(1,1,1) = {"
Q
m
"}
(2,1,1) = {"
b
b
"}
(3,1,1) = {"
a
U
"}
(4,1,1) = {"
x
L
"}
(5,1,1) = {"
q
X
"}
(6,1,1) = {"
H
p
"}
