//MAP CONVERTED BY dmm2tgm.py THIS HEADER COMMENT PREVENTS RECONVERSION, DO NOT REMOVE
"ap" = (
/obj/structure/disposalpipe/segment{
	dir = 9
	},
/obj/structure/cable,
/obj/machinery/atmospherics/pipe/smart/manifold4w/supply/hidden/layer4,
/obj/effect/decal/cleanable/dirt,
/turf/open/floor/catwalk_floor,
/area/station/maintenance/port/central)
"aW" = (
/obj/structure/disposalpipe/segment{
	dir = 10
	},
/obj/structure/cable,
/obj/machinery/atmospherics/pipe/smart/manifold4w/supply/hidden/layer4,
/obj/machinery/atmospherics/pipe/smart/manifold4w/scrubbers/hidden/layer2,
/obj/effect/decal/cleanable/dirt,
/turf/open/floor/catwalk_floor,
/area/station/maintenance/port/central)
"cw" = (
/obj/structure/cable,
/obj/effect/decal/cleanable/dirt,
/obj/machinery/atmospherics/pipe/smart/manifold4w/scrubbers/hidden/layer2,
/obj/machinery/atmospherics/pipe/smart/manifold4w/supply/hidden/layer4,
/obj/effect/landmark/xeno_spawn,
/turf/open/floor/catwalk_floor,
/area/station/maintenance/central/greater)
"cz" = (
/obj/effect/decal/cleanable/dirt,
/obj/machinery/atmospherics/pipe/smart/manifold4w/supply/hidden/layer4,
/obj/machinery/atmospherics/pipe/smart/manifold4w/scrubbers/hidden/layer2,
/obj/structure/cable,
/turf/open/floor/catwalk_floor,
/area/station/maintenance/central/greater)
"ek" = (
/turf/closed/mineral/random/stationside/asteroid/porus,
/area/station/asteroid)
"fs" = (
/obj/effect/decal/cleanable/dirt,
/obj/structure/chair/stool/directional/west,
/turf/open/floor/iron/smooth,
/area/station/maintenance/central/greater)
"fL" = (
/obj/effect/decal/cleanable/dirt,
/obj/structure/grille,
/turf/open/floor/iron/smooth,
/area/station/maintenance/port/central)
"gt" = (
/obj/structure/cable,
/obj/effect/decal/cleanable/dirt,
/obj/machinery/atmospherics/pipe/smart/manifold4w/scrubbers/hidden/layer2,
/obj/machinery/atmospherics/pipe/smart/manifold4w/supply/hidden/layer4,
/obj/machinery/duct,
/turf/open/floor/catwalk_floor,
/area/station/maintenance/central/greater)
"gN" = (
/obj/effect/decal/cleanable/dirt,
/obj/structure/disposalpipe/segment{
	dir = 4
	},
/obj/machinery/atmospherics/pipe/smart/manifold4w/supply/hidden/layer4,
/obj/structure/cable,
/obj/structure/disposalpipe/segment{
	dir = 9
	},
/obj/machinery/atmospherics/pipe/smart/manifold4w/scrubbers/hidden/layer2,
/turf/open/floor/catwalk_floor,
/area/station/maintenance/port/central)
"gU" = (
/obj/structure/ladder,
/obj/effect/decal/cleanable/dirt,
/turf/open/floor/iron/smooth,
/area/station/maintenance/central/greater)
"hb" = (
/obj/effect/turf_decal/stripes/end{
	dir = 4
	},
/obj/structure/cable/multilayer/multiz,
/obj/structure/sign/warning/electric_shock/directional/west,
/obj/effect/decal/cleanable/dirt,
/turf/open/floor/plating,
/area/station/maintenance/central/greater)
"hd" = (
/obj/effect/decal/cleanable/dirt,
/obj/effect/spawner/random/structure/steam_vent,
/turf/open/floor/iron/smooth,
/area/station/maintenance/port/central)
"hi" = (
/obj/effect/decal/cleanable/dirt,
/obj/structure/disposalpipe/segment,
/obj/machinery/atmospherics/pipe/smart/manifold4w/scrubbers/hidden/layer2,
/obj/machinery/atmospherics/pipe/smart/manifold4w/supply/hidden/layer4,
/obj/structure/cable,
/turf/open/floor/catwalk_floor,
/area/station/maintenance/port/central)
"hz" = (
/obj/structure/table,
/obj/effect/decal/cleanable/dirt,
/turf/open/floor/iron/smooth,
/area/station/maintenance/central/greater)
"im" = (
/obj/machinery/door/airlock/maintenance_hatch{
	name = "Maintenance Hatch"
	},
/obj/effect/mapping_helpers/airlock/access/all/engineering/maintenance,
/obj/machinery/duct,
/obj/effect/mapping_helpers/airlock/unres{
	dir = 8
	},
/obj/structure/cable,
/obj/effect/decal/cleanable/dirt,
/obj/machinery/atmospherics/pipe/smart/manifold4w/scrubbers/hidden/layer2,
/obj/machinery/atmospherics/pipe/smart/manifold4w/supply/hidden/layer4,
/turf/open/floor/catwalk_floor,
/area/station/maintenance/central/greater)
"iy" = (
/obj/structure/cable,
/obj/effect/decal/cleanable/dirt,
/obj/machinery/atmospherics/pipe/smart/manifold4w/supply/hidden/layer4,
/obj/machinery/atmospherics/pipe/smart/manifold4w/scrubbers/hidden/layer2,
/obj/structure/disposalpipe/segment{
	dir = 4
	},
/turf/open/floor/catwalk_floor,
/area/station/maintenance/central/greater)
"iP" = (
/obj/structure/cable,
/obj/machinery/atmospherics/pipe/smart/manifold4w/scrubbers/hidden/layer2,
/obj/machinery/atmospherics/pipe/smart/manifold4w/supply/hidden/layer4,
/obj/structure/railing/corner,
/obj/structure/railing/corner{
	dir = 4
	},
/obj/effect/decal/cleanable/dirt,
/obj/effect/landmark/event_spawn,
/turf/open/floor/catwalk_floor,
/area/station/maintenance/central/greater)
"jr" = (
/turf/template_noop,
/area/station/maintenance/port/central)
"jX" = (
/obj/structure/ladder,
/obj/machinery/light/small/directional/west,
/obj/structure/cable,
/obj/machinery/atmospherics/pipe/smart/manifold4w/scrubbers/hidden/layer2,
/obj/machinery/atmospherics/pipe/smart/manifold4w/supply/hidden/layer4,
/obj/effect/decal/cleanable/dirt,
/turf/open/floor/catwalk_floor,
/area/station/maintenance/central/greater)
"kb" = (
/obj/effect/decal/cleanable/dirt,
/obj/structure/closet/crate,
/obj/effect/spawner/random/maintenance/three,
/obj/effect/spawner/random/engineering/tool,
/obj/effect/spawner/random/engineering/flashlight,
/turf/open/floor/iron/smooth,
/area/station/maintenance/port/central)
"lW" = (
/obj/modular_map_root/tramstation{
	key = "secservicelower_attachment_a";
	name = "secservicelower_attachment_a"
	},
/turf/open/floor/plating,
/area/station/maintenance/central/greater)
"mh" = (
/obj/structure/railing{
	dir = 4
	},
/obj/effect/turf_decal/siding/wideplating/dark{
	dir = 4
	},
/obj/effect/decal/cleanable/dirt,
/turf/open/floor/iron/smooth,
/area/station/maintenance/central/greater)
"mp" = (
/obj/effect/decal/cleanable/dirt,
/obj/structure/closet/firecloset,
/turf/open/floor/iron/smooth,
/area/station/maintenance/port/central)
"nV" = (
/obj/modular_map_root/tramstation{
	key = "secservicelower_attachment_b";
	name = "secservicelower_attachment_b"
	},
/turf/open/floor/plating,
/area/station/maintenance/central/greater)
"pq" = (
/obj/effect/decal/cleanable/dirt,
/obj/structure/disposalpipe/junction/flip{
	dir = 8
	},
/obj/machinery/atmospherics/pipe/smart/manifold4w/scrubbers/hidden/layer2,
/obj/machinery/atmospherics/pipe/smart/manifold4w/supply/hidden/layer4,
/obj/structure/cable,
/turf/open/floor/catwalk_floor,
/area/station/maintenance/port/central)
"pN" = (
/obj/structure/cable,
/turf/closed/wall,
/area/station/maintenance/central/greater)
"pW" = (
/obj/structure/cable,
/obj/effect/decal/cleanable/dirt,
/obj/machinery/atmospherics/pipe/smart/manifold4w/scrubbers/hidden/layer2,
/obj/machinery/atmospherics/pipe/smart/manifold4w/supply/hidden/layer4,
/turf/open/floor/catwalk_floor,
/area/station/maintenance/central/greater)
"pY" = (
/obj/effect/decal/cleanable/dirt,
/obj/structure/rack,
/obj/effect/spawner/random/maintenance/three,
/obj/effect/spawner/random/engineering/tool,
/turf/open/floor/iron/smooth,
/area/station/maintenance/central/greater)
"qV" = (
/turf/open/misc/asteroid,
/area/station/asteroid)
"rj" = (
/obj/effect/decal/cleanable/dirt,
/obj/structure/disposalpipe/segment{
	dir = 6
	},
/obj/machinery/atmospherics/pipe/smart/manifold4w/scrubbers/hidden/layer2,
/obj/machinery/atmospherics/pipe/smart/manifold4w/supply/hidden/layer4,
/obj/structure/cable,
/turf/open/floor/catwalk_floor,
/area/station/maintenance/port/central)
"rm" = (
/obj/effect/spawner/structure/window/reinforced,
/turf/open/floor/plating,
/area/station/maintenance/central/greater)
"rv" = (
/obj/structure/disposalpipe/segment{
	dir = 4
	},
/obj/machinery/atmospherics/pipe/smart/manifold4w/supply/hidden/layer4,
/obj/machinery/atmospherics/pipe/smart/manifold4w/scrubbers/hidden/layer2,
/obj/structure/cable,
/turf/open/floor/catwalk_floor,
/area/station/maintenance/port/central)
"rU" = (
/obj/effect/decal/cleanable/dirt,
/obj/structure/girder,
/obj/structure/grille,
/turf/open/floor/iron/smooth,
/area/station/maintenance/port/central)
"sx" = (
/obj/effect/decal/cleanable/dirt,
/obj/machinery/duct,
/turf/open/floor/catwalk_floor,
/area/station/maintenance/central/greater)
"tj" = (
/obj/effect/decal/cleanable/dirt,
/obj/machinery/light/small/directional/north,
/obj/structure/table,
/obj/item/reagent_containers/cup/bucket{
	pixel_x = -9;
	pixel_y = 12
	},
/turf/open/floor/iron/smooth,
/area/station/maintenance/central/greater)
"tZ" = (
/obj/effect/decal/cleanable/dirt,
/obj/structure/window/spawner/north,
/obj/machinery/power/apc/auto_name/directional/west,
/obj/structure/cable,
/turf/open/floor/catwalk_floor,
/area/station/maintenance/central/greater)
"uj" = (
/obj/effect/decal/cleanable/dirt,
/obj/structure/chair/stool/directional/north,
/turf/open/floor/iron/smooth,
/area/station/maintenance/port/central)
"wi" = (
/obj/effect/decal/cleanable/dirt,
/obj/machinery/power/apc/auto_name/directional/east,
/obj/structure/cable,
/turf/open/floor/catwalk_floor,
/area/station/maintenance/port/central)
"wq" = (
/obj/effect/turf_decal/stripes/white/line{
	dir = 8
	},
/obj/effect/decal/cleanable/dirt,
/turf/open/floor/plating,
/area/station/maintenance/central/greater)
"wy" = (
/obj/machinery/door/airlock/maintenance_hatch{
	name = "Water Access Maintenance Hatch"
	},
/obj/effect/mapping_helpers/airlock/access/all/service/janitor,
/obj/effect/decal/cleanable/dirt,
/obj/machinery/duct,
/turf/open/floor/catwalk_floor,
/area/station/maintenance/central/greater)
"wA" = (
/obj/effect/decal/cleanable/dirt,
/obj/structure/closet/emcloset,
/turf/open/floor/iron/smooth,
/area/station/maintenance/port/central)
"xB" = (
/obj/structure/disposalpipe/segment{
	dir = 6
	},
/obj/machinery/atmospherics/pipe/smart/manifold4w/supply/hidden/layer4,
/obj/machinery/atmospherics/pipe/smart/manifold4w/scrubbers/hidden/layer2,
/obj/effect/decal/cleanable/dirt,
/obj/structure/cable,
/turf/open/floor/catwalk_floor,
/area/station/maintenance/port/central)
"xH" = (
/obj/effect/decal/cleanable/dirt,
/obj/effect/mapping_helpers/airlock/unres{
	dir = 1
	},
/obj/effect/mapping_helpers/airlock/access/all/engineering/maintenance,
/obj/machinery/door/airlock/maintenance_hatch{
	name = "Tunnel Access Hatch"
	},
/obj/structure/disposalpipe/segment,
/obj/machinery/atmospherics/pipe/smart/manifold4w/supply/hidden/layer4,
/obj/machinery/atmospherics/pipe/smart/manifold4w/scrubbers/hidden/layer2,
/obj/structure/cable,
/obj/modular_map_connector,
/turf/open/floor/catwalk_floor,
/area/station/maintenance/port/central)
"xZ" = (
/obj/effect/decal/cleanable/dirt,
/obj/structure/disposalpipe/segment{
	dir = 9
	},
/obj/machinery/atmospherics/pipe/smart/manifold4w/scrubbers/hidden/layer2,
/obj/machinery/atmospherics/pipe/smart/manifold4w/supply/hidden/layer4,
/obj/structure/cable,
/turf/open/floor/catwalk_floor,
/area/station/maintenance/port/central)
"yp" = (
/obj/effect/decal/cleanable/dirt,
/obj/effect/spawner/random/engineering/canister,
/turf/open/floor/iron/smooth,
/area/station/maintenance/port/central)
"yC" = (
/obj/structure/disposalpipe/segment,
/turf/template_noop,
/area/template_noop)
"zq" = (
/obj/structure/cable,
/obj/machinery/atmospherics/pipe/smart/manifold4w/scrubbers/hidden/layer2,
/obj/machinery/atmospherics/pipe/smart/manifold4w/supply/hidden/layer4,
/obj/structure/railing{
	dir = 1
	},
/obj/structure/railing,
/obj/effect/decal/cleanable/dirt,
/turf/open/floor/iron/stairs/old{
	dir = 8
	},
/area/station/maintenance/central/greater)
"DC" = (
/obj/structure/cable,
/obj/effect/decal/cleanable/dirt,
/obj/machinery/atmospherics/pipe/smart/manifold4w/supply/hidden/layer4,
/obj/machinery/atmospherics/pipe/smart/manifold4w/scrubbers/hidden/layer2,
/obj/effect/landmark/blobstart,
/turf/open/floor/catwalk_floor,
/area/station/maintenance/central/greater)
"DI" = (
/obj/effect/decal/cleanable/dirt,
/turf/open/floor/iron/smooth,
/area/station/maintenance/central/greater)
"Eo" = (
/obj/structure/disposalpipe/segment{
	dir = 6
	},
/obj/structure/cable,
/obj/machinery/atmospherics/pipe/smart/manifold4w/supply/hidden/layer4,
/obj/machinery/atmospherics/pipe/smart/manifold4w/scrubbers/hidden/layer2,
/obj/effect/decal/cleanable/dirt,
/turf/open/floor/catwalk_floor,
/area/station/maintenance/port/central)
"Fa" = (
/obj/effect/decal/cleanable/dirt,
/obj/effect/spawner/random/engineering/tank,
/turf/open/floor/iron/smooth,
/area/station/maintenance/central/greater)
"Fq" = (
/obj/structure/cable,
/obj/effect/decal/cleanable/dirt,
/obj/machinery/atmospherics/pipe/smart/manifold4w/supply/hidden/layer4,
/obj/machinery/atmospherics/pipe/smart/manifold4w/scrubbers/hidden/layer2,
/obj/structure/disposalpipe/segment,
/turf/open/floor/catwalk_floor,
/area/station/maintenance/central/greater)
"FZ" = (
/obj/effect/decal/cleanable/dirt,
/obj/structure/disposalpipe/segment,
/obj/machinery/atmospherics/pipe/smart/manifold4w/supply/hidden/layer4,
/obj/machinery/atmospherics/pipe/smart/manifold4w/scrubbers/hidden/layer2,
/obj/structure/cable,
/turf/open/floor/catwalk_floor,
/area/station/maintenance/port/central)
"Hc" = (
/obj/effect/turf_decal/stripes/end{
	dir = 4
	},
/obj/machinery/atmospherics/pipe/multiz/supply/hidden/layer4{
	dir = 1
	},
/obj/machinery/atmospherics/pipe/multiz/scrubbers/hidden/layer2{
	dir = 1
	},
/obj/effect/decal/cleanable/dirt,
/turf/open/floor/plating,
/area/station/maintenance/central/greater)
"He" = (
/turf/closed/wall,
/area/station/maintenance/port/central)
"Hl" = (
/obj/effect/decal/cleanable/dirt,
/obj/structure/table,
/obj/effect/spawner/random/entertainment/cigarette_pack,
/turf/open/floor/iron/smooth,
/area/station/maintenance/port/central)
"HW" = (
/obj/effect/decal/cleanable/dirt,
/obj/machinery/plumbing/synthesizer{
	reagent_id = /datum/reagent/water
	},
/turf/open/floor/catwalk_floor,
/area/station/maintenance/central/greater)
"IO" = (
/obj/structure/disposalpipe/segment{
	dir = 9
	},
/obj/structure/cable,
/obj/machinery/atmospherics/pipe/smart/manifold4w/supply/hidden/layer4,
/obj/machinery/atmospherics/pipe/smart/manifold4w/scrubbers/hidden/layer2,
/obj/effect/decal/cleanable/dirt,
/turf/open/floor/catwalk_floor,
/area/station/maintenance/port/central)
"Ji" = (
/obj/effect/decal/cleanable/dirt,
/obj/effect/spawner/random/engineering/atmospherics_portable,
/turf/open/floor/iron/smooth,
/area/station/maintenance/port/central)
"KU" = (
/turf/closed/wall,
/area/station/maintenance/central/greater)
"La" = (
/obj/effect/decal/cleanable/dirt,
/obj/structure/chair/stool/directional/south,
/turf/open/floor/iron/smooth,
/area/station/maintenance/port/central)
"LA" = (
/obj/effect/decal/cleanable/dirt,
/obj/effect/landmark/xeno_spawn,
/turf/open/floor/iron/smooth,
/area/station/maintenance/port/central)
"LV" = (
/obj/effect/decal/cleanable/dirt,
/obj/structure/rack,
/obj/effect/spawner/random/maintenance/three,
/obj/effect/spawner/random/engineering/flashlight,
/turf/open/floor/iron/smooth,
/area/station/maintenance/port/central)
"Ms" = (
/obj/effect/decal/cleanable/dirt,
/turf/open/floor/iron/smooth,
/area/station/maintenance/port/central)
"Nn" = (
/obj/structure/disposalpipe/segment,
/obj/structure/cable,
/obj/machinery/atmospherics/pipe/smart/manifold4w/supply/hidden/layer4,
/obj/machinery/atmospherics/pipe/smart/manifold4w/scrubbers/hidden/layer2,
/obj/effect/decal/cleanable/dirt,
/turf/open/floor/catwalk_floor,
/area/station/maintenance/port/central)
"NC" = (
/obj/structure/railing{
	dir = 4
	},
/obj/effect/turf_decal/siding/wideplating/dark{
	dir = 4
	},
/obj/structure/table,
/obj/effect/decal/cleanable/dirt,
/obj/item/stack/cable_coil,
/obj/item/multitool,
/turf/open/floor/iron/smooth,
/area/station/maintenance/central/greater)
"NE" = (
/obj/structure/disposalpipe/segment{
	dir = 5
	},
/turf/template_noop,
/area/template_noop)
"NH" = (
/obj/effect/spawner/structure/window/reinforced,
/turf/open/floor/plating,
/area/station/maintenance/port/central)
"PV" = (
/obj/structure/cable,
/obj/machinery/atmospherics/pipe/smart/manifold4w/scrubbers/hidden/layer2,
/obj/machinery/atmospherics/pipe/smart/manifold4w/supply/hidden/layer4,
/obj/effect/decal/cleanable/dirt,
/turf/open/floor/catwalk_floor,
/area/station/maintenance/central/greater)
"TD" = (
/obj/effect/decal/cleanable/dirt,
/obj/structure/disposalpipe/segment{
	dir = 4
	},
/obj/machinery/atmospherics/pipe/smart/manifold4w/scrubbers/hidden/layer2,
/obj/machinery/atmospherics/pipe/smart/manifold4w/supply/hidden/layer4,
/obj/structure/cable,
/turf/open/floor/catwalk_floor,
/area/station/maintenance/port/central)
"TT" = (
/obj/structure/cable,
/obj/effect/decal/cleanable/dirt,
/obj/machinery/atmospherics/pipe/smart/manifold4w/supply/hidden/layer4,
/obj/machinery/atmospherics/pipe/smart/manifold4w/scrubbers/hidden/layer2,
/obj/structure/disposalpipe/segment{
	dir = 6
	},
/turf/open/floor/catwalk_floor,
/area/station/maintenance/central/greater)
"Ue" = (
/obj/structure/cable,
/obj/effect/decal/cleanable/dirt,
/obj/machinery/atmospherics/pipe/smart/manifold4w/supply/hidden/layer4,
/obj/machinery/atmospherics/pipe/smart/manifold4w/scrubbers/hidden/layer2,
/turf/open/floor/catwalk_floor,
/area/station/maintenance/central/greater)
"Ul" = (
/obj/effect/decal/cleanable/dirt,
/obj/structure/closet,
/obj/effect/spawner/random/maintenance/four,
/obj/effect/spawner/random/engineering/material_cheap,
/turf/open/floor/iron/smooth,
/area/station/maintenance/port/central)
"Vf" = (
/obj/structure/cable,
/obj/effect/decal/cleanable/dirt,
/obj/machinery/atmospherics/pipe/smart/manifold4w/supply/hidden/layer4,
/obj/machinery/atmospherics/pipe/smart/manifold4w/scrubbers/hidden/layer2,
/obj/structure/disposalpipe/segment{
	dir = 10
	},
/turf/open/floor/catwalk_floor,
/area/station/maintenance/central/greater)
"VY" = (
/turf/template_noop,
/area/template_noop)
"XE" = (
/obj/structure/disposalpipe/segment{
	dir = 4
	},
/obj/machinery/atmospherics/pipe/smart/manifold4w/supply/hidden/layer4,
/obj/machinery/atmospherics/pipe/smart/manifold4w/scrubbers/hidden/layer2,
/obj/effect/decal/cleanable/dirt,
/obj/structure/cable,
/turf/open/floor/catwalk_floor,
/area/station/maintenance/port/central)
"Yd" = (
/obj/modular_map_root/tramstation{
	key = "secservicelower_attachment_c";
	name = "secservicelower_attachment_c"
	},
/turf/open/floor/plating,
/area/station/maintenance/port/central)
"Zg" = (
/obj/structure/disposalpipe/segment,
/obj/structure/cable,
/obj/machinery/atmospherics/pipe/smart/manifold4w/supply/hidden/layer4,
/obj/machinery/atmospherics/pipe/smart/manifold4w/scrubbers/hidden/layer2,
/obj/effect/decal/cleanable/dirt,
/obj/effect/landmark/event_spawn,
/turf/open/floor/catwalk_floor,
/area/station/maintenance/port/central)
"ZO" = (
/obj/structure/disposalpipe/segment{
	dir = 4
	},
/obj/structure/cable,
/obj/machinery/atmospherics/pipe/smart/manifold4w/supply/hidden/layer4,
/obj/machinery/atmospherics/pipe/smart/manifold4w/scrubbers/hidden/layer2,
/obj/effect/decal/cleanable/dirt,
/turf/open/floor/catwalk_floor,
/area/station/maintenance/port/central)

(1,1,1) = {"
VY
VY
VY
VY
VY
VY
VY
VY
VY
VY
VY
VY
VY
VY
VY
VY
VY
VY
VY
VY
ek
ek
ek
ek
ek
ek
ek
ek
ek
ek
ek
ek
ek
ek
ek
ek
VY
VY
VY
VY
He
He
VY
VY
VY
VY
VY
VY
"}
(2,1,1) = {"
VY
VY
VY
VY
VY
VY
VY
VY
VY
VY
VY
VY
VY
VY
VY
VY
VY
VY
VY
VY
VY
VY
VY
VY
VY
VY
VY
VY
ek
ek
ek
ek
ek
ek
ek
ek
ek
ek
ek
ek
He
Ms
VY
VY
VY
VY
VY
VY
"}
(3,1,1) = {"
VY
VY
VY
VY
VY
VY
VY
VY
VY
VY
VY
VY
VY
VY
VY
VY
VY
VY
VY
VY
VY
VY
VY
VY
VY
VY
VY
VY
ek
ek
ek
ek
ek
ek
ek
ek
ek
ek
ek
ek
He
xB
VY
VY
VY
VY
VY
VY
"}
(4,1,1) = {"
VY
VY
VY
VY
VY
VY
VY
VY
VY
VY
VY
VY
VY
VY
VY
VY
VY
VY
VY
VY
VY
VY
VY
VY
VY
VY
VY
VY
ek
ek
ek
ek
ek
ek
ek
ek
ek
ek
ek
ek
He
XE
VY
VY
VY
VY
VY
VY
"}
(5,1,1) = {"
VY
VY
VY
VY
VY
VY
VY
VY
VY
VY
VY
VY
VY
VY
VY
VY
VY
VY
VY
VY
VY
VY
VY
VY
VY
VY
VY
VY
ek
ek
ek
ek
ek
ek
ek
ek
ek
ek
ek
ek
He
rv
VY
VY
VY
VY
VY
VY
"}
(6,1,1) = {"
VY
VY
VY
VY
VY
VY
VY
VY
VY
VY
VY
VY
VY
VY
VY
VY
VY
VY
VY
VY
VY
VY
VY
VY
VY
VY
VY
VY
ek
ek
ek
ek
ek
ek
ek
ek
ek
ek
ek
ek
He
TD
He
ek
ek
ek
VY
VY
"}
(7,1,1) = {"
VY
VY
VY
VY
VY
VY
VY
VY
VY
VY
VY
VY
VY
VY
VY
VY
VY
VY
VY
VY
VY
VY
VY
VY
VY
ek
ek
ek
ek
ek
ek
ek
ek
ek
ek
ek
ek
ek
ek
ek
He
TD
He
ek
ek
ek
VY
VY
"}
(8,1,1) = {"
VY
VY
VY
VY
VY
VY
VY
VY
VY
VY
VY
VY
VY
VY
VY
VY
VY
VY
VY
VY
VY
VY
VY
VY
VY
ek
ek
ek
ek
ek
ek
ek
ek
ek
ek
ek
ek
ek
ek
ek
He
TD
He
ek
ek
ek
VY
VY
"}
(9,1,1) = {"
VY
VY
VY
VY
VY
VY
VY
VY
VY
VY
VY
VY
VY
VY
VY
VY
VY
VY
VY
VY
VY
VY
VY
VY
VY
VY
VY
VY
VY
ek
ek
ek
ek
ek
ek
ek
ek
ek
He
He
He
TD
He
He
He
He
VY
VY
"}
(10,1,1) = {"
VY
VY
VY
VY
VY
VY
VY
VY
VY
VY
VY
VY
VY
VY
VY
VY
VY
VY
VY
VY
VY
VY
VY
VY
VY
VY
VY
VY
VY
ek
ek
ek
ek
ek
ek
ek
ek
ek
Yd
Ms
Ms
pq
FZ
FZ
FZ
FZ
FZ
xH
"}
(11,1,1) = {"
VY
VY
VY
VY
VY
VY
VY
VY
VY
VY
VY
VY
VY
VY
VY
VY
VY
VY
VY
VY
VY
VY
VY
VY
VY
VY
VY
VY
VY
ek
ek
ek
ek
ek
ek
ek
ek
ek
He
rj
hi
xZ
fL
Ul
kb
Ms
wi
He
"}
(12,1,1) = {"
VY
VY
VY
VY
VY
VY
VY
VY
VY
VY
VY
VY
VY
VY
VY
VY
VY
VY
VY
VY
VY
VY
VY
VY
VY
VY
VY
VY
VY
ek
ek
ek
ek
ek
ek
ek
ek
ek
He
TD
VY
VY
VY
VY
VY
VY
VY
VY
"}
(13,1,1) = {"
VY
VY
VY
VY
VY
VY
VY
VY
VY
VY
VY
VY
VY
VY
VY
VY
VY
VY
VY
VY
VY
VY
VY
VY
VY
VY
VY
VY
VY
ek
ek
ek
ek
ek
ek
ek
ek
He
He
TD
VY
VY
VY
VY
VY
VY
VY
VY
"}
(14,1,1) = {"
VY
VY
VY
VY
VY
VY
VY
VY
VY
VY
VY
VY
VY
VY
VY
VY
VY
VY
VY
VY
VY
VY
VY
VY
VY
VY
VY
VY
VY
ek
ek
ek
ek
ek
VY
VY
VY
VY
Ms
TD
VY
VY
VY
VY
VY
VY
VY
VY
"}
(15,1,1) = {"
VY
VY
VY
VY
VY
VY
VY
VY
VY
VY
VY
VY
VY
VY
VY
VY
VY
VY
VY
VY
VY
VY
VY
VY
VY
VY
VY
VY
VY
VY
VY
VY
VY
VY
VY
VY
VY
VY
Ms
TD
VY
VY
VY
VY
VY
VY
VY
VY
"}
(16,1,1) = {"
VY
VY
VY
VY
VY
VY
VY
VY
VY
VY
VY
VY
VY
VY
VY
VY
VY
VY
VY
VY
VY
VY
VY
VY
VY
VY
VY
VY
VY
VY
VY
VY
VY
VY
VY
VY
VY
VY
VY
TD
VY
VY
VY
VY
VY
VY
VY
VY
"}
(17,1,1) = {"
VY
VY
VY
VY
VY
VY
VY
VY
VY
VY
VY
VY
VY
VY
VY
VY
VY
VY
VY
VY
VY
VY
VY
VY
VY
VY
VY
VY
VY
VY
VY
VY
VY
VY
VY
VY
VY
VY
VY
TD
VY
VY
VY
VY
VY
VY
VY
VY
"}
(18,1,1) = {"
VY
VY
VY
VY
VY
VY
VY
VY
VY
VY
VY
VY
VY
VY
VY
VY
VY
VY
VY
VY
VY
VY
VY
VY
VY
VY
VY
VY
VY
VY
VY
VY
VY
VY
VY
VY
VY
VY
VY
TD
VY
VY
VY
VY
VY
VY
VY
VY
"}
(19,1,1) = {"
VY
VY
VY
VY
VY
VY
VY
VY
VY
VY
VY
VY
VY
VY
VY
VY
VY
VY
VY
VY
VY
VY
VY
VY
VY
VY
VY
VY
VY
VY
VY
VY
VY
VY
VY
VY
VY
VY
VY
TD
VY
VY
VY
VY
VY
VY
VY
VY
"}
(20,1,1) = {"
VY
VY
VY
VY
VY
VY
VY
VY
VY
VY
VY
VY
VY
VY
VY
VY
VY
VY
VY
VY
VY
VY
VY
VY
VY
VY
VY
VY
VY
VY
VY
VY
VY
VY
VY
VY
VY
VY
VY
TD
VY
VY
VY
VY
VY
VY
VY
VY
"}
(21,1,1) = {"
VY
VY
VY
VY
VY
VY
VY
VY
VY
VY
VY
VY
VY
VY
VY
VY
VY
VY
VY
VY
VY
VY
VY
VY
VY
VY
VY
VY
jr
jr
jr
jr
jr
jr
jr
VY
VY
VY
Ms
TD
VY
VY
VY
VY
VY
VY
VY
VY
"}
(22,1,1) = {"
VY
VY
VY
VY
VY
VY
VY
VY
VY
VY
VY
VY
VY
VY
VY
VY
VY
VY
VY
VY
VY
VY
VY
VY
VY
VY
VY
VY
jr
yp
Ji
rU
mp
wA
jr
jr
jr
jr
Ms
TD
VY
VY
VY
VY
VY
VY
VY
VY
"}
(23,1,1) = {"
VY
VY
VY
VY
VY
VY
VY
VY
VY
VY
VY
VY
VY
VY
VY
VY
VY
VY
VY
VY
VY
VY
VY
VY
VY
VY
VY
VY
jr
ZO
Nn
Nn
Nn
aW
Nn
Zg
Nn
Nn
Nn
gN
VY
VY
VY
VY
VY
VY
VY
VY
"}
(24,1,1) = {"
VY
VY
VY
VY
VY
VY
VY
VY
VY
VY
VY
VY
VY
VY
VY
VY
VY
VY
VY
VY
VY
VY
VY
VY
VY
VY
VY
VY
jr
ZO
Ms
Ms
Ms
Ms
La
Hl
uj
Ms
Ms
He
VY
VY
VY
VY
VY
VY
VY
VY
"}
(25,1,1) = {"
VY
VY
VY
VY
VY
VY
VY
VY
VY
VY
VY
VY
VY
VY
VY
VY
VY
VY
VY
VY
VY
VY
VY
VY
ek
ek
ek
He
Ms
ZO
He
He
He
NH
NH
NH
NH
He
He
He
ek
ek
VY
VY
VY
VY
VY
VY
"}
(26,1,1) = {"
VY
VY
VY
VY
VY
VY
VY
VY
VY
VY
VY
VY
VY
VY
VY
VY
VY
VY
VY
VY
VY
VY
VY
VY
ek
ek
ek
He
hd
ZO
He
ek
qV
qV
qV
qV
qV
qV
qV
ek
ek
ek
VY
VY
VY
VY
VY
VY
"}
(27,1,1) = {"
VY
VY
VY
VY
VY
VY
VY
VY
VY
VY
VY
VY
VY
VY
VY
VY
VY
VY
VY
VY
VY
VY
ek
ek
ek
ek
ek
He
LA
ZO
He
qV
qV
qV
qV
qV
qV
qV
qV
ek
ek
ek
ek
ek
ek
ek
VY
VY
"}
(28,1,1) = {"
VY
VY
VY
VY
VY
VY
VY
VY
VY
VY
VY
VY
VY
VY
VY
VY
VY
VY
VY
VY
VY
VY
VY
VY
VY
VY
VY
VY
jr
ZO
He
qV
qV
qV
qV
qV
qV
qV
qV
qV
ek
ek
ek
qV
qV
ek
VY
VY
"}
(29,1,1) = {"
VY
VY
VY
VY
VY
VY
VY
VY
VY
VY
VY
VY
VY
VY
VY
VY
VY
VY
VY
VY
VY
VY
VY
VY
VY
VY
VY
VY
jr
ZO
He
qV
qV
qV
qV
qV
qV
qV
qV
qV
ek
qV
qV
qV
qV
ek
VY
VY
"}
(30,1,1) = {"
VY
VY
VY
VY
VY
VY
VY
VY
VY
VY
VY
VY
VY
VY
VY
VY
VY
VY
VY
VY
VY
VY
VY
VY
VY
VY
VY
VY
jr
ZO
He
ek
qV
qV
qV
qV
qV
ek
ek
qV
qV
qV
ek
ek
ek
ek
VY
VY
"}
(31,1,1) = {"
VY
VY
VY
VY
VY
VY
VY
VY
VY
VY
VY
VY
VY
VY
VY
VY
VY
VY
VY
VY
VY
VY
VY
VY
VY
VY
VY
VY
jr
ZO
He
ek
qV
qV
qV
qV
ek
ek
qV
qV
qV
ek
ek
ek
ek
ek
VY
VY
"}
(32,1,1) = {"
VY
VY
VY
VY
VY
VY
VY
VY
VY
VY
VY
VY
VY
VY
VY
VY
VY
VY
VY
VY
VY
VY
VY
VY
VY
VY
VY
VY
jr
ZO
He
ek
qV
qV
qV
qV
qV
ek
qV
qV
qV
ek
ek
VY
VY
VY
VY
VY
"}
(33,1,1) = {"
VY
VY
VY
VY
VY
VY
VY
VY
VY
VY
VY
VY
VY
VY
VY
VY
VY
VY
VY
VY
VY
VY
jr
jr
jr
jr
jr
jr
jr
ZO
He
ek
qV
ek
qV
qV
qV
qV
qV
qV
qV
ek
ek
VY
VY
VY
VY
VY
"}
(34,1,1) = {"
pN
Ue
Ue
Ue
Ue
VY
VY
VY
VY
VY
VY
VY
VY
VY
VY
VY
VY
VY
VY
VY
VY
VY
Ms
Eo
Nn
Nn
Nn
Nn
Nn
IO
He
ek
ek
ek
ek
qV
qV
qV
qV
qV
qV
ek
ek
VY
VY
VY
VY
VY
"}
(35,1,1) = {"
KU
KU
KU
KU
Ue
VY
VY
VY
VY
VY
VY
VY
VY
VY
VY
VY
VY
VY
VY
VY
VY
VY
jr
ZO
He
He
He
He
He
He
He
ek
ek
ek
ek
ek
qV
qV
qV
qV
ek
ek
ek
VY
VY
VY
VY
VY
"}
(36,1,1) = {"
ek
ek
ek
KU
Ue
Ue
Ue
Ue
Ue
Ue
Ue
Ue
DC
KU
ek
ek
VY
VY
VY
VY
VY
VY
jr
ZO
He
ek
ek
ek
ek
ek
ek
ek
ek
ek
qV
qV
qV
qV
qV
ek
ek
ek
ek
VY
VY
VY
VY
VY
"}
(37,1,1) = {"
ek
ek
ek
KU
KU
KU
KU
KU
KU
KU
KU
KU
Ue
KU
ek
ek
VY
VY
VY
VY
VY
VY
jr
ZO
He
ek
ek
ek
ek
ek
qV
ek
ek
ek
qV
qV
qV
qV
qV
ek
ek
ek
ek
VY
VY
VY
VY
VY
"}
(38,1,1) = {"
ek
ek
ek
ek
ek
ek
ek
ek
ek
ek
ek
lW
Ue
KU
ek
ek
VY
VY
VY
VY
VY
VY
jr
ZO
He
ek
ek
ek
ek
ek
qV
ek
qV
qV
qV
qV
qV
qV
qV
qV
ek
ek
ek
VY
VY
VY
VY
VY
"}
(39,1,1) = {"
ek
ek
ek
ek
ek
ek
ek
qV
ek
ek
ek
KU
Ue
KU
ek
ek
VY
VY
VY
VY
VY
VY
jr
ZO
He
ek
ek
ek
ek
qV
qV
qV
qV
qV
qV
qV
qV
qV
qV
qV
ek
ek
ek
VY
VY
VY
VY
VY
"}
(40,1,1) = {"
ek
ek
ek
ek
ek
ek
ek
qV
ek
ek
ek
KU
Ue
KU
He
He
jr
jr
VY
VY
VY
jr
jr
ZO
He
ek
ek
qV
qV
qV
qV
qV
qV
qV
qV
qV
qV
qV
qV
qV
qV
ek
ek
VY
VY
VY
VY
VY
"}
(41,1,1) = {"
ek
qV
ek
ek
ek
ek
qV
qV
ek
ek
ek
KU
Ue
KU
Ji
LV
Ms
jr
jr
jr
jr
jr
Eo
ap
He
ek
ek
qV
qV
qV
qV
qV
qV
qV
ek
qV
qV
qV
qV
qV
qV
ek
ek
VY
VY
VY
VY
VY
"}
(42,1,1) = {"
ek
qV
qV
ek
ek
ek
qV
qV
ek
qV
qV
KU
TT
Nn
Nn
Nn
Nn
Nn
Nn
Nn
Nn
Nn
IO
He
He
ek
ek
ek
qV
qV
qV
qV
qV
ek
ek
qV
qV
qV
ek
ek
qV
ek
ek
VY
VY
VY
VY
VY
"}
(43,1,1) = {"
ek
ek
qV
ek
qV
qV
qV
qV
qV
qV
qV
KU
iy
KU
He
He
He
He
He
He
He
He
He
He
ek
ek
ek
qV
qV
qV
qV
ek
ek
ek
ek
ek
qV
qV
ek
ek
qV
qV
ek
VY
VY
VY
VY
VY
"}
(44,1,1) = {"
ek
qV
qV
qV
qV
qV
qV
qV
qV
qV
qV
KU
iy
KU
qV
qV
ek
qV
qV
qV
ek
ek
ek
qV
qV
qV
qV
qV
qV
qV
qV
qV
qV
ek
qV
qV
qV
qV
ek
ek
qV
qV
ek
VY
VY
VY
VY
VY
"}
(45,1,1) = {"
ek
ek
qV
qV
qV
qV
qV
qV
qV
qV
qV
rm
iy
rm
qV
qV
qV
qV
qV
qV
qV
qV
qV
qV
qV
qV
qV
qV
qV
qV
qV
qV
qV
qV
qV
qV
qV
ek
ek
ek
qV
qV
ek
VY
VY
VY
VY
VY
"}
(46,1,1) = {"
ek
ek
qV
qV
qV
qV
qV
qV
qV
qV
qV
rm
iy
rm
qV
qV
qV
qV
qV
qV
qV
qV
qV
qV
qV
qV
qV
qV
qV
qV
qV
qV
qV
qV
qV
qV
qV
ek
ek
ek
qV
qV
ek
VY
VY
VY
VY
VY
"}
(47,1,1) = {"
ek
ek
qV
qV
qV
qV
qV
qV
qV
qV
qV
rm
iy
rm
qV
qV
qV
qV
qV
qV
qV
qV
qV
qV
qV
qV
qV
qV
qV
qV
qV
qV
ek
qV
qV
qV
qV
qV
ek
ek
ek
qV
ek
VY
VY
VY
VY
VY
"}
(48,1,1) = {"
ek
qV
qV
qV
qV
qV
ek
qV
qV
qV
qV
rm
iy
rm
qV
qV
qV
qV
qV
qV
ek
qV
qV
qV
qV
qV
ek
ek
qV
qV
qV
qV
ek
ek
ek
qV
qV
qV
ek
ek
ek
ek
ek
VY
VY
VY
VY
VY
"}
(49,1,1) = {"
ek
qV
qV
qV
qV
ek
ek
ek
qV
qV
qV
KU
iy
KU
qV
VY
VY
VY
VY
VY
ek
ek
qV
qV
ek
ek
ek
ek
ek
ek
ek
ek
ek
ek
ek
ek
qV
qV
qV
ek
ek
ek
ek
VY
VY
VY
VY
VY
"}
(50,1,1) = {"
ek
ek
qV
ek
ek
ek
ek
ek
ek
qV
qV
KU
iy
KU
ek
VY
VY
VY
VY
VY
ek
ek
qV
ek
ek
ek
KU
KU
KU
KU
KU
KU
KU
ek
ek
ek
qV
qV
qV
ek
ek
ek
ek
VY
VY
VY
VY
VY
"}
(51,1,1) = {"
ek
ek
ek
ek
ek
ek
ek
ek
qV
qV
qV
KU
iy
KU
KU
VY
VY
VY
VY
VY
KU
KU
KU
KU
KU
nV
KU
DI
hb
jX
Hc
DI
KU
ek
ek
qV
qV
qV
ek
ek
ek
ek
ek
VY
VY
VY
VY
VY
"}
(52,1,1) = {"
ek
ek
ek
ek
ek
ek
ek
ek
ek
ek
ek
KU
Vf
Fq
Fq
yC
yC
NE
VY
VY
pW
pW
pW
pW
pW
pW
KU
hz
DI
PV
DI
DI
KU
ek
qV
qV
qV
qV
ek
ek
ek
ek
ek
VY
VY
VY
VY
VY
"}
(53,1,1) = {"
ek
ek
ek
ek
ek
ek
ek
ek
ek
ek
ek
KU
KU
DI
KU
VY
VY
VY
VY
VY
VY
VY
VY
VY
VY
pW
KU
NC
mh
iP
mh
mh
KU
ek
qV
qV
qV
ek
ek
ek
ek
ek
ek
VY
VY
VY
VY
VY
"}
(54,1,1) = {"
VY
VY
VY
VY
VY
VY
VY
VY
VY
VY
VY
VY
VY
VY
VY
VY
VY
VY
VY
VY
VY
VY
VY
VY
VY
pW
KU
wq
wq
zq
wq
wq
KU
KU
KU
KU
KU
KU
ek
ek
ek
ek
ek
VY
VY
VY
VY
VY
"}
(55,1,1) = {"
VY
VY
VY
VY
VY
VY
VY
VY
VY
VY
VY
VY
VY
VY
VY
VY
VY
VY
VY
VY
VY
VY
VY
VY
VY
pW
pW
pW
pW
pW
pW
pW
pW
cw
Fa
pY
tZ
VY
VY
VY
VY
VY
VY
VY
VY
VY
VY
VY
"}
(56,1,1) = {"
VY
VY
VY
VY
VY
VY
VY
VY
VY
VY
VY
VY
VY
VY
VY
VY
VY
VY
VY
VY
VY
VY
VY
VY
VY
VY
VY
VY
VY
KU
KU
KU
KU
pW
cz
cz
cz
VY
VY
VY
VY
VY
VY
VY
VY
VY
VY
VY
"}
(57,1,1) = {"
VY
VY
VY
VY
VY
VY
VY
VY
VY
VY
VY
VY
VY
VY
VY
VY
VY
VY
VY
VY
VY
VY
VY
VY
VY
VY
VY
VY
VY
KU
HW
sx
KU
pW
VY
VY
VY
VY
VY
VY
VY
VY
VY
VY
VY
VY
VY
VY
"}
(58,1,1) = {"
VY
VY
VY
VY
VY
VY
VY
VY
VY
VY
VY
VY
VY
VY
VY
VY
VY
VY
VY
VY
VY
VY
VY
VY
VY
VY
VY
VY
VY
KU
tj
sx
KU
pW
VY
VY
VY
VY
VY
VY
VY
VY
VY
VY
VY
VY
VY
VY
"}
(59,1,1) = {"
VY
VY
VY
VY
VY
VY
VY
VY
VY
VY
VY
VY
VY
VY
VY
VY
VY
VY
VY
VY
VY
VY
VY
VY
VY
VY
VY
VY
VY
KU
fs
sx
KU
pW
VY
VY
VY
VY
VY
VY
VY
VY
VY
VY
VY
VY
VY
VY
"}
(60,1,1) = {"
VY
VY
VY
VY
VY
VY
VY
VY
VY
VY
VY
VY
VY
VY
VY
VY
VY
VY
VY
VY
VY
VY
VY
VY
VY
VY
VY
VY
VY
KU
gU
sx
wy
gt
VY
VY
VY
VY
VY
VY
VY
VY
VY
VY
VY
VY
VY
VY
"}
(61,1,1) = {"
VY
VY
VY
VY
VY
VY
VY
VY
VY
VY
VY
VY
VY
VY
VY
VY
VY
VY
VY
VY
VY
VY
VY
VY
VY
VY
VY
VY
VY
VY
VY
VY
VY
gt
VY
VY
VY
VY
VY
VY
VY
VY
VY
VY
VY
VY
VY
VY
"}
(62,1,1) = {"
VY
VY
VY
VY
VY
VY
VY
VY
VY
VY
VY
VY
VY
VY
VY
VY
VY
VY
VY
VY
VY
VY
VY
VY
VY
VY
VY
VY
VY
VY
VY
VY
VY
gt
VY
VY
VY
VY
VY
VY
VY
VY
VY
VY
VY
VY
VY
VY
"}
(63,1,1) = {"
VY
VY
VY
VY
VY
VY
VY
VY
VY
VY
VY
VY
VY
VY
VY
VY
VY
VY
VY
VY
VY
VY
VY
VY
VY
VY
VY
VY
VY
VY
VY
VY
VY
im
VY
VY
VY
VY
VY
VY
VY
VY
VY
VY
VY
VY
VY
VY
"}
