//MAP CONVERTED BY dmm2tgm.py THIS HEADER COMMENT PREVENTS RECONVERSION, DO NOT REMOVE
"bj" = (
/turf/open/misc/asteroid,
/area/station/asteroid)
"bs" = (
/obj/effect/decal/cleanable/dirt,
/obj/structure/closet/crate,
/obj/effect/spawner/random/engineering/toolbox,
/obj/effect/spawner/random/engineering/flashlight,
/obj/effect/spawner/random/maintenance/three,
/turf/open/floor/iron/smooth,
/area/station/maintenance/starboard/greater)
"cD" = (
/obj/item/assembly/mousetrap/armed,
/obj/structure/railing,
/obj/effect/turf_decal/siding/wideplating/dark,
/obj/effect/decal/cleanable/dirt,
/turf/open/floor/iron/smooth,
/area/station/maintenance/starboard/greater)
"cL" = (
/obj/modular_map_connector,
/turf/template_noop,
/area/template_noop)
"cV" = (
/turf/open/misc/asteroid/airless,
/area/station/asteroid)
"dN" = (
/obj/effect/spawner/structure/window,
/turf/open/floor/plating,
/area/station/maintenance/starboard/greater)
"eB" = (
/obj/effect/turf_decal/stripes/white/line{
	dir = 1
	},
/obj/effect/decal/cleanable/dirt,
/turf/open/floor/plating,
/area/station/maintenance/starboard/greater)
"eQ" = (
/obj/machinery/atmospherics/pipe/smart/manifold4w/supply/hidden/layer4,
/obj/effect/decal/cleanable/dirt,
/obj/structure/cable,
/turf/open/floor/catwalk_floor,
/area/station/maintenance/starboard/greater)
"fX" = (
/turf/template_noop,
/area/template_noop)
"gt" = (
/obj/structure/railing,
/obj/effect/turf_decal/siding/wideplating/dark,
/obj/effect/decal/cleanable/dirt,
/turf/open/floor/iron/smooth,
/area/station/maintenance/starboard/greater)
"gN" = (
/obj/effect/decal/cleanable/dirt,
/obj/machinery/atmospherics/pipe/smart/manifold4w/supply/hidden/layer4,
/obj/machinery/atmospherics/pipe/smart/manifold4w/scrubbers/hidden/layer2,
/obj/structure/cable,
/obj/machinery/door/poddoor/preopen{
	id = "freevbucks4u"
	},
/turf/open/floor/catwalk_floor,
/area/station/maintenance/starboard/greater)
"hD" = (
/obj/structure/cable,
/obj/effect/decal/cleanable/dirt,
/obj/machinery/atmospherics/pipe/smart/manifold4w/supply/hidden/layer4,
/obj/machinery/atmospherics/pipe/smart/manifold4w/scrubbers/hidden/layer2,
/obj/machinery/door/poddoor/preopen{
	id = "freevbucks4u"
	},
/turf/open/floor/catwalk_floor,
/area/station/maintenance/starboard/greater)
"ja" = (
/obj/effect/turf_decal/sand/plating,
/obj/structure/cable/layer1,
/turf/open/floor/plating/airless,
/area/station/asteroid)
"jk" = (
/obj/structure/falsewall,
/obj/effect/decal/cleanable/dirt,
/turf/open/floor/plating,
/area/station/maintenance/starboard/greater)
"jJ" = (
/obj/effect/decal/cleanable/dirt,
/obj/structure/table,
/turf/open/floor/iron/smooth,
/area/station/maintenance/starboard/greater)
"jK" = (
/turf/template_noop,
/area/station/maintenance/starboard/greater)
"jP" = (
/obj/effect/decal/cleanable/dirt,
/obj/structure/grille,
/turf/open/floor/iron/smooth,
/area/station/maintenance/starboard/greater)
"kS" = (
/obj/item/shovel,
/turf/open/misc/asteroid,
/area/station/asteroid)
"le" = (
/obj/effect/decal/cleanable/dirt,
/obj/effect/spawner/random/engineering/tank,
/turf/open/floor/iron/smooth,
/area/station/maintenance/starboard/greater)
"lp" = (
/obj/effect/decal/cleanable/dirt,
/obj/structure/cable/layer1,
/turf/open/floor/catwalk_floor,
/area/station/maintenance/starboard/greater)
"mq" = (
/obj/item/stack/ore/iron,
/turf/open/misc/asteroid,
/area/station/asteroid)
"nb" = (
/obj/effect/turf_decal/stripes/end,
/obj/machinery/atmospherics/pipe/multiz/scrubbers/hidden/layer2{
	dir = 4
	},
/obj/machinery/atmospherics/pipe/multiz/supply/hidden/layer4{
	dir = 4
	},
/obj/effect/decal/cleanable/dirt,
/turf/open/floor/plating,
/area/station/maintenance/starboard/greater)
"ob" = (
/obj/effect/decal/cleanable/dirt,
/obj/machinery/light/small/directional/west,
/turf/open/floor/iron/smooth,
/area/station/maintenance/starboard/greater)
"om" = (
/obj/structure/cable,
/obj/machinery/atmospherics/pipe/smart/manifold4w/supply/hidden/layer4,
/obj/machinery/atmospherics/pipe/smart/manifold4w/scrubbers/hidden/layer2,
/obj/structure/ladder,
/obj/machinery/light/small/directional/north,
/obj/effect/decal/cleanable/dirt,
/turf/open/floor/catwalk_floor,
/area/station/maintenance/starboard/greater)
"oT" = (
/obj/effect/turf_decal/sand/plating,
/turf/open/floor/plating/airless,
/area/station/asteroid)
"oV" = (
/obj/effect/decal/cleanable/dirt,
/obj/machinery/button/door/directional/west{
	id = "freevbucks4u";
	name = "Blast Door Toggle"
	},
/turf/open/floor/iron/smooth,
/area/station/maintenance/starboard/greater)
"pJ" = (
/obj/effect/decal/cleanable/dirt,
/obj/structure/table,
/obj/effect/spawner/random/decoration/ornament,
/turf/open/floor/iron/smooth,
/area/station/maintenance/starboard/greater)
"rw" = (
/obj/effect/decal/cleanable/dirt,
/obj/machinery/door/airlock/maintenance_hatch{
	name = "Maintenance Hatch"
	},
/obj/effect/mapping_helpers/airlock/access/all/engineering/maintenance,
/turf/open/floor/iron/smooth,
/area/station/maintenance/starboard/greater)
"sj" = (
/turf/closed/wall,
/area/station/maintenance/starboard/greater)
"tx" = (
/obj/effect/decal/cleanable/dirt,
/obj/effect/spawner/random/engineering/material_cheap,
/obj/structure/closet/crate,
/obj/effect/spawner/random/engineering/tool,
/obj/effect/spawner/random/maintenance/four,
/turf/open/floor/iron/smooth,
/area/station/maintenance/starboard/greater)
"uK" = (
/obj/effect/decal/cleanable/dirt,
/obj/machinery/atmospherics/pipe/smart/manifold4w/supply/hidden/layer4,
/obj/machinery/atmospherics/pipe/smart/manifold4w/scrubbers/hidden/layer2,
/obj/structure/cable,
/turf/open/floor/catwalk_floor,
/area/station/maintenance/starboard/greater)
"vZ" = (
/obj/effect/decal/cleanable/dirt,
/obj/effect/spawner/random/engineering/atmospherics_portable,
/turf/open/floor/iron/smooth,
/area/station/maintenance/starboard/greater)
"wx" = (
/obj/effect/decal/cleanable/dirt,
/obj/machinery/button/door/directional/east{
	name = "Blast Door Toggle";
	id = "freevbucks4u"
	},
/turf/open/floor/iron/smooth,
/area/station/maintenance/starboard/greater)
"wF" = (
/obj/effect/decal/cleanable/dirt,
/obj/structure/rack,
/obj/effect/spawner/random/maintenance/four,
/obj/effect/decal/cleanable/cobweb,
/turf/open/floor/iron/smooth,
/area/station/maintenance/starboard/greater)
"xv" = (
/obj/effect/decal/cleanable/dirt,
/obj/effect/spawner/random/trash/bin,
/turf/open/floor/iron/smooth,
/area/station/maintenance/starboard/greater)
"Ag" = (
/obj/effect/decal/cleanable/dirt,
/obj/structure/chair/stool/directional/south,
/turf/open/floor/iron/smooth,
/area/station/maintenance/starboard/greater)
"Al" = (
/obj/modular_map_root/tramstation{
	key = "servicecargolower_attachment_a";
	name = "servicecargolower_attachment_a"
	},
/turf/open/floor/plating,
/area/station/maintenance/starboard/greater)
"Br" = (
/obj/machinery/atmospherics/pipe/smart/manifold4w/supply/hidden/layer4,
/obj/structure/cable,
/obj/machinery/atmospherics/pipe/smart/manifold4w/scrubbers/hidden/layer2,
/obj/effect/decal/cleanable/dirt,
/turf/open/floor/catwalk_floor,
/area/station/maintenance/starboard/greater)
"Cn" = (
/obj/item/stack/cable_coil,
/turf/open/misc/asteroid/airless,
/area/station/asteroid)
"Ex" = (
/obj/effect/decal/cleanable/dirt,
/obj/structure/closet/firecloset,
/turf/open/floor/iron/smooth,
/area/station/maintenance/starboard/greater)
"EZ" = (
/obj/effect/decal/cleanable/dirt,
/obj/effect/spawner/random/engineering/canister,
/turf/open/floor/iron/smooth,
/area/station/maintenance/starboard/greater)
"Fo" = (
/obj/machinery/atmospherics/components/unary/vent_pump/on/layer4{
	dir = 4
	},
/obj/effect/decal/cleanable/dirt,
/turf/open/floor/iron/smooth,
/area/station/maintenance/starboard/greater)
"Gg" = (
/obj/structure/cable,
/obj/machinery/atmospherics/pipe/smart/manifold4w/supply/hidden/layer4,
/obj/machinery/atmospherics/pipe/smart/manifold4w/scrubbers/hidden/layer2,
/obj/structure/railing{
	dir = 4
	},
/obj/structure/railing{
	dir = 8
	},
/obj/effect/decal/cleanable/dirt,
/turf/open/floor/iron/stairs/old,
/area/station/maintenance/starboard/greater)
"GQ" = (
/obj/effect/decal/cleanable/dirt,
/obj/structure/cable,
/turf/open/floor/catwalk_floor,
/area/station/maintenance/starboard/greater)
"Hb" = (
/obj/effect/decal/cleanable/dirt,
/obj/machinery/atmospherics/pipe/smart/manifold4w/supply/hidden/layer4,
/obj/structure/cable,
/turf/open/floor/catwalk_floor,
/area/station/maintenance/starboard/greater)
"Hy" = (
/obj/effect/decal/cleanable/dirt,
/obj/structure/sign/warning/vacuum/external/directional/north,
/turf/open/floor/iron/smooth,
/area/station/maintenance/starboard/greater)
"HQ" = (
/obj/structure/cable/multilayer/multiz,
/obj/effect/turf_decal/stripes/end,
/obj/structure/sign/warning/electric_shock/directional/north,
/obj/effect/decal/cleanable/dirt,
/turf/open/floor/plating,
/area/station/maintenance/starboard/greater)
"Ip" = (
/obj/structure/cable,
/obj/effect/decal/cleanable/dirt,
/obj/machinery/atmospherics/pipe/smart/manifold4w/supply/hidden/layer4,
/obj/machinery/atmospherics/pipe/smart/manifold4w/scrubbers/hidden/layer2,
/turf/open/floor/catwalk_floor,
/area/station/maintenance/starboard/greater)
"JH" = (
/obj/structure/cable,
/obj/machinery/atmospherics/pipe/smart/manifold4w/supply/hidden/layer4,
/obj/machinery/atmospherics/pipe/smart/manifold4w/scrubbers/hidden/layer2,
/obj/structure/railing/corner,
/obj/structure/railing/corner{
	dir = 8
	},
/obj/effect/decal/cleanable/dirt,
/turf/open/floor/catwalk_floor,
/area/station/maintenance/starboard/greater)
"LD" = (
/obj/effect/decal/cleanable/dirt,
/obj/structure/girder,
/turf/open/floor/iron/smooth,
/area/station/maintenance/starboard/greater)
"LM" = (
/obj/effect/decal/cleanable/dirt,
/obj/effect/spawner/random/trash/moisture_trap,
/turf/open/floor/iron/smooth,
/area/station/maintenance/starboard/greater)
"MG" = (
/obj/effect/decal/cleanable/dirt,
/obj/structure/cable,
/obj/machinery/power/apc/auto_name/directional/south,
/turf/open/floor/catwalk_floor,
/area/station/maintenance/starboard/greater)
"NJ" = (
/obj/structure/girder,
/obj/effect/decal/cleanable/dirt,
/turf/open/floor/plating,
/area/station/maintenance/starboard/greater)
"NN" = (
/obj/modular_map_root/tramstation{
	key = "servicecargolower_attachment_b";
	name = "servicecargolower_attachment_b"
	},
/turf/open/floor/plating,
/area/station/maintenance/starboard/greater)
"Pe" = (
/obj/effect/decal/cleanable/dirt,
/obj/structure/closet/cardboard,
/obj/effect/spawner/random/maintenance/five,
/turf/open/floor/iron/smooth,
/area/station/maintenance/starboard/greater)
"PC" = (
/obj/effect/decal/cleanable/dirt,
/obj/structure/cable/multilayer/connected,
/turf/open/floor/catwalk_floor,
/area/station/maintenance/starboard/greater)
"QZ" = (
/obj/effect/turf_decal/sand/plating,
/turf/open/floor/plating,
/area/station/asteroid)
"Rk" = (
/turf/closed/mineral/random/stationside/asteroid/porus,
/area/station/asteroid)
"RQ" = (
/obj/effect/decal/cleanable/dirt,
/obj/effect/decal/cleanable/cobweb/cobweb2,
/turf/open/floor/iron/smooth,
/area/station/maintenance/starboard/greater)
"ST" = (
/obj/item/stack/ore/glass,
/obj/item/relic,
/turf/open/misc/asteroid/dug,
/area/station/asteroid)
"Ui" = (
/obj/effect/decal/cleanable/dirt,
/obj/effect/spawner/random/trash/garbage,
/turf/open/floor/iron/smooth,
/area/station/maintenance/starboard/greater)
"Uj" = (
/obj/machinery/door/airlock/external{
	name = "External Access"
	},
/obj/effect/mapping_helpers/airlock/cyclelink_helper,
/obj/effect/decal/cleanable/dirt,
/obj/structure/cable/layer1,
/obj/effect/mapping_helpers/airlock/access/all/engineering/external,
/turf/open/floor/catwalk_floor,
/area/station/maintenance/starboard/greater)
"UB" = (
/obj/effect/decal/cleanable/dirt,
/obj/machinery/atmospherics/pipe/smart/manifold4w/scrubbers/hidden/layer2,
/obj/machinery/atmospherics/pipe/smart/manifold4w/supply/hidden/layer4,
/obj/structure/cable,
/turf/open/floor/catwalk_floor,
/area/station/maintenance/starboard/greater)
"VQ" = (
/obj/effect/decal/cleanable/dirt,
/turf/open/floor/iron/smooth,
/area/station/maintenance/starboard/greater)
"Xg" = (
/obj/effect/decal/cleanable/dirt,
/obj/structure/closet/emcloset,
/turf/open/floor/iron/smooth,
/area/station/maintenance/starboard/greater)
"XB" = (
/obj/machinery/door/airlock/external{
	name = "External Access"
	},
/obj/effect/mapping_helpers/airlock/cyclelink_helper{
	dir = 1
	},
/obj/machinery/atmospherics/pipe/smart/manifold4w/supply/hidden/layer4,
/obj/effect/decal/cleanable/dirt,
/obj/structure/cable,
/obj/effect/mapping_helpers/airlock/access/all/engineering/external,
/turf/open/floor/catwalk_floor,
/area/station/maintenance/starboard/greater)
"YP" = (
/obj/effect/decal/cleanable/dirt,
/obj/effect/spawner/random/trash/cigbutt,
/turf/open/floor/iron/smooth,
/area/station/maintenance/starboard/greater)

(1,1,1) = {"
fX
fX
fX
fX
fX
fX
fX
fX
cL
fX
fX
fX
fX
fX
fX
fX
fX
fX
fX
fX
fX
fX
fX
fX
"}
(2,1,1) = {"
fX
fX
fX
fX
fX
fX
fX
VQ
Ip
sj
Rk
Rk
fX
fX
fX
fX
fX
fX
fX
fX
fX
fX
fX
fX
"}
(3,1,1) = {"
fX
fX
fX
fX
fX
fX
fX
VQ
Ip
sj
Rk
Rk
fX
fX
fX
fX
fX
fX
fX
fX
fX
fX
fX
fX
"}
(4,1,1) = {"
fX
fX
fX
fX
fX
fX
fX
jP
Ip
sj
sj
sj
fX
fX
fX
fX
fX
fX
fX
fX
fX
fX
fX
fX
"}
(5,1,1) = {"
fX
fX
fX
fX
fX
fX
fX
le
Ip
Ip
Ip
Ip
fX
fX
fX
fX
fX
fX
fX
fX
fX
fX
fX
fX
"}
(6,1,1) = {"
fX
Rk
Rk
Rk
Rk
Rk
sj
sj
sj
sj
sj
Ip
fX
fX
fX
fX
fX
fX
fX
fX
fX
fX
fX
fX
"}
(7,1,1) = {"
Rk
Rk
Rk
Rk
Rk
Rk
Rk
Rk
Rk
Rk
Al
Ip
fX
fX
fX
fX
fX
fX
fX
fX
fX
fX
fX
fX
"}
(8,1,1) = {"
Rk
Rk
Rk
Rk
Rk
Rk
Rk
Rk
Rk
Rk
sj
Ip
sj
sj
Rk
Rk
Rk
fX
fX
fX
fX
fX
fX
fX
"}
(9,1,1) = {"
Rk
Rk
Rk
Rk
Rk
Rk
Rk
Rk
Rk
Rk
sj
Ip
LM
sj
Rk
Rk
Rk
fX
fX
fX
fX
fX
fX
fX
"}
(10,1,1) = {"
Rk
Rk
Rk
Rk
Rk
Rk
Rk
Rk
Rk
Rk
sj
Ip
Ex
sj
Rk
Rk
Rk
fX
fX
fX
fX
fX
fX
fX
"}
(11,1,1) = {"
Rk
Rk
Rk
Rk
Rk
Rk
Rk
Rk
Rk
Rk
sj
hD
dN
sj
sj
Rk
Rk
fX
fX
fX
fX
fX
fX
fX
"}
(12,1,1) = {"
Rk
Rk
Rk
Rk
Rk
Rk
Rk
Rk
Rk
Rk
sj
Ip
VQ
oV
sj
Rk
Rk
fX
fX
fX
fX
fX
fX
fX
"}
(13,1,1) = {"
Rk
Rk
Rk
Rk
Rk
Rk
Rk
Rk
Rk
Rk
sj
Ip
VQ
VQ
sj
Rk
Rk
fX
fX
fX
fX
fX
fX
fX
"}
(14,1,1) = {"
Rk
Rk
Rk
Rk
Rk
Rk
Rk
Rk
Rk
Rk
sj
Ip
VQ
VQ
sj
Rk
Rk
fX
fX
fX
fX
fX
fX
fX
"}
(15,1,1) = {"
Rk
Rk
Rk
Rk
Rk
Rk
Rk
Rk
Rk
Rk
sj
Ip
VQ
VQ
sj
Rk
Rk
fX
fX
fX
fX
fX
fX
fX
"}
(16,1,1) = {"
Rk
Rk
Rk
Rk
Rk
Rk
Rk
Rk
Rk
Rk
sj
Ip
dN
bs
sj
Rk
Rk
fX
fX
fX
fX
fX
fX
fX
"}
(17,1,1) = {"
Rk
Rk
Rk
Rk
Rk
Rk
Rk
sj
sj
sj
sj
Ip
NJ
LD
sj
Rk
Rk
fX
fX
fX
fX
fX
fX
fX
"}
(18,1,1) = {"
Rk
Rk
Rk
Rk
Rk
Rk
Rk
sj
VQ
gt
eB
Ip
dN
tx
sj
Rk
Rk
fX
fX
fX
fX
fX
fX
fX
"}
(19,1,1) = {"
Rk
Rk
Rk
Rk
Rk
Rk
Rk
sj
nb
gt
eB
Ip
VQ
VQ
sj
Rk
Rk
fX
fX
fX
fX
fX
fX
fX
"}
(20,1,1) = {"
Rk
Rk
Rk
Rk
Rk
Rk
Rk
sj
om
JH
Gg
Br
GQ
MG
sj
Rk
Rk
fX
fX
fX
fX
fX
fX
fX
"}
(21,1,1) = {"
Rk
Rk
Rk
Rk
Rk
Rk
Rk
sj
HQ
cD
eB
Ip
VQ
Ui
sj
Rk
Rk
fX
fX
fX
fX
fX
fX
fX
"}
(22,1,1) = {"
Rk
Rk
Rk
Rk
Rk
Rk
Rk
sj
RQ
gt
eB
uK
VQ
wx
sj
Rk
Rk
fX
fX
fX
fX
fX
fX
fX
"}
(23,1,1) = {"
Rk
Rk
Rk
Rk
Rk
Rk
Rk
sj
sj
sj
sj
gN
dN
sj
sj
Rk
Rk
fX
fX
fX
fX
fX
fX
fX
"}
(24,1,1) = {"
Rk
Rk
Rk
Rk
cV
cV
Rk
Rk
Rk
sj
EZ
uK
VQ
Xg
sj
Rk
Rk
fX
fX
fX
fX
fX
fX
fX
"}
(25,1,1) = {"
Rk
Rk
Rk
cV
cV
cV
sj
sj
sj
sj
vZ
UB
VQ
VQ
sj
Rk
Rk
fX
fX
fX
fX
fX
fX
fX
"}
(26,1,1) = {"
Rk
Rk
Rk
cV
cV
cV
sj
ob
Fo
sj
Hy
UB
VQ
sj
sj
Rk
Rk
fX
fX
fX
fX
fX
fX
fX
"}
(27,1,1) = {"
Rk
Rk
Rk
cV
ja
ja
Uj
lp
eQ
XB
Hb
UB
sj
sj
Rk
Rk
Rk
fX
fX
fX
fX
fX
fX
fX
"}
(28,1,1) = {"
Rk
cV
cV
cV
oT
cV
sj
PC
GQ
sj
VQ
UB
sj
Rk
Rk
Rk
Rk
fX
fX
fX
fX
fX
fX
fX
"}
(29,1,1) = {"
Cn
oT
oT
oT
oT
cV
sj
sj
sj
sj
sj
UB
sj
Rk
Rk
Rk
Rk
fX
fX
fX
fX
fX
fX
fX
"}
(30,1,1) = {"
cV
oT
cV
cV
cV
Rk
sj
wF
VQ
xv
sj
UB
sj
Rk
Rk
Rk
Rk
fX
fX
fX
fX
fX
fX
fX
"}
(31,1,1) = {"
oT
oT
cV
cV
Rk
Rk
sj
VQ
VQ
pJ
dN
UB
NN
Rk
Rk
Rk
Rk
fX
fX
fX
fX
fX
fX
fX
"}
(32,1,1) = {"
cV
cV
Rk
cV
Rk
Rk
sj
VQ
Ag
jJ
dN
UB
sj
Rk
Rk
Rk
Rk
fX
fX
fX
fX
fX
fX
fX
"}
(33,1,1) = {"
Rk
Rk
Rk
Rk
Rk
Rk
sj
YP
VQ
VQ
rw
UB
sj
Rk
Rk
Rk
Rk
fX
fX
fX
fX
fX
fX
fX
"}
(34,1,1) = {"
Rk
Rk
Rk
fX
fX
fX
jK
jK
sj
sj
sj
UB
fX
fX
fX
fX
fX
fX
fX
kS
Rk
fX
fX
fX
"}
(35,1,1) = {"
Rk
Rk
Rk
fX
fX
fX
fX
fX
Rk
Rk
sj
UB
fX
fX
fX
fX
fX
fX
fX
ST
mq
fX
fX
fX
"}
(36,1,1) = {"
Rk
Rk
Rk
fX
fX
fX
fX
fX
Rk
Rk
sj
UB
fX
fX
fX
fX
fX
fX
fX
bj
bj
fX
fX
fX
"}
(37,1,1) = {"
fX
fX
fX
fX
fX
fX
fX
fX
fX
fX
fX
UB
fX
fX
fX
fX
fX
fX
fX
bj
Rk
fX
fX
fX
"}
(38,1,1) = {"
fX
fX
fX
fX
fX
fX
fX
fX
fX
fX
fX
UB
fX
fX
fX
fX
fX
fX
fX
QZ
Rk
Rk
fX
fX
"}
(39,1,1) = {"
fX
fX
fX
fX
fX
fX
fX
fX
fX
fX
fX
UB
fX
fX
fX
fX
fX
fX
fX
QZ
QZ
Rk
Rk
fX
"}
(40,1,1) = {"
fX
fX
fX
fX
fX
fX
fX
fX
fX
fX
fX
UB
UB
UB
fX
fX
fX
fX
fX
jk
sj
sj
Rk
fX
"}
(41,1,1) = {"
fX
fX
fX
fX
fX
fX
fX
fX
fX
fX
fX
fX
fX
UB
fX
fX
fX
fX
fX
Pe
VQ
sj
Rk
fX
"}
(42,1,1) = {"
fX
fX
fX
fX
fX
fX
fX
fX
fX
fX
fX
fX
fX
UB
UB
VQ
VQ
VQ
VQ
VQ
VQ
sj
sj
fX
"}
(43,1,1) = {"
fX
fX
fX
fX
fX
fX
fX
fX
fX
fX
fX
fX
fX
fX
UB
fX
fX
fX
fX
fX
VQ
VQ
VQ
fX
"}
(44,1,1) = {"
fX
fX
fX
fX
fX
fX
fX
fX
fX
fX
fX
fX
fX
fX
fX
fX
fX
fX
fX
fX
fX
fX
fX
fX
"}
