//MAP CONVERTED BY dmm2tgm.py THIS HEADER COMMENT PREVENTS RECONVERSION, DO NOT REMOVE 
"a" = (
/turf/template_noop,
/area/template_noop)
"b" = (
/turf/open/floor/plating/asteroid/basalt/lava_land_surface,
/area/lavaland/surface/outdoors)
"c" = (
/obj/structure/lattice,
/turf/open/floor/plating/asteroid/basalt/lava_land_surface,
/area/lavaland/surface/outdoors)
"d" = (
/turf/closed/wall{
	baseturf = /turf/open/floor/plating/asteroid/basalt/lava_land_surface
	},
/area/ruin/unpowered)
"e" = (
/obj/effect/decal/cleanable/dirt,
/turf/open/floor/plating{
	baseturf = /turf/open/floor/plating/asteroid/basalt/lava_land_surface;
	initial_gas_mix = "o2=14;n2=23;TEMP=300"
	},
/area/ruin/unpowered)
"f" = (
/obj/structure/table/wood,
/obj/item/weapon/storage/box/cups,
/turf/open/floor/wood{
	baseturf = /turf/open/floor/plating/asteroid/basalt/lava_land_surface;
	initial_gas_mix = "o2=14;n2=23;TEMP=300"
	},
/area/ruin/unpowered)
"g" = (
/obj/structure/reagent_dispensers/water_cooler{
	name = "punch cooler";
	reagent_id = "bacchus_blessing"
	},
/obj/effect/decal/cleanable/dirt,
/turf/open/floor/wood{
	baseturf = /turf/open/floor/plating/asteroid/basalt/lava_land_surface;
	initial_gas_mix = "o2=14;n2=23;TEMP=300"
	},
/area/ruin/unpowered)
"h" = (
/obj/effect/decal/cleanable/dirt,
/turf/open/floor/wood{
	baseturf = /turf/open/floor/plating/asteroid/basalt/lava_land_surface;
	initial_gas_mix = "o2=14;n2=23;TEMP=300"
	},
/area/ruin/unpowered)
"i" = (
/obj/effect/decal/cleanable/dirt,
/obj/effect/decal/cleanable/dirt,
/turf/open/floor/wood{
	baseturf = /turf/open/floor/plating/asteroid/basalt/lava_land_surface;
	initial_gas_mix = "o2=14;n2=23;TEMP=300"
	},
/area/ruin/unpowered)
"j" = (
/obj/item/weapon/reagent_containers/food/snacks/pizzaslice/mushroom,
/obj/effect/decal/cleanable/dirt,
/turf/open/floor/plating{
	baseturf = /turf/open/floor/plating/asteroid/basalt/lava_land_surface;
	initial_gas_mix = "o2=14;n2=23;TEMP=300"
	},
/area/ruin/unpowered)
"k" = (
/obj/structure/table/wood,
/obj/effect/spawner/lootdrop{
	loot = list(/obj/item/pizzabox/margherita = 3, /obj/item/pizzabox/meat = 3, /obj/item/pizzabox/mushroom = 3, /obj/item/pizzabox/bomb = 1);
	lootdoubles = 0;
	name = "pizza spawner"
	},
/obj/effect/decal/cleanable/dirt,
/turf/open/floor/wood{
	baseturf = /turf/open/floor/plating/asteroid/basalt/lava_land_surface;
	initial_gas_mix = "o2=14;n2=23;TEMP=300"
	},
/area/ruin/unpowered)
"l" = (
/obj/machinery/light{
	dir = 4;
	icon_state = "tube1"
	},
/obj/structure/table/wood,
/obj/effect/spawner/lootdrop{
	loot = list(/obj/item/pizzabox/margherita = 3, /obj/item/pizzabox/meat = 3, /obj/item/pizzabox/mushroom = 3, /obj/item/pizzabox/bomb = 1);
	lootdoubles = 0;
	name = "pizza spawner"
	},
/obj/effect/decal/cleanable/dirt,
/obj/effect/decal/cleanable/cobweb/cobweb2,
/turf/open/floor/wood{
	baseturf = /turf/open/floor/plating/asteroid/basalt/lava_land_surface;
	initial_gas_mix = "o2=14;n2=23;TEMP=300"
	},
/area/ruin/unpowered)
"m" = (
/obj/item/chair/wood/wings,
/obj/effect/decal/cleanable/dirt,
/turf/open/floor/plating{
	baseturf = /turf/open/floor/plating/asteroid/basalt/lava_land_surface;
	initial_gas_mix = "o2=14;n2=23;TEMP=300"
	},
/area/ruin/unpowered)
"n" = (
/obj/structure/glowshroom/single,
/obj/effect/decal/cleanable/dirt,
/turf/open/floor/wood{
	baseturf = /turf/open/floor/plating/asteroid/basalt/lava_land_surface;
	initial_gas_mix = "o2=14;n2=23;TEMP=300"
	},
/area/ruin/unpowered)
"o" = (
/obj/item/trash/plate,
/obj/effect/decal/cleanable/dirt,
/turf/open/floor/wood{
	baseturf = /turf/open/floor/plating/asteroid/basalt/lava_land_surface;
	initial_gas_mix = "o2=14;n2=23;TEMP=300"
	},
/area/ruin/unpowered)
"p" = (
/obj/effect/decal/remains/human,
/obj/effect/decal/cleanable/dirt,
/turf/open/floor/wood{
	baseturf = /turf/open/floor/plating/asteroid/basalt/lava_land_surface;
	initial_gas_mix = "o2=14;n2=23;TEMP=300"
	},
/area/ruin/unpowered)
"q" = (
/obj/item/chair/wood/wings,
/obj/effect/decal/cleanable/dirt,
/turf/open/floor/wood{
	baseturf = /turf/open/floor/plating/asteroid/basalt/lava_land_surface;
	initial_gas_mix = "o2=14;n2=23;TEMP=300"
	},
/area/ruin/unpowered)
"r" = (
/obj/structure/chair/wood/wings,
/obj/effect/decal/remains/human,
/obj/item/clothing/head/festive{
	desc = "A festive party hat with the name 'timmy' scribbled on the front.";
	name = "party hat"
	},
/turf/open/floor/wood{
	baseturf = /turf/open/floor/plating/asteroid/basalt/lava_land_surface;
	initial_gas_mix = "o2=14;n2=23;TEMP=300"
	},
/area/ruin/unpowered)
"s" = (
/turf/open/floor/wood{
	baseturf = /turf/open/floor/plating/asteroid/basalt/lava_land_surface;
	initial_gas_mix = "o2=14;n2=23;TEMP=300"
	},
/area/ruin/unpowered)
"t" = (
/obj/structure/chair/wood/wings,
/obj/effect/decal/remains/human,
/turf/open/floor/wood{
	baseturf = /turf/open/floor/plating/asteroid/basalt/lava_land_surface;
	initial_gas_mix = "o2=14;n2=23;TEMP=300"
	},
/area/ruin/unpowered)
"u" = (
/obj/structure/glowshroom/single,
/turf/open/floor/wood{
	baseturf = /turf/open/floor/plating/asteroid/basalt/lava_land_surface;
	initial_gas_mix = "o2=14;n2=23;TEMP=300"
	},
/area/ruin/unpowered)
"v" = (
/obj/structure/lattice,
/obj/item/chair/wood/wings,
/turf/open/floor/plating/asteroid/basalt/lava_land_surface,
/area/lavaland/surface/outdoors)
"w" = (
/obj/item/weapon/kitchen/fork,
/obj/effect/decal/cleanable/dirt,
/turf/open/floor/wood{
	baseturf = /turf/open/floor/plating/asteroid/basalt/lava_land_surface;
	initial_gas_mix = "o2=14;n2=23;TEMP=300"
	},
/area/ruin/unpowered)
"x" = (
/obj/structure/table/wood,
/obj/effect/spawner/lootdrop{
	loot = list(/obj/item/pizzabox/margherita = 3, /obj/item/pizzabox/meat = 3, /obj/item/pizzabox/mushroom = 3, /obj/item/pizzabox/bomb = 1);
	lootdoubles = 0;
	name = "pizza spawner"
	},
/turf/open/floor/wood{
	baseturf = /turf/open/floor/plating/asteroid/basalt/lava_land_surface;
	initial_gas_mix = "o2=14;n2=23;TEMP=300"
	},
/area/ruin/unpowered)
"y" = (
/obj/structure/table/wood,
/obj/item/trash/plate,
/turf/open/floor/wood{
	baseturf = /turf/open/floor/plating/asteroid/basalt/lava_land_surface;
	initial_gas_mix = "o2=14;n2=23;TEMP=300"
	},
/area/ruin/unpowered)
"z" = (
/obj/structure/table/wood,
/obj/structure/glowshroom/single,
/obj/item/weapon/a_gift,
/turf/open/floor/wood{
	baseturf = /turf/open/floor/plating/asteroid/basalt/lava_land_surface;
	initial_gas_mix = "o2=14;n2=23;TEMP=300"
	},
/area/ruin/unpowered)
"A" = (
/obj/structure/table/wood,
/obj/item/trash/plate,
/obj/item/weapon/kitchen/fork,
/turf/open/floor/wood{
	baseturf = /turf/open/floor/plating/asteroid/basalt/lava_land_surface;
	initial_gas_mix = "o2=14;n2=23;TEMP=300"
	},
/area/ruin/unpowered)
"B" = (
/obj/structure/lattice,
/obj/effect/decal/cleanable/dirt,
/turf/open/floor/plating/asteroid/basalt/lava_land_surface,
/area/space)
"C" = (
/obj/structure/chair/wood/wings{
	tag = "icon-wooden_chair_wings (EAST)";
	icon_state = "wooden_chair_wings";
	dir = 4
	},
/obj/effect/decal/cleanable/dirt,
/turf/open/floor/plating{
	baseturf = /turf/open/floor/plating/asteroid/basalt/lava_land_surface;
	initial_gas_mix = "o2=14;n2=23;TEMP=300"
	},
/area/ruin/unpowered)
"D" = (
/obj/structure/table/wood,
/obj/item/weapon/reagent_containers/food/snacks/pizzaslice/margherita,
/obj/item/trash/plate,
/turf/open/floor/wood{
	baseturf = /turf/open/floor/plating/asteroid/basalt/lava_land_surface;
	initial_gas_mix = "o2=14;n2=23;TEMP=300"
	},
/area/ruin/unpowered)
"E" = (
/obj/structure/table/wood,
/obj/item/weapon/reagent_containers/food/snacks/pizzaslice/meat,
/turf/open/floor/wood{
	baseturf = /turf/open/floor/plating/asteroid/basalt/lava_land_surface;
	initial_gas_mix = "o2=14;n2=23;TEMP=300"
	},
/area/ruin/unpowered)
"F" = (
/obj/structure/table/wood,
/obj/item/weapon/reagent_containers/food/snacks/store/cake/birthday,
/turf/open/floor/wood{
	baseturf = /turf/open/floor/plating/asteroid/basalt/lava_land_surface;
	initial_gas_mix = "o2=14;n2=23;TEMP=300"
	},
/area/ruin/unpowered)
"G" = (
/obj/structure/table/wood,
/turf/open/floor/wood{
	baseturf = /turf/open/floor/plating/asteroid/basalt/lava_land_surface;
	initial_gas_mix = "o2=14;n2=23;TEMP=300"
	},
/area/ruin/unpowered)
"H" = (
/obj/item/chair/wood/wings,
/turf/open/floor/wood{
	baseturf = /turf/open/floor/plating/asteroid/basalt/lava_land_surface;
	initial_gas_mix = "o2=14;n2=23;TEMP=300"
	},
/area/ruin/unpowered)
"I" = (
/obj/item/weapon/kitchen/fork,
/obj/effect/decal/cleanable/dirt,
/turf/open/floor/plating{
	baseturf = /turf/open/floor/plating/asteroid/basalt/lava_land_surface;
	initial_gas_mix = "o2=14;n2=23;TEMP=300"
	},
/area/ruin/unpowered)
"J" = (
/obj/structure/glowshroom/single,
/obj/effect/decal/cleanable/dirt,
/turf/open/floor/plating{
	baseturf = /turf/open/floor/plating/asteroid/basalt/lava_land_surface;
	initial_gas_mix = "o2=14;n2=23;TEMP=300"
	},
/area/ruin/unpowered)
"K" = (
/obj/structure/chair/wood/wings{
	tag = "icon-wooden_chair_wings (NORTH)";
	icon_state = "wooden_chair_wings";
	dir = 1
	},
/obj/effect/decal/remains/human,
/obj/effect/decal/cleanable/dirt,
/turf/open/floor/wood{
	baseturf = /turf/open/floor/plating/asteroid/basalt/lava_land_surface;
	initial_gas_mix = "o2=14;n2=23;TEMP=300"
	},
/area/ruin/unpowered)
"L" = (
/obj/effect/decal/cleanable/dirt,
/obj/effect/decal/cleanable/dirt,
/turf/open/floor/plating{
	baseturf = /turf/open/floor/plating/asteroid/basalt/lava_land_surface;
	initial_gas_mix = "o2=14;n2=23;TEMP=300"
	},
/area/ruin/unpowered)
"M" = (
/obj/effect/decal/cleanable/dirt,
/obj/item/weapon/a_gift,
/turf/open/floor/wood{
	baseturf = /turf/open/floor/plating/asteroid/basalt/lava_land_surface;
	initial_gas_mix = "o2=14;n2=23;TEMP=300"
	},
/area/ruin/unpowered)
"N" = (
/obj/structure/lattice,
/obj/effect/decal/cleanable/dirt,
/turf/open/floor/plating/asteroid/basalt/lava_land_surface,
/area/lavaland/surface/outdoors)
"O" = (
/obj/item/weapon/kitchen/knife,
/obj/effect/decal/cleanable/dirt,
/turf/open/floor/wood{
	baseturf = /turf/open/floor/plating/asteroid/basalt/lava_land_surface;
	initial_gas_mix = "o2=14;n2=23;TEMP=300"
	},
/area/ruin/unpowered)
"P" = (
/obj/machinery/light{
	dir = 4;
	icon_state = "tube1"
	},
/obj/effect/decal/cleanable/dirt,
/turf/open/floor/wood{
	baseturf = /turf/open/floor/plating/asteroid/basalt/lava_land_surface;
	initial_gas_mix = "o2=14;n2=23;TEMP=300"
	},
/area/ruin/unpowered)
"Q" = (
/turf/open/floor/plating{
	baseturf = /turf/open/floor/plating/asteroid/basalt/lava_land_surface;
	initial_gas_mix = "o2=14;n2=23;TEMP=300"
	},
/area/ruin/unpowered)

(1,1,1) = {"
a
a
a
a
a
a
a
a
a
a
a
a
a
a
a
a
a
a
a
a
"}
(2,1,1) = {"
a
a
a
b
b
a
a
b
b
b
b
b
b
b
b
a
a
a
a
a
"}
(3,1,1) = {"
a
b
b
b
b
b
b
b
b
b
b
c
c
b
b
b
b
a
a
a
"}
(4,1,1) = {"
a
b
b
b
b
b
b
b
b
c
c
e
e
c
c
b
b
b
a
a
"}
(5,1,1) = {"
a
b
b
b
b
d
b
c
c
e
h
h
e
Q
e
d
b
b
a
a
"}
(6,1,1) = {"
a
a
b
b
b
d
b
m
e
w
h
w
h
h
e
d
b
b
b
a
"}
(7,1,1) = {"
a
a
b
b
b
d
f
n
h
h
c
e
M
e
c
b
b
b
b
a
"}
(8,1,1) = {"
a
b
b
b
b
d
g
o
h
h
C
J
h
d
b
b
b
b
b
a
"}
(9,1,1) = {"
a
b
b
b
b
e
h
p
q
x
D
K
M
d
b
b
b
b
b
a
"}
(10,1,1) = {"
a
b
b
b
c
e
i
h
r
y
E
h
h
c
b
b
b
b
b
a
"}
(11,1,1) = {"
a
b
b
b
c
e
j
h
s
z
F
q
N
c
b
b
b
b
b
a
"}
(12,1,1) = {"
a
b
b
b
b
e
e
h
t
A
G
q
h
c
b
b
b
b
b
a
"}
(13,1,1) = {"
a
b
b
b
b
d
k
h
s
s
H
h
O
d
b
b
b
b
b
a
"}
(14,1,1) = {"
a
b
b
b
b
d
k
h
u
s
s
o
n
d
b
b
b
b
a
a
"}
(15,1,1) = {"
a
b
b
b
b
d
l
i
h
e
I
L
P
d
b
b
b
b
a
a
"}
(16,1,1) = {"
a
b
b
b
b
d
d
e
e
N
e
e
d
d
b
b
b
b
a
a
"}
(17,1,1) = {"
a
a
b
b
b
b
b
c
v
b
c
b
b
b
b
b
b
b
a
a
"}
(18,1,1) = {"
a
a
b
b
b
b
b
b
b
b
b
b
b
b
b
b
a
a
a
a
"}
(19,1,1) = {"
a
a
a
a
a
b
b
b
b
b
b
b
b
a
a
a
a
a
a
a
"}
(20,1,1) = {"
a
a
a
a
a
a
a
a
a
a
a
a
a
a
a
a
a
a
a
a
"}
