//MAP CONVERTED BY dmm2tgm.py THIS HEADER COMMENT PREVENTS RECONVERSION, DO NOT REMOVE 
"aa" = (
/turf/template_noop,
/area/template_noop)
"ad" = (
/obj/structure/flora/ausbushes/leafybush,
/turf/open/floor/plating/beach/sand,
/area/ruin/powered/beach)
"ae" = (
/obj/structure/table,
/obj/item/storage/toolbox/mechanical,
/obj/item/stack/cable_coil,
/turf/open/floor/plating,
/area/ruin/powered/beach)
"af" = (
/obj/structure/table,
/obj/item/clothing/mask/gas,
/obj/machinery/light/small{
	dir = 1
	},
/turf/open/floor/plating,
/area/ruin/powered/beach)
"ag" = (
/obj/structure/reagent_dispensers/fueltank,
/turf/open/floor/plating,
/area/ruin/powered/beach)
"ah" = (
/obj/machinery/power/smes,
/turf/open/floor/plating,
/area/ruin/powered/beach)
"ai" = (
/obj/machinery/portable_atmospherics/canister/oxygen,
/turf/open/floor/plating,
/area/ruin/powered/beach)
"aj" = (
/turf/closed/wall/mineral/sandstone,
/area/ruin/powered/beach)
"ak" = (
/obj/structure/toilet,
/obj/effect/turf_decal/sand,
/turf/open/floor/plating,
/area/ruin/powered/beach)
"al" = (
/obj/structure/urinal{
	pixel_y = 32
	},
/turf/open/floor/plating,
/area/ruin/powered/beach)
"am" = (
/obj/structure/urinal{
	pixel_y = 32
	},
/obj/effect/turf_decal/sand,
/turf/open/floor/plating,
/area/ruin/powered/beach)
"an" = (
/obj/item/device/flashlight/lantern,
/obj/machinery/light/small{
	dir = 1
	},
/turf/open/floor/plating,
/area/ruin/powered/beach)
"ao" = (
/obj/structure/sink{
	dir = 4;
	pixel_x = 11
	},
/obj/effect/turf_decal/sand,
/obj/structure/mirror{
	pixel_x = 28
	},
/turf/open/floor/plating,
/area/ruin/powered/beach)
"ap" = (
/obj/structure/flora/ausbushes/sparsegrass,
/turf/open/floor/plating/beach/sand,
/area/ruin/powered/beach)
"aq" = (
/obj/structure/flora/ausbushes/sunnybush,
/turf/open/floor/plating/beach/sand,
/area/ruin/powered/beach)
"ar" = (
/turf/open/floor/plating/beach/sand,
/area/ruin/powered/beach)
"as" = (
/turf/open/floor/plating,
/area/ruin/powered/beach)
"at" = (
/obj/item/tank/internals/oxygen,
/turf/open/floor/plating,
/area/ruin/powered/beach)
"au" = (
/obj/effect/turf_decal/sand,
/turf/open/floor/plating,
/area/ruin/powered/beach)
"av" = (
/obj/machinery/door/airlock/hatch,
/turf/open/floor/plating,
/area/ruin/powered/beach)
"aw" = (
/obj/machinery/door/airlock/sandstone,
/turf/open/floor/wood,
/area/ruin/powered/beach)
"ax" = (
/obj/structure/extinguisher_cabinet,
/turf/closed/wall/mineral/sandstone,
/area/ruin/powered/beach)
"ay" = (
/obj/machinery/door/airlock/hatch,
/obj/effect/turf_decal/sand,
/turf/open/floor/plating,
/area/ruin/powered/beach)
"az" = (
/obj/item/clothing/neck/necklace/dope,
/obj/item/reagent_containers/spray/spraytan,
/turf/open/floor/plating/beach/sand,
/area/ruin/powered/beach)
"aA" = (
/obj/effect/turf_decal/sand,
/turf/open/floor/plating/beach/sand,
/area/ruin/powered/beach)
"aB" = (
/obj/effect/turf_decal/stripes/asteroid/line{
	dir = 1
	},
/turf/open/floor/plasteel/asteroid,
/area/ruin/powered/beach)
"aC" = (
/turf/open/floor/wood,
/area/ruin/powered/beach)
"aD" = (
/obj/structure/table,
/obj/item/storage/box/drinkingglasses,
/obj/item/storage/box/drinkingglasses,
/obj/item/reagent_containers/food/drinks/shaker,
/obj/item/storage/box/beakers,
/obj/machinery/light{
	dir = 1
	},
/turf/open/floor/wood,
/area/ruin/powered/beach)
"aE" = (
/obj/structure/table,
/obj/machinery/reagentgrinder,
/turf/open/floor/wood,
/area/ruin/powered/beach)
"aF" = (
/obj/machinery/vending/boozeomat{
	emagged = 1;
	req_access_txt = "0"
	},
/turf/open/floor/wood,
/area/ruin/powered/beach)
"aG" = (
/obj/structure/table,
/obj/item/book/manual/barman_recipes,
/obj/item/reagent_containers/glass/rag,
/turf/open/floor/wood,
/area/ruin/powered/beach)
"aH" = (
/obj/structure/table,
/obj/item/storage/box/donkpockets,
/obj/machinery/light{
	dir = 1
	},
/turf/open/floor/wood,
/area/ruin/powered/beach)
"aI" = (
/obj/structure/table,
/obj/machinery/microwave,
/turf/open/floor/wood,
/area/ruin/powered/beach)
"aJ" = (
/obj/structure/closet/crate/bin,
/obj/item/tank/internals/emergency_oxygen,
/obj/item/trash/candy,
/obj/item/toy/talking/owl,
/obj/effect/turf_decal/stripes/asteroid/line{
	dir = 1
	},
/turf/open/floor/plasteel/asteroid,
/area/ruin/powered/beach)
"aK" = (
/turf/open/floor/plasteel/asteroid,
/area/ruin/powered/beach)
"aL" = (
/obj/effect/mob_spawn/human/bartender/alive{
	name = "beach bum sleeper"
	},
/turf/open/floor/wood,
/area/ruin/powered/beach)
"aM" = (
/obj/structure/reagent_dispensers/beerkeg,
/turf/open/floor/wood,
/area/ruin/powered/beach)
"aN" = (
/obj/machinery/vending/cigarette,
/turf/open/floor/plasteel/asteroid,
/area/ruin/powered/beach)
"aO" = (
/obj/structure/stacklifter,
/turf/open/floor/plating/beach/sand,
/area/ruin/powered/beach)
"aP" = (
/obj/structure/table/wood,
/turf/open/floor/wood,
/area/ruin/powered/beach)
"aQ" = (
/obj/structure/table/wood,
/obj/item/device/flashlight/lamp,
/turf/open/floor/wood,
/area/ruin/powered/beach)
"aR" = (
/obj/structure/table/wood,
/obj/item/reagent_containers/food/drinks/bottle/tequila,
/turf/open/floor/wood,
/area/ruin/powered/beach)
"aS" = (
/obj/machinery/processor,
/turf/open/floor/wood,
/area/ruin/powered/beach)
"aT" = (
/obj/machinery/vending/cola,
/turf/open/floor/plasteel/asteroid,
/area/ruin/powered/beach)
"aU" = (
/obj/effect/overlay/palmtree_l,
/turf/open/floor/plating/beach/sand,
/area/ruin/powered/beach)
"aV" = (
/obj/effect/mob_spawn/human/beach/alive{
	flavour_text = "You're, like, totally a dudebro, bruh. Ch'yea. You came here, like, on spring break, hopin' to pick up some bangin' hot chicks, y'knaw?";
	l_pocket = /obj/item/reagent_containers/food/snacks/pizzaslice/dank;
	uniform = /obj/item/clothing/under/pants/youngfolksjeans
	},
/turf/open/floor/plating/beach/sand,
/area/ruin/powered/beach)
"aW" = (
/obj/structure/chair/stool,
/obj/effect/turf_decal/stripes/asteroid/line{
	dir = 1
	},
/turf/open/floor/plasteel/asteroid,
/area/ruin/powered/beach)
"aX" = (
/obj/structure/closet/secure_closet/freezer/meat,
/turf/open/floor/wood,
/area/ruin/powered/beach)
"aY" = (
/obj/machinery/vending/snack,
/turf/open/floor/plasteel/asteroid,
/area/ruin/powered/beach)
"aZ" = (
/obj/effect/overlay/coconut,
/turf/open/floor/plating/beach/sand,
/area/ruin/powered/beach)
"bb" = (
/obj/structure/weightlifter,
/turf/open/floor/plating/beach/sand,
/area/ruin/powered/beach)
"bc" = (
/obj/machinery/door/airlock/sandstone,
/obj/effect/turf_decal/sand,
/turf/open/floor/wood,
/area/ruin/powered/beach)
"bd" = (
/obj/structure/closet/secure_closet/freezer/kitchen{
	req_access = null
	},
/turf/open/floor/wood,
/area/ruin/powered/beach)
"be" = (
/obj/vehicle/scooter/skateboard{
	dir = 4
	},
/turf/open/floor/plating/beach/sand,
/area/ruin/powered/beach)
"bg" = (
/obj/structure/sign/barsign,
/turf/closed/wall/mineral/sandstone,
/area/ruin/powered/beach)
"bj" = (
/obj/structure/chair/wood/normal{
	dir = 4
	},
/turf/open/floor/plasteel/asteroid,
/area/ruin/powered/beach)
"bk" = (
/obj/structure/table/wood,
/obj/item/reagent_containers/food/snacks/pastatomato,
/turf/open/floor/plasteel/asteroid,
/area/ruin/powered/beach)
"bl" = (
/obj/structure/chair/wood/normal{
	dir = 8
	},
/turf/open/floor/plasteel/asteroid,
/area/ruin/powered/beach)
"bx" = (
/obj/structure/flora/rock,
/turf/open/floor/plating/beach/sand,
/area/ruin/powered/beach)
"bz" = (
/mob/living/simple_animal/crab,
/turf/open/floor/plating/beach/sand,
/area/ruin/powered/beach)
"bA" = (
/obj/structure/window/reinforced{
	dir = 1
	},
/obj/structure/window/reinforced{
	dir = 8
	},
/obj/item/bikehorn/airhorn,
/obj/structure/table/wood,
/obj/item/storage/firstaid,
/obj/item/storage/firstaid/brute,
/turf/open/floor/wood,
/area/ruin/powered/beach)
"bB" = (
/obj/structure/window/reinforced{
	dir = 4
	},
/obj/structure/window/reinforced{
	dir = 1;
	layer = 2.9
	},
/obj/structure/chair/stool,
/turf/open/floor/wood,
/area/ruin/powered/beach)
"bE" = (
/obj/item/reagent_containers/spray/spraytan,
/turf/open/floor/plating/beach/sand,
/area/ruin/powered/beach)
"bF" = (
/obj/item/toy/beach_ball,
/turf/open/floor/plating/beach/sand,
/area/ruin/powered/beach)
"bG" = (
/obj/structure/window/reinforced{
	dir = 8
	},
/obj/structure/window/reinforced,
/obj/item/device/megaphone,
/turf/open/floor/wood,
/area/ruin/powered/beach)
"bH" = (
/obj/structure/window/reinforced{
	dir = 4
	},
/obj/effect/mob_spawn/human/beach/alive{
	flavour_text = "You're a spunky lifeguard! It's up to you to make sure nobody drowns or gets eaten by sharks and stuff.";
	id = /obj/item/card/id;
	id_access = "Medical Doctor";
	id_job = "Lifeguard";
	mob_gender = "female"
	},
/turf/open/floor/wood,
/area/ruin/powered/beach)
"bJ" = (
/obj/structure/chair,
/turf/open/floor/plating/beach/sand,
/area/ruin/powered/beach)
"bK" = (
/obj/item/storage/backpack/duffelbag,
/turf/open/floor/plating/beach/sand,
/area/ruin/powered/beach)
"bL" = (
/obj/effect/turf_decal/sand{
	density = 1
	},
/obj/effect/decal/fakelattice,
/turf/open/floor/pod/light{
	density = 1
	},
/area/ruin/powered/beach)
"bM" = (
/turf/open/floor/plasteel/stairs/old,
/area/ruin/powered/beach)
"bN" = (
/obj/structure/flora/ausbushes/reedbush,
/turf/open/floor/plating/beach/sand,
/area/ruin/powered/beach)
"bO" = (
/obj/item/device/camera,
/turf/open/floor/plating/beach/sand,
/area/ruin/powered/beach)
"bP" = (
/obj/item/reagent_containers/food/drinks/beer,
/turf/open/floor/plating/beach/sand,
/area/ruin/powered/beach)
"bQ" = (
/obj/structure/flora/ausbushes/reedbush,
/turf/open/floor/plating/beach/coastline_t,
/area/ruin/powered/beach)
"bR" = (
/turf/open/floor/plating/beach/coastline_t,
/area/ruin/powered/beach)
"bS" = (
/obj/structure/flora/ausbushes/sparsegrass,
/turf/open/floor/plating/beach/coastline_t,
/area/ruin/powered/beach)
"bT" = (
/turf/open/floor/plating/beach/coastline_b,
/area/ruin/powered/beach)
"bU" = (
/turf/open/floor/plating/beach/water,
/area/ruin/powered/beach)
"bV" = (
/obj/structure/flora/ausbushes/stalkybush,
/turf/open/floor/plating/beach/water,
/area/ruin/powered/beach)
"bW" = (
/turf/closed/wall/r_wall,
/area/ruin/powered/beach)
"cd" = (
/obj/machinery/light/small{
	dir = 1
	},
/turf/closed/wall/mineral/sandstone,
/area/ruin/powered/beach)
"ce" = (
/obj/effect/turf_decal/sand,
/obj/machinery/light{
	dir = 1
	},
/turf/open/floor/plating/beach/sand,
/area/ruin/powered/beach)
"cg" = (
/obj/machinery/light{
	dir = 8
	},
/turf/open/floor/plating/beach/sand,
/area/ruin/powered/beach)
"ch" = (
/obj/machinery/light{
	dir = 4
	},
/turf/open/floor/plating/beach/sand,
/area/ruin/powered/beach)
"cj" = (
/obj/effect/turf_decal/stripes/asteroid/line{
	dir = 1
	},
/obj/machinery/light{
	dir = 1
	},
/turf/open/floor/plasteel/asteroid,
/area/ruin/powered/beach)
"cs" = (
/obj/effect/overlay/palmtree_l,
/obj/machinery/light{
	dir = 4
	},
/turf/open/floor/plating/beach/sand,
/area/ruin/powered/beach)
"ct" = (
/obj/machinery/light,
/turf/open/floor/plating/beach/water,
/area/ruin/powered/beach)
"cz" = (
/obj/effect/turf_decal/sand,
/obj/effect/baseturf_helper/lava_land/surface,
/turf/open/floor/plating/beach/sand,
/area/ruin/powered/beach)
"cR" = (
/obj/structure/table/wood,
/obj/item/tank/internals/oxygen,
/obj/item/pickaxe,
/obj/item/clothing/mask/gas,
/turf/open/floor/pod/dark,
/area/ruin/powered/beach)
"dw" = (
/obj/machinery/door/airlock/sandstone,
/turf/open/floor/pod/dark,
/area/ruin/powered/beach)
"iw" = (
/obj/machinery/light/small{
	brightness = 3;
	dir = 8
	},
/turf/open/floor/pod/dark,
/area/ruin/powered/beach)
"jF" = (
/obj/effect/turf_decal/sand,
/turf/open/floor/pod/dark,
/area/ruin/powered/beach)
"lF" = (
/obj/machinery/light{
	dir = 4
	},
/turf/open/floor/pod/dark{
	initial_gas_mix = "o2=14;n2=23;TEMP=300"
	},
/area/ruin/powered/beach)
"lM" = (
/obj/structure/dresser,
/turf/open/floor/pod/dark,
/area/ruin/powered/beach)
"mh" = (
/obj/effect/spawner/structure/window,
/turf/open/floor/plating,
/area/ruin/powered/beach)
"pI" = (
/obj/machinery/door/airlock/hatch,
/obj/structure/fans/tiny,
/turf/open/floor/pod/dark,
/area/ruin/powered/beach)
"pU" = (
/obj/machinery/light/small{
	dir = 4
	},
/turf/open/floor/pod/dark,
/area/ruin/powered/beach)
"qa" = (
/obj/effect/turf_decal/sand,
/obj/machinery/light/small{
	dir = 4
	},
/turf/open/floor/pod/dark,
/area/ruin/powered/beach)
"vl" = (
/obj/structure/closet/athletic_mixed,
/turf/open/floor/pod/dark,
/area/ruin/powered/beach)
"wY" = (
/turf/open/floor/pod/light,
/area/ruin/powered/beach)
"zw" = (
/obj/structure/closet/athletic_mixed,
/obj/effect/turf_decal/sand,
/turf/open/floor/pod/dark,
/area/ruin/powered/beach)
"Ec" = (
/obj/machinery/door/airlock/sandstone,
/obj/effect/turf_decal/sand,
/turf/open/floor/pod/dark,
/area/ruin/powered/beach)
"Gc" = (
/obj/effect/turf_decal/sand,
/turf/open/floor/pod/light,
/area/ruin/powered/beach)
"HC" = (
/obj/structure/rack,
/obj/item/clothing/shoes/sandal,
/obj/item/clothing/shoes/sandal,
/obj/effect/turf_decal/sand,
/turf/open/floor/pod/dark,
/area/ruin/powered/beach)
"TP" = (
/obj/machinery/light{
	dir = 8
	},
/turf/open/floor/pod/dark{
	initial_gas_mix = "o2=14;n2=23;TEMP=300"
	},
/area/ruin/powered/beach)
"VO" = (
/turf/open/floor/pod/dark,
/area/ruin/powered/beach)
"Xp" = (
/obj/effect/turf_decal/sand,
/obj/machinery/light/small{
	brightness = 3;
	dir = 8
	},
/turf/open/floor/pod/dark,
/area/ruin/powered/beach)

(1,1,1) = {"
aa
aa
aa
aa
aa
aa
aa
aa
aa
lF
aa
bW
bW
bW
pI
bW
pI
bW
bW
bW
aa
lF
aa
aa
aa
aa
aa
aa
aa
aa
"}
(2,1,1) = {"
aa
aa
aa
aa
aa
aa
bW
bW
bW
bW
bW
bW
vl
iw
wY
Gc
wY
Xp
cR
bW
bW
bW
bW
bW
aa
aa
aa
aa
aa
aa
"}
(3,1,1) = {"
aa
aa
aa
aa
bW
bW
bW
ap
cg
ar
ar
bW
HC
VO
Gc
Gc
wY
VO
lM
bW
ad
bQ
bT
bW
bW
bW
aa
aa
aa
aa
"}
(4,1,1) = {"
aa
aa
aa
bW
bW
ap
ar
ar
ar
ar
ar
bW
mh
mh
mh
dw
mh
mh
mh
bW
ap
bR
bT
bU
ct
bW
bW
aa
aa
aa
"}
(5,1,1) = {"
aa
aa
bW
bW
ad
ar
ar
aO
ar
bb
ar
cg
ar
ar
aA
aA
aA
ar
ar
cg
bN
bR
bT
bU
bU
bU
bW
bW
aa
aa
"}
(6,1,1) = {"
aa
aa
bW
aq
ar
ar
ar
ar
aV
ar
ar
ar
ar
ar
ar
ar
ar
bz
ar
bJ
ar
bS
bT
bU
bU
bU
bU
bW
aa
aa
"}
(7,1,1) = {"
aa
bW
bW
ar
ap
az
ar
aO
ar
bb
ar
ar
ar
aU
aZ
ar
ar
ar
ar
ar
ar
bR
bT
bU
bU
bU
ct
bW
bW
aa
"}
(8,1,1) = {"
aa
bW
ad
ar
ar
ar
ar
ar
ar
ar
ar
ar
ar
ar
ar
ar
ar
ar
ar
bJ
bE
bR
bT
bU
bU
bU
bU
bU
bW
aa
"}
(9,1,1) = {"
aa
bW
bW
bW
bW
ce
aA
aA
aA
aA
aA
aA
aA
aA
ar
ar
ar
ap
ar
ar
bO
bR
bT
bU
bU
bU
bU
bU
bW
aa
"}
(10,1,1) = {"
aa
bW
ae
as
bW
aB
aK
aK
aK
aK
aK
aK
aK
aA
ar
ar
ap
bx
ar
bJ
ar
bR
bT
bU
bU
bV
bU
bU
bW
aa
"}
(11,1,1) = {"
aa
bW
af
as
aj
aj
aj
aj
aB
aK
aK
bj
aK
aA
ar
ar
ar
ar
ar
ar
ar
bR
bT
bU
bU
bU
bU
bU
bW
aa
"}
(12,1,1) = {"
aa
bW
ag
as
aw
aC
aC
aP
aW
aK
aK
bk
aK
aA
ar
ar
ap
ar
ar
bJ
ar
bR
bT
bU
bU
bU
bU
ct
bW
aa
"}
(13,1,1) = {"
aa
bW
ah
as
aj
aD
aC
aQ
aW
aK
aK
bl
aK
aA
ar
bx
ar
ar
ar
bK
ar
bR
bT
bU
bU
bU
bU
bU
bW
aa
"}
(14,1,1) = {"
aa
bW
ai
at
ax
aE
aL
aP
aW
aK
aK
aK
aK
aA
ar
ap
ar
ar
ar
bJ
ar
bR
bT
bU
bU
bU
bU
bU
bW
aa
"}
(15,1,1) = {"
aa
bW
cd
aj
aj
aF
aC
aR
aW
aK
aK
aK
aK
cz
ar
ar
ar
ar
bE
ar
ar
bR
bT
bU
bU
bU
bU
bU
bW
aa
"}
(16,1,1) = {"
aa
bW
ak
au
aj
aG
aC
aj
aj
bc
aj
cj
aK
aA
ar
ar
ar
ar
ar
bJ
ar
bR
bT
bU
bU
bU
bU
bU
bW
aa
"}
(17,1,1) = {"
aa
bW
aj
av
aj
aH
aC
aC
aC
aC
bg
aB
aK
aA
ar
ar
aU
ar
ar
ar
ar
bR
bT
bU
bV
bU
bU
bU
bW
aa
"}
(18,1,1) = {"
aa
bW
al
as
aj
aI
aM
aS
aX
bd
aj
aB
aK
aA
ar
aZ
ar
ar
bF
ar
bz
bR
bT
bU
bU
bU
bU
ct
bW
aa
"}
(19,1,1) = {"
aa
bW
am
as
aj
aj
aj
aj
aj
aj
aj
cj
aK
aA
ar
ar
ar
ar
ch
ar
ar
bR
bT
bU
bU
bU
bU
bU
bW
aa
"}
(20,1,1) = {"
aa
bW
an
au
aj
aJ
aN
aT
aY
aK
aK
aK
aK
aA
ar
ar
ar
bA
bG
bL
ar
bR
bT
bU
bU
bU
bU
bU
bW
aa
"}
(21,1,1) = {"
aa
bW
ao
au
ay
aK
aK
aK
aK
aK
aK
aK
aK
aA
ar
ar
ar
bB
bH
bM
ar
bR
bT
bU
bU
bU
bU
bU
bW
aa
"}
(22,1,1) = {"
aa
bW
bW
bW
bW
ce
aA
aA
aA
aA
aA
aA
aA
aA
ar
ar
ar
ar
ar
ar
bP
bR
bT
bU
bU
bU
bV
bU
bW
aa
"}
(23,1,1) = {"
aa
bW
ap
ar
ar
ar
ar
ar
ar
ar
ar
ar
ar
ar
ar
ar
ar
ar
ar
bJ
ar
bR
bT
bU
bU
bU
bU
bU
bW
aa
"}
(24,1,1) = {"
aa
bW
bW
ar
ap
ar
ar
aU
ar
ar
ar
bz
ar
ar
ar
ar
ar
aZ
ar
ar
ar
bR
bT
bU
bU
bU
ct
bW
bW
aa
"}
(25,1,1) = {"
aa
aa
bW
aq
ar
ar
ar
ar
aZ
ar
ar
ar
ar
ar
ar
ar
ar
ar
ar
ar
ar
bS
bT
bU
bU
bU
bU
bW
aa
aa
"}
(26,1,1) = {"
aa
aa
bW
bW
ap
ar
ar
aq
ar
be
ar
ch
ar
ar
aA
aA
aA
ar
ar
cs
ar
bR
bT
bU
bU
bU
bW
bW
aa
aa
"}
(27,1,1) = {"
aa
aa
aa
bW
bW
ad
ar
ar
ar
ar
ar
bW
mh
mh
mh
Ec
mh
mh
mh
bW
ap
bR
bT
bU
ct
bW
bW
aa
aa
aa
"}
(28,1,1) = {"
aa
aa
aa
aa
bW
bW
bW
ap
ch
ap
ar
bW
zw
VO
wY
Gc
Gc
jF
lM
bW
bN
bR
bT
bW
bW
bW
aa
aa
aa
aa
"}
(29,1,1) = {"
aa
aa
aa
aa
aa
aa
bW
bW
bW
bW
bW
bW
HC
qa
wY
wY
Gc
pU
cR
bW
bW
bW
bW
bW
aa
aa
aa
aa
aa
aa
"}
(30,1,1) = {"
aa
aa
aa
aa
aa
aa
aa
aa
aa
TP
aa
bW
bW
bW
pI
bW
pI
bW
bW
bW
aa
TP
aa
aa
aa
aa
aa
aa
aa
aa
"}
