//MAP CONVERTED BY dmm2tgm.py THIS HEADER COMMENT PREVENTS RECONVERSION, DO NOT REMOVE
"a" = (
/turf/template_noop,
/area/template_noop)
"b" = (
/turf/closed/indestructible,
/area/ruin/powered)
"c" = (
/turf/open/floor/engine/cult,
/area/ruin/powered)
"d" = (
/obj/structure/destructible/cult/pylon,
/turf/open/floor/engine/cult,
/area/ruin/powered)
"e" = (
/turf/open/floor/plating{
	icon_state = "cultdamage5"
	},
/area/ruin/powered)
"f" = (
/mob/living/simple_animal/hostile/faithless,
/turf/open/floor/engine/cult,
/area/ruin/powered)
"g" = (
/turf/open/floor/plasteel/circuit/off,
/area/ruin/powered)
"h" = (
/turf/closed/indestructible{
	desc = "The patterns engraved on the wall seem to shift as you try to focus on them. You feel sick.";
	icon = 'icons/turf/walls/cult_wall.dmi';
	icon_state = "cult"
	},
/area/ruin/powered)
"i" = (
/turf/open/floor/plating{
	icon_state = "cultdamage3"
	},
/area/ruin/powered)
"j" = (
/turf/open/floor/plating{
	icon_state = "cultdamage6"
	},
/area/ruin/powered)
"k" = (
/obj/effect/gateway,
/turf/open/floor/engine/cult,
/area/ruin/powered)
"l" = (
/mob/living/simple_animal/hostile/faithless,
/turf/open/floor/plasteel/circuit/off,
/area/ruin/powered)
"m" = (
/obj/machinery/wish_granter_dark,
/turf/open/floor/plasteel/circuit/gcircuit/off,
/area/ruin/powered)
"n" = (
/turf/open/floor/plasteel/circuit/gcircuit/off,
/area/ruin/powered)
"o" = (
/obj/structure/destructible/cult/pylon,
/turf/open/floor/plasteel/circuit/gcircuit/off,
/area/ruin/powered)
"p" = (
/obj/structure/signpost,
/turf/open/floor/plasteel/circuit/gcircuit/off,
/area/ruin/powered)
"q" = (
/obj/effect/meatgrinder,
/turf/open/floor/plasteel/circuit/gcircuit/off,
/area/ruin/powered)
"r" = (
/obj/structure/destructible/cult/pylon,
/turf/open/floor/plasteel/circuit/off,
/area/ruin/powered)
"s" = (
/turf/open/floor/engine/cult{
	baseturf = /turf/open/floor/plating/lava/smooth
	},
/area/ruin/powered)
"t" = (
/turf/open/floor/plating{
	icon_state = "cultdamage2"
	},
/area/ruin/powered)
"u" = (
/turf/open/floor/carpet,
/area/ruin/powered)
"v" = (
/mob/living/simple_animal/hostile/faithless,
/turf/open/floor/carpet,
/area/ruin/powered)
"w" = (
/obj/machinery/door/airlock/vault{
	locked = 1
	},
/turf/open/floor/engine/cult,
/area/ruin/powered)
"x" = (
/obj/structure/destructible/cult/pylon,
/turf/open/floor/engine/cult{
	baseturf = /turf/open/floor/plating/lava/smooth
	},
/area/ruin/powered)
"y" = (
/mob/living/simple_animal/hostile/faithless,
/turf/open/floor/engine/cult{
	baseturf = /turf/open/floor/plating/lava/smooth
	},
/area/ruin/powered)
"z" = (
/turf/template_noop,
/turf/closed/indestructible{
	desc = "The patterns engraved on the wall seem to shift as you try to focus on them. You feel sick.";
	icon = 'icons/turf/walls/cult_wall.dmi';
	icon_state = "cult"
	},
/area/ruin/powered)
"A" = (
/mob/living/simple_animal/hostile/faithless,
/turf/template_noop,
/area/template_noop)
"B" = (
/obj/effect/mob_spawn/human/miner/rig,
/turf/open/floor/engine/cult{
	baseturf = /turf/open/floor/plating/lava/smooth
	},
/area/ruin/powered)
"C" = (
/obj/machinery/door/airlock/vault{
	locked = 1
	},
/turf/open/floor/engine/cult{
	baseturf = /turf/open/floor/plating/lava/smooth;
	blocks_air = 1
	},
/area/ruin/powered)
"D" = (
/turf/open/floor/engine/cult{
	baseturf = /turf/open/floor/plating/lava/smooth;
	initial_gas_mix = "o2=14;n2=23;TEMP=300"
	},
/area/template_noop)
"E" = (
/turf/closed/indestructible,
/area/template_noop)
"F" = (
/obj/item/weapon/paper{
	info = "meat grinder requires sacri"
	},
/turf/open/floor/engine/cult{
	baseturf = /turf/open/floor/plating/lava/smooth;
	initial_gas_mix = "o2=14;n2=23;TEMP=300"
	},
/area/template_noop)
"G" = (
/obj/effect/mob_spawn/human/syndicatecommando,
/turf/open/floor/engine/cult{
	baseturf = /turf/open/floor/plating/lava/smooth;
	initial_gas_mix = "o2=14;n2=23;TEMP=300"
	},
/area/template_noop)
"H" = (
/mob/living/simple_animal/hostile/faithless,
/turf/open/floor/engine/cult{
	baseturf = /turf/open/floor/plating/lava/smooth;
	initial_gas_mix = "o2=14;n2=23;TEMP=300"
	},
/area/template_noop)

(1,1,1) = {"
a
a
a
a
a
a
a
a
a
a
a
a
a
a
a
a
a
a
a
a
a
a
a
a
a
a
a
a
a
a
a
a
a
a
a
a
a
a
a
a
a
a
a
a
a
a
a
a
a
a
a
a
a
a
a
a
a
a
a
a
a
a
a
a
a
a
a
a
a
a
a
a
a
a
a
a
a
a
a
a
"}
(2,1,1) = {"
a
a
a
a
a
a
a
a
a
a
a
a
a
a
a
a
a
a
a
a
a
a
a
a
a
a
a
a
a
a
a
a
a
a
a
a
a
a
a
a
a
a
a
a
a
a
a
a
a
a
a
a
a
a
a
a
a
a
a
a
a
a
a
a
a
a
a
a
a
a
a
a
a
a
a
a
a
a
a
a
"}
(3,1,1) = {"
a
a
a
a
a
a
a
a
a
a
a
a
a
a
a
a
a
a
a
a
a
a
a
a
a
a
a
a
a
a
a
a
a
a
a
a
a
a
a
a
a
a
a
a
a
a
a
a
b
b
b
b
b
a
a
a
a
a
a
a
a
a
a
a
a
a
a
a
a
a
a
a
a
a
a
a
a
a
a
a
"}
(4,1,1) = {"
a
a
a
a
a
a
a
a
a
a
a
a
a
a
a
a
a
a
a
a
a
a
a
a
a
a
a
a
a
a
a
a
a
a
b
b
b
b
a
a
a
a
a
a
a
a
a
b
b
s
s
s
b
b
a
a
a
a
a
a
a
a
a
a
a
a
a
a
a
a
a
a
a
a
a
a
a
a
a
a
"}
(5,1,1) = {"
a
a
a
a
a
a
a
a
a
a
a
a
a
a
a
a
a
a
a
a
a
a
a
a
a
a
a
a
a
a
a
a
b
b
b
c
c
b
b
a
a
a
a
a
a
a
a
b
s
s
h
s
s
b
a
a
a
a
a
a
a
a
a
a
a
a
a
a
a
a
a
a
a
a
a
a
a
a
a
a
"}
(6,1,1) = {"
a
a
a
a
a
a
a
a
a
a
a
a
a
a
a
a
a
a
a
a
a
a
a
a
a
a
a
a
a
a
a
b
b
c
c
c
c
c
b
b
a
a
a
a
a
a
a
b
s
h
h
h
s
b
b
b
b
b
b
b
a
a
a
a
a
a
a
a
a
a
a
a
a
a
a
a
a
a
a
a
"}
(7,1,1) = {"
a
a
a
a
a
a
a
a
a
a
a
a
a
a
a
a
a
a
a
a
a
a
a
a
a
a
a
a
a
a
a
b
b
c
c
c
c
c
c
b
b
a
a
a
a
a
a
b
s
s
h
h
s
s
s
s
s
s
h
b
a
a
a
a
a
a
a
a
a
a
a
a
a
a
a
a
a
a
a
a
"}
(8,1,1) = {"
a
a
a
a
a
a
a
a
a
a
a
a
a
a
a
a
a
a
a
a
a
a
a
a
a
a
a
a
a
a
a
a
b
b
c
c
h
h
c
c
b
b
a
a
a
a
a
b
b
s
s
h
h
h
h
h
h
c
h
b
b
a
a
a
a
a
a
a
a
a
a
a
a
a
a
a
a
a
a
a
"}
(9,1,1) = {"
a
a
a
a
a
a
a
a
a
a
a
a
a
a
a
a
a
a
a
a
a
a
a
a
a
a
a
a
a
a
a
a
a
b
c
f
c
h
c
c
c
b
b
b
b
b
b
b
b
h
s
h
h
s
s
s
s
s
h
s
b
a
a
a
a
a
a
a
a
a
a
a
a
a
a
a
a
a
a
a
"}
(10,1,1) = {"
a
a
a
a
a
a
a
a
a
a
a
a
a
a
a
a
a
a
a
a
a
a
a
a
a
a
a
a
a
a
a
a
a
b
c
c
c
h
h
c
c
c
c
h
s
s
s
s
h
s
y
h
s
y
h
h
h
h
h
s
b
b
a
a
a
a
a
a
a
a
a
a
a
a
a
a
a
a
a
a
"}
(11,1,1) = {"
a
a
a
a
a
a
a
a
a
a
a
a
a
a
a
a
a
a
a
a
a
a
a
a
a
a
a
a
a
a
a
b
b
b
c
f
c
d
h
c
c
f
c
h
s
s
h
s
h
y
s
h
y
h
h
s
s
s
h
s
s
b
b
a
a
a
a
a
a
a
a
a
a
a
a
a
a
a
a
a
"}
(12,1,1) = {"
a
a
a
a
a
a
a
a
a
a
a
a
a
a
a
a
a
a
a
a
a
a
a
a
a
a
a
b
b
b
b
b
c
h
c
c
c
h
h
c
f
f
c
h
s
s
h
s
h
s
y
h
s
s
s
s
s
s
h
s
s
b
b
a
a
a
a
a
a
a
a
a
a
a
a
a
a
a
a
a
"}
(13,1,1) = {"
a
a
a
a
a
a
a
a
a
a
a
a
a
a
a
a
a
a
a
a
a
a
a
a
a
b
b
b
c
c
c
c
c
h
c
c
h
h
h
h
c
c
f
h
s
s
h
s
s
s
x
h
s
x
s
s
s
s
h
s
s
b
b
b
a
a
a
a
a
a
a
a
a
a
a
a
a
a
a
a
"}
(14,1,1) = {"
a
a
a
a
a
a
a
a
a
a
a
a
a
a
a
a
a
a
a
a
a
a
a
a
a
b
b
c
c
c
c
c
c
h
h
c
h
c
c
h
c
c
c
h
h
s
h
s
s
s
s
h
s
s
s
h
s
s
h
s
s
b
s
b
b
a
a
a
a
a
a
a
a
a
a
a
a
a
a
a
"}
(15,1,1) = {"
a
a
a
a
a
a
a
a
a
a
a
a
a
a
a
a
a
a
a
a
a
a
a
a
b
b
h
c
c
c
c
c
c
c
h
c
h
c
f
h
h
c
c
c
h
s
h
h
h
h
h
h
s
s
s
h
s
s
h
s
s
s
s
s
b
a
a
a
a
a
a
a
a
a
a
a
a
a
a
a
"}
(16,1,1) = {"
a
a
a
a
a
a
a
a
a
a
a
a
a
a
a
a
a
a
a
a
a
a
a
b
b
c
h
c
c
c
h
h
c
c
h
c
h
c
c
c
h
d
c
c
h
s
c
c
c
c
c
h
h
h
h
h
s
s
h
s
x
s
s
s
b
b
a
a
a
a
a
a
a
a
a
a
a
a
a
a
"}
(17,1,1) = {"
a
a
a
a
a
a
a
a
a
a
a
a
a
a
a
a
a
a
a
a
a
b
b
b
c
c
h
h
c
c
c
h
c
c
h
c
h
h
c
c
h
h
c
h
h
s
h
c
c
c
c
c
d
c
h
s
s
s
h
s
s
s
s
s
b
b
a
a
a
a
a
a
a
a
a
a
a
a
a
a
"}
(18,1,1) = {"
a
a
a
a
a
a
a
a
a
a
a
a
a
a
a
a
a
a
a
b
b
b
c
c
c
c
c
h
c
c
c
h
d
c
h
c
c
h
c
c
c
c
c
h
s
s
h
h
h
f
f
c
c
c
h
s
s
s
h
s
s
s
s
s
s
b
a
a
a
a
a
a
D
a
a
a
a
a
a
a
"}
(19,1,1) = {"
a
a
a
a
a
a
a
a
a
a
a
a
a
a
a
a
a
a
a
b
c
c
c
c
c
c
c
h
h
c
c
h
c
c
h
c
c
h
h
h
c
c
c
h
s
s
s
s
h
h
h
c
c
c
h
s
s
y
h
s
x
s
s
s
s
b
D
D
D
a
a
a
D
a
a
a
a
a
a
a
"}
(20,1,1) = {"
a
a
a
a
a
a
a
a
a
a
a
a
a
a
a
a
a
a
b
b
c
c
c
h
d
c
c
c
h
c
c
h
c
c
h
c
c
c
c
h
h
c
c
h
h
s
s
s
s
s
h
h
c
c
h
s
y
s
w
s
s
s
s
s
s
b
a
a
D
D
D
D
a
a
a
a
a
a
a
a
"}
(21,1,1) = {"
a
a
a
a
a
a
a
a
a
a
a
a
a
a
a
a
a
b
b
h
c
c
c
h
h
c
f
c
h
c
c
h
c
c
h
d
c
c
c
c
h
h
c
c
h
h
s
s
s
s
s
h
c
c
h
s
s
s
w
s
s
s
s
s
s
b
a
a
a
D
a
a
a
a
a
a
a
a
a
a
"}
(22,1,1) = {"
a
a
a
a
a
a
a
a
a
a
a
a
a
a
a
a
a
b
c
h
h
h
c
c
h
c
c
c
h
f
c
h
c
c
h
h
c
c
h
c
c
h
c
c
c
h
h
h
x
s
s
h
c
c
h
s
s
s
h
s
x
s
s
s
s
b
D
D
a
a
a
a
a
a
a
a
a
a
a
a
"}
(23,1,1) = {"
a
a
a
a
a
a
a
a
a
a
a
a
a
a
a
a
a
b
c
c
h
h
c
c
h
f
c
c
h
c
c
h
c
c
c
h
c
c
h
c
c
h
h
c
c
c
f
h
h
s
s
h
c
c
h
h
h
h
h
s
s
s
s
s
s
b
a
D
D
a
a
a
a
a
a
a
a
a
a
a
"}
(24,1,1) = {"
a
a
a
a
a
a
a
a
a
a
a
a
a
a
a
a
a
b
c
c
h
h
c
c
h
c
c
c
h
f
c
h
c
c
c
h
c
c
h
f
c
c
h
h
c
f
c
c
h
h
s
h
c
c
c
c
s
s
h
s
s
s
s
s
s
b
D
D
D
D
a
A
a
a
a
a
a
a
a
a
"}
(25,1,1) = {"
a
a
a
a
a
a
a
a
a
a
a
a
a
a
a
a
a
b
c
c
c
h
c
c
h
c
c
c
h
c
c
h
h
c
c
h
c
c
h
h
c
c
c
h
c
s
s
s
s
h
s
h
h
c
c
c
s
s
h
s
x
B
s
s
s
b
a
D
D
D
a
a
a
a
a
a
a
a
a
a
"}
(26,1,1) = {"
a
a
a
a
a
a
a
a
a
a
a
a
a
a
a
a
a
b
c
h
c
h
c
f
h
c
c
c
h
c
c
c
h
c
c
h
c
c
c
h
c
f
c
h
h
s
s
s
s
c
s
s
h
c
c
c
s
s
h
s
s
s
s
s
s
b
D
D
D
D
D
D
D
D
a
a
a
a
a
a
"}
(27,1,1) = {"
a
a
a
a
a
a
a
a
a
a
a
a
a
a
a
a
a
b
c
h
c
f
c
c
h
c
c
h
h
c
c
c
h
c
c
h
h
c
c
h
h
h
h
h
h
s
s
s
s
c
s
h
h
h
h
h
s
s
h
s
s
y
s
s
s
b
a
a
a
a
a
a
a
a
D
D
a
a
a
a
"}
(28,1,1) = {"
a
a
a
a
a
a
a
a
a
a
a
a
a
a
a
a
a
b
c
h
h
c
c
f
h
c
c
h
d
c
c
c
h
c
c
c
h
h
c
c
c
c
c
c
h
h
s
s
s
h
h
h
s
s
s
s
s
s
h
s
x
s
s
s
s
b
a
a
a
a
a
a
a
a
D
a
a
a
a
a
"}
(29,1,1) = {"
a
a
a
a
a
a
a
a
a
a
a
a
a
a
a
a
a
b
c
c
h
d
c
c
h
c
c
h
c
c
c
c
h
h
d
c
c
h
h
h
h
c
c
c
c
h
h
h
h
h
s
s
s
s
s
s
s
s
h
s
s
s
s
s
s
b
E
E
E
E
a
a
a
a
a
a
a
a
a
a
"}
(30,1,1) = {"
a
a
a
a
a
a
a
a
a
a
a
a
a
a
a
a
a
b
c
h
h
h
h
h
h
c
c
c
c
c
c
c
c
h
h
c
c
c
c
c
h
h
h
c
c
c
h
s
s
s
s
s
s
s
s
x
s
s
h
s
s
s
s
s
s
C
F
G
D
D
D
D
D
a
a
a
a
a
a
a
"}
(31,1,1) = {"
a
a
a
a
a
a
a
a
a
a
a
a
a
a
a
a
a
b
c
c
c
c
c
c
h
c
c
c
c
c
c
h
h
h
h
c
f
c
c
c
c
d
h
c
f
c
h
s
s
s
s
s
s
h
h
h
s
s
h
s
x
s
s
s
s
C
D
D
D
H
D
D
a
a
a
a
a
a
a
a
"}
(32,1,1) = {"
a
a
a
a
a
a
a
a
a
a
a
a
a
a
a
a
a
b
b
h
h
h
c
c
h
h
h
c
c
c
h
h
c
c
c
c
c
c
c
c
c
c
h
c
c
h
h
s
s
s
s
h
h
h
s
h
s
s
h
s
s
s
s
s
s
b
E
E
E
E
a
a
D
a
a
a
a
a
a
a
"}
(33,1,1) = {"
a
a
a
a
a
a
a
a
a
a
a
a
a
a
a
a
a
a
b
b
c
h
h
c
c
c
h
h
h
c
h
c
c
h
h
h
h
h
h
h
c
c
h
c
c
h
s
s
s
s
h
h
x
s
s
h
s
s
h
s
s
s
s
s
s
b
a
a
a
a
a
a
D
D
a
a
a
a
a
a
"}
(34,1,1) = {"
a
a
a
a
a
a
a
a
a
a
a
a
a
a
a
a
a
a
a
b
c
c
h
c
c
c
c
d
h
h
h
c
c
h
c
f
f
c
c
h
c
c
c
c
c
h
h
s
s
s
h
s
s
y
s
h
s
s
h
s
x
s
s
s
s
b
a
a
a
a
a
a
D
D
a
a
a
a
a
a
"}
(35,1,1) = {"
a
a
a
a
a
a
a
a
a
a
a
a
a
a
a
a
a
a
a
b
c
c
h
h
c
c
c
c
c
c
h
c
c
h
f
c
f
f
c
h
h
c
c
c
c
c
h
s
s
s
s
s
s
s
s
h
s
s
h
s
s
s
s
s
s
b
a
a
a
a
a
a
a
a
a
a
a
a
a
a
"}
(36,1,1) = {"
a
a
a
a
a
a
a
a
a
a
a
a
a
a
a
a
a
a
a
b
c
c
c
h
c
c
c
c
c
c
h
c
c
h
h
h
h
c
f
c
h
c
c
c
c
c
h
s
s
s
s
s
s
h
h
h
s
s
h
s
s
s
s
s
s
b
D
D
a
a
a
a
a
a
a
D
a
a
a
a
"}
(37,1,1) = {"
a
a
a
a
a
a
a
a
a
a
a
a
a
a
a
a
a
a
a
b
c
c
c
h
c
c
c
c
c
c
h
c
c
c
c
d
h
c
c
c
h
h
h
h
h
h
h
h
s
s
c
s
h
h
s
s
s
s
h
s
x
s
s
s
b
b
a
D
a
a
a
a
a
a
a
a
a
a
a
a
"}
(38,1,1) = {"
a
a
a
a
a
a
a
a
a
a
a
a
a
a
a
a
a
a
a
b
c
c
c
h
h
c
c
c
c
c
h
c
c
c
c
c
h
h
c
c
c
c
c
c
c
c
c
h
h
s
h
h
h
s
s
s
s
y
h
s
s
s
b
b
b
a
a
D
a
a
a
a
a
a
a
a
a
a
a
a
"}
(39,1,1) = {"
a
a
a
a
a
a
a
a
a
a
a
a
a
a
a
a
a
a
b
b
c
c
c
c
h
h
c
c
c
c
h
h
c
c
c
c
c
h
h
c
c
c
c
c
c
c
c
c
h
h
h
s
s
s
s
s
s
s
h
s
s
b
a
a
a
a
a
D
a
a
a
a
a
a
a
a
a
a
a
a
"}
(40,1,1) = {"
a
a
a
a
a
a
a
a
a
a
a
a
a
a
a
a
a
b
b
c
c
f
f
c
c
h
h
c
c
c
c
h
c
c
c
c
c
c
h
h
h
h
h
h
d
c
c
c
c
c
c
s
s
s
s
s
s
s
b
b
b
b
a
a
a
a
a
a
a
a
a
a
a
a
a
a
a
a
a
a
"}
(41,1,1) = {"
a
a
a
a
a
a
a
a
a
a
a
a
a
a
a
a
b
h
h
c
c
c
c
c
c
c
h
c
c
c
c
h
h
h
h
h
c
f
c
c
c
h
c
c
c
c
c
c
c
c
c
s
s
s
s
s
c
b
b
a
a
a
a
a
a
a
a
a
a
a
a
a
a
a
a
a
a
a
a
a
"}
(42,1,1) = {"
a
a
a
a
a
a
a
a
a
a
a
a
a
a
a
b
b
h
c
c
c
d
h
h
c
c
h
h
c
f
c
c
c
c
h
c
c
c
c
f
h
h
c
c
c
h
h
h
h
h
c
s
s
s
s
s
b
b
a
a
a
a
a
a
a
a
a
a
a
a
a
a
a
a
a
a
a
a
a
a
"}
(43,1,1) = {"
a
a
a
a
a
a
a
a
a
a
a
a
a
a
b
b
c
h
h
c
c
c
h
h
c
c
c
h
h
h
c
c
f
c
h
c
c
h
h
h
h
c
c
c
c
h
f
c
c
h
h
h
h
h
h
h
b
a
a
a
a
a
a
a
a
a
a
a
a
a
a
a
a
a
a
a
a
a
a
a
"}
(44,1,1) = {"
a
a
a
a
a
a
a
a
a
a
a
a
a
b
b
c
c
c
h
h
c
c
h
h
c
c
c
c
d
h
c
c
c
c
h
c
c
h
c
c
c
c
c
c
c
h
c
f
c
c
c
h
h
c
c
b
b
a
a
a
a
a
a
a
a
a
a
a
a
a
a
a
a
a
a
a
a
a
a
a
"}
(45,1,1) = {"
a
a
a
a
a
a
a
a
a
a
a
a
a
b
c
c
c
c
c
h
h
c
c
h
h
h
c
c
c
h
h
h
d
c
h
c
c
h
c
c
c
h
h
h
h
h
f
c
c
c
c
c
c
c
c
b
a
a
a
a
a
a
a
a
a
a
a
a
a
a
a
a
a
a
a
a
a
a
a
a
"}
(46,1,1) = {"
a
a
a
a
a
a
a
a
a
a
a
a
b
b
c
c
c
c
c
c
h
h
c
c
c
h
h
h
c
c
c
h
h
c
h
c
c
h
c
c
c
h
d
c
c
c
c
h
h
h
h
h
c
c
c
b
a
a
a
a
a
a
a
a
a
a
a
a
a
a
a
a
a
a
a
a
a
a
a
a
"}
(47,1,1) = {"
a
a
a
a
a
a
a
a
a
a
a
a
b
c
c
c
c
c
c
c
c
h
c
c
c
c
d
h
c
c
c
c
c
c
h
c
c
h
c
c
c
c
c
c
c
c
h
h
d
h
h
c
c
c
c
b
a
a
a
a
a
a
a
a
a
a
a
a
a
a
a
a
a
a
a
a
a
a
a
a
"}
(48,1,1) = {"
a
a
a
a
a
a
a
a
a
a
a
a
b
c
c
c
c
c
c
c
c
h
c
c
c
c
c
h
h
h
c
c
c
c
h
c
c
h
h
h
c
c
c
c
h
h
h
f
c
f
c
f
c
c
b
b
a
a
a
a
a
a
a
a
a
a
a
a
a
a
a
a
a
a
a
a
a
a
a
a
"}
(49,1,1) = {"
a
a
a
a
a
a
a
a
a
a
a
b
b
c
c
c
c
c
c
c
c
h
h
c
c
f
f
c
c
h
h
h
h
h
h
c
c
c
f
h
h
h
h
h
h
c
c
c
c
c
c
c
c
b
b
a
a
a
a
a
a
a
a
a
a
a
a
a
a
a
a
a
a
a
a
a
a
a
a
a
"}
(50,1,1) = {"
a
a
a
a
a
a
a
a
a
a
a
b
c
c
c
c
c
c
c
c
c
c
h
h
h
c
c
c
c
c
c
c
c
d
h
h
c
c
c
c
c
c
c
c
c
c
c
c
h
h
h
h
h
b
a
a
a
a
a
a
a
a
a
a
a
a
a
a
a
a
a
a
a
a
a
a
a
a
a
a
"}
(51,1,1) = {"
a
a
a
a
a
a
a
a
a
a
a
b
c
c
c
c
c
i
c
c
c
c
c
c
h
h
h
c
c
c
c
c
c
c
c
h
h
d
c
c
f
c
c
c
c
c
c
c
h
c
c
c
c
b
a
a
a
a
a
a
a
a
a
a
a
a
a
a
a
a
a
a
a
a
a
a
a
a
a
a
"}
(52,1,1) = {"
a
a
a
a
a
a
a
a
a
a
a
b
c
c
c
c
c
f
c
c
c
d
c
c
c
c
h
c
c
c
c
c
c
c
c
c
h
h
h
h
c
c
c
c
c
c
c
h
h
c
c
c
c
b
a
a
a
a
a
a
a
a
a
a
a
a
a
a
a
a
a
a
a
a
a
a
a
a
a
a
"}
(53,1,1) = {"
a
a
a
a
a
a
a
a
a
a
a
b
c
c
c
c
c
c
c
c
c
c
c
c
c
c
h
h
h
h
h
h
c
c
c
c
c
c
c
h
h
c
c
c
h
h
h
h
f
c
c
c
c
b
a
a
a
a
a
a
a
a
a
a
a
a
a
a
a
a
a
a
a
a
a
a
a
a
a
a
"}
(54,1,1) = {"
a
a
a
a
a
a
a
a
a
a
a
b
c
c
c
c
c
c
c
c
c
c
c
c
c
c
c
c
c
c
c
h
h
h
c
c
c
f
f
c
h
h
h
h
h
d
c
f
c
c
h
c
c
b
a
a
a
a
a
a
a
a
a
a
a
a
a
a
a
a
a
a
a
a
a
a
a
a
a
a
"}
(55,1,1) = {"
a
a
a
a
a
a
a
a
a
a
b
b
c
c
c
c
c
c
c
j
c
c
c
f
c
c
c
c
c
c
c
c
c
h
h
h
c
c
c
c
c
c
c
c
c
c
c
c
c
f
h
c
c
b
a
a
a
a
a
a
a
a
a
a
a
a
a
a
a
a
a
a
a
a
a
a
a
a
a
a
"}
(56,1,1) = {"
a
a
a
a
a
a
a
a
a
a
b
c
c
c
c
d
c
c
c
c
c
c
c
c
c
c
c
c
c
c
c
c
c
c
c
h
h
h
h
c
c
c
c
c
c
c
c
c
h
h
h
c
f
b
b
a
a
a
a
a
a
a
a
a
a
a
a
a
a
a
a
a
a
a
a
a
a
a
a
a
"}
(57,1,1) = {"
a
a
a
a
a
a
a
a
a
a
b
c
c
c
c
c
c
c
c
c
c
c
e
c
c
f
c
c
c
c
c
c
c
c
c
c
c
c
h
h
c
c
c
c
c
h
h
h
h
d
c
c
f
c
b
a
a
a
a
a
a
a
a
a
a
a
a
a
a
a
a
a
a
a
a
a
a
a
a
a
"}
(58,1,1) = {"
a
a
a
a
a
a
a
a
a
a
b
c
c
c
c
c
c
c
c
c
c
c
c
c
c
c
i
c
c
j
c
c
c
c
c
c
c
c
c
h
h
h
h
h
h
h
c
c
c
c
c
c
c
c
b
a
a
a
a
a
a
a
a
a
a
a
a
a
a
a
a
a
a
a
a
a
a
a
a
a
"}
(59,1,1) = {"
a
a
a
a
a
a
a
a
a
a
b
c
c
c
c
c
c
c
c
c
c
k
c
c
c
c
c
c
s
s
s
c
k
c
c
c
c
c
c
c
c
c
c
c
c
h
c
c
c
c
c
c
c
c
b
a
a
a
a
a
a
a
a
a
a
a
a
a
a
a
a
a
a
a
a
a
a
a
a
a
"}
(60,1,1) = {"
a
a
a
a
a
a
a
a
a
a
b
b
c
c
c
c
e
c
c
c
c
c
c
c
c
c
c
c
c
c
f
c
c
c
c
c
c
c
c
c
c
c
c
c
c
h
w
w
h
h
h
h
h
h
b
a
a
a
a
a
a
a
a
a
a
a
a
a
a
a
a
a
a
a
a
a
a
a
a
a
"}
(61,1,1) = {"
a
a
a
a
a
a
a
a
a
a
a
b
c
c
c
c
c
c
f
c
c
c
c
c
c
c
j
c
c
c
c
c
i
c
c
c
c
c
c
c
c
c
c
c
c
c
c
c
c
c
c
c
c
c
b
a
a
a
a
a
a
a
a
a
a
a
a
a
a
a
a
a
a
a
a
a
a
a
a
a
"}
(62,1,1) = {"
a
a
a
a
a
a
a
a
a
a
a
b
c
c
c
c
c
c
c
c
c
c
c
d
c
c
c
c
c
c
c
c
c
c
c
c
c
c
c
c
f
c
c
c
d
u
u
u
u
d
c
c
c
c
b
a
a
a
a
a
a
a
a
a
a
a
a
a
a
a
a
a
a
a
a
a
a
a
a
a
"}
(63,1,1) = {"
a
a
a
a
a
a
a
a
a
a
a
b
c
c
c
c
f
c
c
c
c
c
c
c
c
c
c
f
c
d
c
c
f
c
c
c
c
c
c
c
c
c
c
c
c
v
u
u
u
c
c
f
c
c
b
a
a
a
a
a
a
a
a
a
a
a
a
a
a
a
a
a
a
a
a
a
a
a
a
a
"}
(64,1,1) = {"
a
a
a
a
a
a
a
a
a
a
a
b
b
c
c
c
c
c
c
c
c
c
c
c
c
c
c
c
c
c
c
c
c
c
c
c
j
c
f
c
c
c
c
c
c
u
u
u
u
c
f
c
c
c
b
a
a
a
a
a
a
a
a
a
a
a
a
a
a
a
a
a
a
a
a
a
a
a
a
a
"}
(65,1,1) = {"
a
a
a
a
a
a
a
a
a
a
a
a
b
b
c
c
c
c
e
c
c
c
c
c
c
c
c
c
c
c
c
c
c
c
c
c
c
c
c
c
c
c
c
c
c
u
u
v
u
c
c
c
c
c
b
b
a
a
a
a
a
a
a
a
a
a
a
a
a
a
a
a
a
a
a
a
a
a
a
a
"}
(66,1,1) = {"
a
a
a
a
a
a
a
a
a
a
a
a
a
b
c
c
c
c
c
c
c
c
j
c
c
f
c
c
c
c
c
e
c
c
c
c
i
c
c
c
c
c
c
f
c
u
u
u
u
c
c
c
c
c
c
b
b
a
a
a
a
a
a
a
a
a
a
a
a
a
a
a
a
a
a
a
a
a
a
a
"}
(67,1,1) = {"
a
a
a
a
a
a
a
a
a
a
a
a
a
b
c
c
c
c
c
c
c
c
c
c
c
c
c
j
c
c
c
c
c
c
c
c
c
c
c
f
c
k
c
c
d
u
u
u
u
d
c
c
c
c
c
c
b
a
a
a
a
a
a
a
a
a
a
a
a
a
a
a
a
a
a
a
a
a
a
a
"}
(68,1,1) = {"
a
a
a
a
a
a
a
a
a
a
a
a
a
b
c
c
c
c
c
c
c
c
c
c
c
c
c
c
c
c
c
c
c
c
c
c
c
c
c
c
c
c
c
c
c
u
u
u
u
c
c
c
c
c
c
c
b
b
a
a
a
a
a
a
a
a
a
a
a
a
a
a
a
a
a
a
a
a
a
a
"}
(69,1,1) = {"
a
a
a
a
a
a
a
a
a
a
a
a
a
b
c
c
c
c
c
k
c
c
f
c
c
c
c
c
c
c
c
f
c
c
c
c
c
d
c
c
c
c
c
c
c
u
u
u
v
c
c
c
c
c
c
c
c
b
a
a
a
a
a
a
a
a
a
a
a
a
a
a
a
a
a
a
a
a
a
a
"}
(70,1,1) = {"
a
a
a
a
a
a
a
a
a
a
a
a
a
b
c
c
c
c
c
c
c
c
c
c
c
c
c
c
c
c
c
c
c
c
c
c
c
c
c
c
c
c
c
c
c
u
u
u
u
c
c
c
c
c
k
c
c
b
a
a
a
a
a
a
a
a
a
a
a
a
a
a
a
a
a
a
a
a
a
a
"}
(71,1,1) = {"
a
a
a
a
a
a
a
a
a
a
a
a
a
b
c
c
c
c
c
c
c
c
c
d
c
c
c
c
c
c
c
c
c
c
c
i
c
c
c
c
c
c
f
c
c
u
u
u
u
c
i
c
c
c
c
c
c
b
b
a
a
a
a
a
a
a
a
a
a
a
a
a
a
a
a
a
a
a
a
a
"}
(72,1,1) = {"
a
a
a
a
a
a
a
a
a
a
a
a
a
b
c
c
c
i
c
c
c
c
c
c
c
c
e
c
c
c
c
i
c
c
c
c
c
c
c
c
c
c
c
c
d
u
u
u
u
d
c
c
c
c
c
c
c
c
b
a
a
a
a
a
a
a
a
a
a
a
a
a
a
a
a
a
a
a
a
a
"}
(73,1,1) = {"
a
a
a
a
a
a
a
a
a
a
a
a
a
b
b
c
c
f
c
c
c
c
c
c
c
c
c
c
c
c
c
c
c
c
c
c
j
c
c
c
c
c
c
c
c
u
u
u
u
c
c
c
c
c
c
c
c
c
b
a
a
a
a
a
a
a
a
a
a
a
a
a
a
a
a
a
a
a
a
a
"}
(74,1,1) = {"
a
a
a
a
a
a
a
a
a
a
a
a
a
a
b
c
c
c
c
c
g
g
c
c
c
c
c
f
c
c
c
c
c
c
c
c
c
c
c
c
c
c
c
f
c
u
v
u
u
c
c
c
c
f
c
f
c
c
b
a
a
a
a
a
a
a
a
a
a
a
a
a
a
a
a
a
a
a
a
a
"}
(75,1,1) = {"
a
a
a
a
a
a
a
a
a
a
a
a
a
a
b
c
c
c
c
c
c
g
g
g
c
c
c
c
c
c
c
c
f
c
c
c
f
c
c
i
c
c
c
c
c
u
u
u
u
c
c
c
c
c
c
c
c
c
b
b
a
a
a
a
a
a
a
a
a
a
a
a
a
a
a
a
a
a
a
a
"}
(76,1,1) = {"
a
a
a
a
a
a
a
a
a
a
a
a
a
a
b
c
c
c
c
c
c
c
c
g
c
c
i
c
g
c
c
c
c
c
c
c
c
c
c
c
c
c
c
c
c
u
u
u
u
c
c
c
c
c
c
c
c
c
c
b
a
a
a
a
a
a
a
a
a
a
a
a
a
a
a
a
a
a
a
a
"}
(77,1,1) = {"
a
a
a
a
a
a
a
a
a
a
a
a
a
a
b
c
g
c
c
c
c
c
l
c
c
c
c
g
g
c
f
c
c
c
c
c
c
c
c
c
c
c
c
c
d
u
u
u
u
d
c
c
c
c
c
c
c
c
c
b
a
a
a
a
a
a
a
a
a
a
a
a
a
a
a
a
a
a
a
a
"}
(78,1,1) = {"
a
a
a
a
a
a
a
a
a
a
a
a
a
a
b
c
c
g
c
c
c
c
g
c
c
c
c
g
c
c
c
c
c
c
c
d
c
c
c
c
c
c
c
c
c
u
u
u
u
c
c
c
c
c
c
c
c
b
b
b
a
a
a
a
a
a
a
a
a
a
a
a
a
a
a
a
a
a
a
a
"}
(79,1,1) = {"
a
a
a
a
a
a
a
a
a
a
a
a
a
a
b
c
c
g
g
k
c
c
g
c
c
c
g
c
c
c
c
c
c
c
c
c
c
c
c
c
c
f
c
c
c
v
u
u
u
c
c
f
c
c
c
b
b
b
a
a
a
a
a
a
a
a
a
a
a
a
a
a
a
a
a
a
a
a
a
a
"}
(80,1,1) = {"
a
a
a
a
a
a
a
a
a
a
a
a
a
a
b
c
c
c
g
c
c
c
g
c
c
c
g
c
c
c
c
c
t
c
c
c
c
c
f
c
c
c
c
c
c
u
u
u
u
c
c
c
c
c
b
b
a
a
a
a
a
a
a
a
a
a
a
a
a
a
a
a
a
a
a
a
a
a
a
a
"}
(81,1,1) = {"
a
a
a
a
a
a
a
a
a
a
a
a
a
a
b
c
c
c
g
g
c
g
c
c
c
f
g
c
c
d
c
c
c
c
c
c
c
c
c
c
c
c
c
c
c
u
u
u
u
c
c
c
c
b
b
a
a
a
a
a
a
a
a
a
a
a
a
a
a
a
a
a
a
a
a
a
a
a
a
a
"}
(82,1,1) = {"
a
a
a
a
a
a
a
a
a
a
a
a
a
a
b
c
c
c
c
g
c
g
c
g
c
c
c
g
c
c
c
c
c
f
j
c
c
c
c
c
c
c
f
c
d
u
u
u
u
d
c
c
b
b
a
a
a
a
a
a
a
a
a
a
a
a
a
a
a
a
a
a
a
a
a
a
a
a
a
a
"}
(83,1,1) = {"
a
a
a
a
a
a
a
a
a
a
a
a
a
a
b
c
c
c
c
g
c
g
c
g
c
c
c
g
c
c
c
c
c
c
c
c
c
c
c
c
c
c
c
c
c
c
c
c
c
c
c
b
b
a
a
a
a
a
a
a
a
a
a
a
a
a
a
a
a
a
a
a
a
a
a
a
a
a
a
a
"}
(84,1,1) = {"
a
a
a
a
a
a
a
a
a
a
a
a
a
a
b
b
c
c
c
g
c
g
c
c
g
c
g
g
c
g
g
c
c
c
c
c
g
f
c
c
k
c
c
c
c
c
c
c
c
c
b
b
a
a
a
a
a
a
a
a
a
a
a
a
a
a
a
a
a
a
a
a
a
a
a
a
a
a
a
a
"}
(85,1,1) = {"
a
a
a
a
a
a
a
a
a
a
a
a
a
a
a
b
c
c
c
l
g
g
c
c
g
c
g
c
c
g
c
c
c
c
g
g
g
c
c
c
c
c
c
c
c
c
f
c
c
c
b
a
a
a
a
a
a
a
a
a
a
a
a
a
a
a
a
a
a
a
a
a
a
a
a
a
a
a
a
a
"}
(86,1,1) = {"
a
a
a
a
a
a
a
a
a
a
a
a
a
a
a
b
c
c
c
c
g
g
g
d
g
c
g
c
g
g
c
f
c
c
g
c
c
c
c
c
c
c
c
j
c
c
c
c
k
c
b
a
a
a
a
a
a
a
a
a
a
a
a
a
a
a
a
a
a
a
a
a
a
a
a
a
a
a
a
a
"}
(87,1,1) = {"
a
a
a
a
a
a
a
a
a
a
a
a
a
a
a
b
b
c
c
c
g
c
g
g
g
g
g
k
g
c
c
c
c
g
g
c
c
c
c
c
c
c
c
c
c
c
c
c
c
c
b
b
a
a
a
a
a
a
a
a
a
a
a
a
a
a
a
a
a
a
a
a
a
a
a
a
a
a
a
a
"}
(88,1,1) = {"
a
a
a
a
a
a
a
a
a
a
a
a
a
a
a
a
b
c
c
c
g
c
g
g
g
g
c
c
g
c
c
c
g
g
c
c
f
c
c
c
c
d
c
c
c
c
c
c
c
c
c
b
a
a
a
a
a
a
a
a
a
a
a
a
a
a
a
a
a
a
a
a
a
a
a
a
a
a
a
a
"}
(89,1,1) = {"
a
a
a
a
a
a
a
a
a
a
a
a
a
a
a
a
b
c
c
c
c
g
g
i
c
g
f
g
c
c
c
c
g
c
c
c
g
c
c
c
c
c
c
c
c
c
c
c
c
c
c
b
a
a
a
a
a
a
a
a
a
a
a
a
a
a
a
a
a
a
a
a
a
a
a
a
a
a
a
a
"}
(90,1,1) = {"
a
a
a
a
a
a
a
a
a
a
a
a
a
a
a
a
b
c
c
c
c
g
g
g
c
g
g
g
g
g
c
g
g
r
c
g
g
c
c
c
c
c
c
c
c
c
c
c
c
c
c
b
b
a
a
a
a
a
a
a
a
a
a
a
a
a
a
a
a
a
a
a
a
a
a
a
a
a
a
a
"}
(91,1,1) = {"
a
a
a
a
a
a
a
a
a
a
a
a
a
a
a
a
b
c
c
i
c
g
g
g
c
g
g
g
c
g
c
g
g
c
g
g
c
c
c
f
c
c
c
c
j
c
c
c
c
c
c
c
b
a
a
a
a
a
a
a
a
a
a
a
a
a
a
a
a
a
a
a
a
a
a
a
a
a
a
a
"}
(92,1,1) = {"
a
a
a
a
a
a
a
a
a
a
a
a
a
a
a
a
b
c
c
c
g
g
l
g
g
g
g
g
c
g
g
g
c
g
g
c
c
g
g
c
c
c
c
c
c
c
c
f
c
c
c
c
b
b
a
a
a
a
A
a
a
a
a
a
a
a
a
a
a
a
a
a
a
a
a
a
a
a
a
a
"}
(93,1,1) = {"
a
a
a
a
a
a
a
a
a
a
a
a
a
a
a
a
b
b
c
c
c
g
g
g
g
c
g
c
g
l
g
c
g
g
c
c
g
g
c
f
c
c
c
c
c
c
c
c
c
c
c
c
c
b
b
a
a
a
a
a
a
a
a
a
a
a
a
a
a
a
a
a
a
a
a
a
a
a
a
a
"}
(94,1,1) = {"
a
a
a
a
a
a
a
a
a
a
a
a
a
a
a
a
a
b
c
c
c
g
g
g
c
d
g
c
g
g
c
g
g
g
g
g
g
c
c
c
c
c
c
c
c
f
c
c
c
c
d
c
c
c
b
b
a
a
a
a
a
a
a
a
a
a
a
a
a
a
a
a
a
a
a
a
a
a
a
a
"}
(95,1,1) = {"
a
a
a
a
a
a
a
a
a
a
a
a
a
a
a
a
a
b
c
c
g
g
g
g
c
c
g
g
l
g
g
g
g
g
g
f
c
c
c
c
c
c
c
c
c
c
c
c
c
c
c
c
c
c
c
b
b
a
a
a
a
a
a
a
a
a
a
a
a
a
a
a
a
a
a
a
a
a
a
a
"}
(96,1,1) = {"
a
a
a
a
a
a
a
a
a
a
a
a
a
a
a
a
a
b
c
c
c
g
g
g
c
c
g
g
g
g
g
g
f
g
c
c
c
g
c
c
c
c
c
c
c
e
c
c
c
c
c
c
c
c
c
c
b
a
a
a
a
a
a
a
a
a
a
a
a
a
a
a
a
a
a
a
a
a
a
a
"}
(97,1,1) = {"
a
a
a
a
a
a
a
a
a
a
a
a
a
a
a
a
a
b
c
c
c
c
g
g
g
c
g
g
g
g
g
c
g
g
c
g
g
g
c
c
c
g
g
g
c
c
c
c
c
c
j
c
c
c
c
c
b
b
a
a
a
a
a
a
a
a
a
a
a
a
a
a
a
a
a
a
a
a
a
a
"}
(98,1,1) = {"
a
a
a
a
a
a
a
a
a
a
a
a
a
a
a
a
a
b
c
c
c
c
c
g
g
g
g
c
g
g
g
g
g
g
g
c
g
l
g
g
g
g
c
c
c
c
c
c
c
c
c
c
c
c
c
c
c
b
b
a
a
a
a
a
a
a
a
a
a
a
a
a
a
a
a
a
a
a
a
a
"}
(99,1,1) = {"
a
a
a
a
a
a
a
a
a
a
a
a
a
a
a
a
a
b
c
c
g
g
i
b
b
g
b
b
g
g
g
g
g
g
g
l
g
c
c
c
c
c
g
c
c
c
c
k
c
c
c
c
c
c
j
c
c
c
b
a
a
a
a
a
a
a
a
a
a
a
a
a
a
a
a
a
a
a
a
a
"}
(100,1,1) = {"
a
a
a
a
a
a
a
a
a
a
a
a
a
a
a
a
a
b
c
c
d
g
g
b
g
g
g
b
g
g
g
g
g
c
c
g
g
g
g
g
g
g
g
c
c
c
c
c
f
c
j
c
c
c
c
c
c
c
b
a
a
a
a
a
a
a
a
a
a
a
a
a
a
a
a
a
a
a
a
a
"}
(101,1,1) = {"
a
a
a
a
a
a
a
a
a
a
a
a
a
a
a
a
a
b
c
c
c
c
b
b
g
b
g
b
b
g
g
g
g
l
g
g
c
c
c
c
c
f
c
c
c
c
c
c
c
c
c
c
c
f
c
c
c
c
b
a
a
a
a
a
a
a
a
a
a
a
a
a
a
a
a
a
a
a
a
a
"}
(102,1,1) = {"
a
a
a
a
a
a
a
a
a
a
a
a
a
a
a
a
a
b
b
c
c
c
b
g
c
g
g
g
b
g
g
g
g
g
g
g
g
g
g
g
c
c
c
c
c
c
d
c
c
c
c
c
c
c
c
c
f
c
b
a
a
a
a
a
a
a
a
a
a
a
a
a
a
a
a
a
a
a
a
a
"}
(103,1,1) = {"
a
a
a
a
a
a
a
a
a
a
a
a
a
a
a
a
a
a
b
c
c
c
b
g
g
g
g
g
b
g
g
g
c
c
c
c
d
c
c
g
g
g
c
c
c
c
c
c
c
c
c
c
c
d
c
c
c
c
b
a
a
a
a
a
a
a
a
a
a
a
a
a
a
a
a
a
a
a
a
a
"}
(104,1,1) = {"
a
a
a
a
a
a
a
a
a
a
a
a
a
a
a
a
a
a
b
c
c
c
b
c
d
g
r
c
b
c
c
g
g
g
c
c
c
c
c
c
c
c
c
c
c
c
c
j
c
c
c
c
c
c
c
c
f
c
b
a
a
a
a
a
a
a
a
a
a
a
a
a
a
a
a
a
a
a
a
a
"}
(105,1,1) = {"
a
a
a
a
a
a
a
a
a
a
a
a
a
a
a
a
a
a
b
b
b
b
b
b
b
n
b
b
b
b
b
c
d
g
g
g
g
c
c
f
c
c
c
c
c
c
c
c
c
c
c
c
c
c
c
c
c
c
b
a
a
a
a
a
a
a
a
a
a
a
a
a
a
a
a
a
a
a
a
a
"}
(106,1,1) = {"
a
a
a
a
a
a
a
a
a
a
a
a
a
a
a
a
a
a
b
b
b
p
n
n
n
n
n
n
n
n
b
c
c
c
c
c
g
c
c
c
c
c
c
f
c
f
c
c
c
c
f
c
c
j
c
c
c
c
b
a
a
a
a
a
a
a
a
a
a
a
a
a
a
a
a
a
a
a
a
a
"}
(107,1,1) = {"
a
a
a
a
a
a
a
a
a
a
a
a
a
a
a
a
a
a
b
b
b
n
n
n
n
n
n
n
n
n
b
c
c
c
f
c
c
c
c
c
k
c
c
c
c
c
c
f
c
c
c
c
c
c
c
f
c
c
b
a
a
a
a
a
a
a
a
a
a
a
a
a
a
a
a
a
a
a
a
a
"}
(108,1,1) = {"
a
a
a
a
a
a
a
a
a
a
a
a
a
a
a
a
a
a
a
b
b
n
n
n
n
n
n
o
n
n
b
c
c
c
c
c
c
c
c
c
c
c
c
c
c
c
c
c
c
c
e
c
c
c
c
c
c
c
b
a
a
a
a
a
a
a
a
a
a
a
a
a
a
a
a
a
a
a
a
a
"}
(109,1,1) = {"
a
a
a
a
a
a
a
a
a
a
a
a
a
a
a
a
a
a
a
b
b
b
n
n
n
n
n
b
b
b
b
c
c
c
c
c
c
c
c
c
c
c
c
c
c
c
c
c
c
c
c
c
c
c
c
c
c
c
b
a
a
a
a
a
a
a
a
a
a
a
a
a
a
a
a
a
a
a
a
a
"}
(110,1,1) = {"
a
a
a
a
a
a
a
a
a
a
a
a
a
a
a
a
a
a
a
b
b
b
n
n
n
n
b
b
b
b
b
b
b
b
b
b
b
b
b
b
b
b
b
b
c
c
c
c
d
c
c
c
c
c
c
c
f
c
b
a
a
a
a
a
a
a
a
a
a
a
a
a
a
a
a
a
a
a
a
a
"}
(111,1,1) = {"
a
a
a
a
a
a
a
a
a
a
a
a
a
a
a
a
a
a
a
a
b
b
n
n
n
b
b
b
b
a
a
a
a
a
a
a
a
a
a
a
a
a
a
b
b
b
b
c
c
c
c
c
c
c
f
c
c
c
b
b
a
a
a
a
a
a
a
a
a
a
a
a
a
a
a
a
a
a
a
a
"}
(112,1,1) = {"
a
a
a
a
a
a
a
a
a
a
a
a
a
a
a
a
a
a
a
a
b
b
b
n
b
b
b
b
a
a
a
a
a
a
a
a
a
a
a
a
a
a
a
a
a
a
b
c
f
c
c
c
c
f
c
c
c
c
b
b
a
a
a
a
a
a
a
a
a
a
a
a
a
a
a
a
a
a
a
a
"}
(113,1,1) = {"
a
a
a
a
a
a
a
a
a
a
a
a
a
a
a
a
a
a
a
a
b
b
n
q
n
b
b
a
a
a
a
a
a
a
a
a
a
a
a
a
a
a
a
a
a
a
b
c
c
c
c
c
c
c
c
b
b
b
b
a
a
a
a
a
a
a
a
a
a
a
a
a
a
a
a
a
a
a
a
a
"}
(114,1,1) = {"
a
a
a
a
a
a
a
a
a
a
a
a
a
a
a
a
a
a
a
b
b
n
n
b
n
o
b
a
a
a
a
a
a
a
a
a
a
a
a
a
a
a
a
a
a
a
b
c
c
c
b
b
b
b
b
b
a
a
a
a
a
a
a
a
a
a
a
a
a
a
a
a
a
a
a
a
a
a
a
a
"}
(115,1,1) = {"
a
a
a
a
a
a
a
a
a
a
a
a
a
a
a
a
a
a
a
b
o
n
n
n
n
n
b
a
a
a
a
a
a
a
a
a
a
a
a
a
a
a
a
a
a
a
b
b
b
b
b
a
a
a
a
a
a
a
a
a
a
a
a
a
a
a
a
a
a
a
a
a
a
a
a
a
a
a
a
a
"}
(116,1,1) = {"
a
a
a
a
a
a
a
a
a
a
a
a
a
a
a
a
a
a
a
b
n
n
n
n
n
n
b
a
a
a
a
a
a
a
a
a
a
a
a
a
a
a
a
a
a
a
a
a
a
a
a
a
a
a
a
a
a
a
a
a
a
a
a
a
a
a
a
a
a
a
a
a
a
a
a
a
a
a
a
a
"}
(117,1,1) = {"
a
a
a
a
a
a
a
a
a
a
a
a
a
a
a
a
a
a
b
b
n
n
n
n
n
n
b
b
a
a
a
a
a
a
a
a
a
a
a
a
a
a
a
a
a
a
a
a
a
a
a
a
a
a
a
a
a
a
a
a
a
a
a
A
a
a
a
a
a
a
a
a
a
a
a
a
a
a
a
a
"}
(118,1,1) = {"
a
a
a
a
a
a
a
a
a
a
a
a
a
a
a
a
a
a
b
m
n
n
n
n
n
n
b
b
a
a
a
a
a
a
a
a
a
a
a
a
a
a
a
a
a
a
a
a
a
a
a
a
a
a
a
a
a
a
a
a
a
a
a
a
a
a
a
a
a
a
a
a
a
a
a
a
a
a
a
a
"}
(119,1,1) = {"
a
a
a
a
a
a
a
a
a
a
a
a
a
a
a
a
a
a
b
n
n
n
o
n
n
n
b
b
a
a
a
a
a
a
a
a
a
a
a
a
a
a
a
a
a
a
a
a
a
a
a
a
a
a
a
a
a
a
a
a
a
a
a
a
a
a
a
a
a
a
a
a
a
a
a
a
a
a
a
a
"}
(120,1,1) = {"
a
a
a
a
a
a
a
a
a
a
a
a
a
a
a
a
a
a
b
b
b
b
b
b
b
b
b
a
a
a
a
a
a
a
a
a
a
a
a
a
a
a
a
a
a
a
a
a
a
a
a
a
a
a
a
a
a
a
a
a
a
a
a
a
a
a
a
a
a
a
a
a
a
a
a
a
a
a
a
a
"}
