//MAP CONVERTED BY dmm2tgm.py THIS HEADER COMMENT PREVENTS RECONVERSION, DO NOT REMOVE
"a" = (
/turf/open/misc/asteroid/basalt/lava_land_surface,
/area/lavaland/surface/outdoors)
"b" = (
/obj/machinery/light/small/directional/north,
/turf/open/floor/mineral/silver,
/area/ruin/powered/pride)
"c" = (
/turf/open/lava/smooth/lava_land_surface,
/area/lavaland/surface/outdoors)
"f" = (
/obj/structure/mirror/directional/west,
/turf/open/floor/carpet/red,
/area/ruin/powered/pride)
"g" = (
/turf/open/floor/mineral/silver,
/area/ruin/powered/pride)
"i" = (
/obj/structure/mirror/directional/east,
/obj/machinery/light/small/directional/east,
/turf/open/floor/mineral/silver,
/area/ruin/powered/pride)
"j" = (
/obj/structure/mirror/magic/pride,
/turf/closed/wall/mineral/diamond,
/area/ruin/powered/pride)
"k" = (
/obj/structure/table/wood/fancy/red,
/obj/item/clothing/under/chameleon{
	armor = null
	},
/turf/open/floor/mineral/silver,
/area/ruin/powered/pride)
"l" = (
/obj/structure/table/wood/fancy/red,
/obj/item/dyespray,
/turf/open/floor/mineral/silver,
/area/ruin/powered/pride)
"m" = (
/obj/structure/mirror/directional/east,
/turf/open/floor/carpet/red,
/area/ruin/powered/pride)
"q" = (
/obj/structure/mirror/directional/east,
/turf/open/floor/mineral/silver,
/area/ruin/powered/pride)
"r" = (
/turf/open/floor/carpet/red,
/area/ruin/powered/pride)
"G" = (
/turf/closed/wall/mineral/diamond,
/area/ruin/powered/pride)
"N" = (
/obj/machinery/door/airlock/diamond,
/turf/open/floor/carpet/red,
/area/ruin/powered/pride)
"O" = (
/obj/structure/mirror/directional/west,
/turf/open/floor/mineral/silver,
/area/ruin/powered/pride)
"X" = (
/obj/structure/mirror/directional/west,
/obj/machinery/light/small/directional/west,
/turf/open/floor/mineral/silver,
/area/ruin/powered/pride)
"Y" = (
/obj/machinery/light/small/directional/south,
/turf/open/floor/mineral/silver,
/area/ruin/powered/pride)

(1,1,1) = {"
a
a
a
a
a
a
a
a
a
a
a
a
"}
(2,1,1) = {"
a
G
G
G
G
G
G
G
G
G
c
a
"}
(3,1,1) = {"
a
G
b
f
f
O
X
O
O
G
G
a
"}
(4,1,1) = {"
a
G
G
l
r
r
g
g
g
Y
G
a
"}
(5,1,1) = {"
a
a
G
j
r
r
r
r
r
r
N
a
"}
(6,1,1) = {"
a
G
G
k
r
r
g
g
g
Y
G
a
"}
(7,1,1) = {"
a
G
b
m
m
q
i
q
q
G
G
a
"}
(8,1,1) = {"
a
G
G
G
G
G
G
G
G
G
c
a
"}
(9,1,1) = {"
a
a
a
a
a
a
a
a
a
a
a
a
"}
