//MAP CONVERTED BY dmm2tgm.py THIS HEADER COMMENT PREVENTS RECONVERSION, DO NOT REMOVE
"aa" = (
/obj/effect/mob_spawn/human/seed_vault,
/turf/open/floor/plasteel/hydrofloor,
/area/ruin/powered/seedvault)
"ab" = (
/turf/open/floor/plating/asteroid/basalt/lava_land_surface,
/area/lavaland/surface/outdoors)
"ac" = (
/turf/template_noop,
/area/template_noop)
"ad" = (
/obj/structure/table/glass,
/obj/item/storage/box/disks_plantgene,
/obj/item/storage/box/disks_plantgene{
	pixel_x = 5;
	pixel_y = 5
	},
/obj/machinery/airalarm/all_access{
	pixel_y = 28;
	name = "Seed Vault Air Alarm"
	},
/turf/open/floor/plasteel/green/side{
	dir = 5
	},
/area/ruin/powered/seedvault)
"ae" = (
/obj/structure/rack,
/obj/effect/turf_decal/bot,
/obj/item/mop,
/obj/item/soap,
/obj/item/reagent_containers/glass/bucket,
/turf/open/floor/plating,
/area/ruin/powered/seedvault)
"af" = (
/obj/effect/mob_spawn/human/seed_vault,
/obj/machinery/light/small{
	dir = 1
	},
/turf/open/floor/plasteel/hydrofloor,
/area/ruin/powered/seedvault)
"ag" = (
/turf/open/floor/plasteel/green/side{
	dir = 6
	},
/area/ruin/powered/seedvault)
"ah" = (
/obj/machinery/smartfridge/disks,
/turf/closed/wall/mineral/titanium,
/area/ruin/powered/seedvault)
"ai" = (
/obj/structure/table/reinforced,
/obj/item/paper_bin,
/obj/item/pen,
/turf/open/floor/plasteel/hydrofloor,
/area/ruin/powered/seedvault)
"aj" = (
/obj/structure/table/reinforced,
/turf/open/floor/plasteel/hydrofloor,
/area/ruin/powered/seedvault)
"ak" = (
/obj/effect/spawner/structure/window/shuttle,
/obj/machinery/door/poddoor{
	id = "seedvault_blastdoors"
	},
/turf/open/floor/plating,
/area/ruin/powered/seedvault)
"al" = (
/turf/open/floor/plasteel/hydrofloor,
/area/ruin/powered/seedvault)
"am" = (
/turf/closed/wall/mineral/titanium,
/area/ruin/powered/seedvault)
"an" = (
/obj/effect/mob_spawn/human/seed_vault,
/obj/effect/decal/cleanable/cobweb,
/turf/open/floor/plasteel/hydrofloor,
/area/ruin/powered/seedvault)
"ao" = (
/turf/open/floor/plasteel,
/area/ruin/powered/seedvault)
"ap" = (
/obj/machinery/door/airlock{
	name = "Organic Storage"
	},
/obj/machinery/atmospherics/pipe/simple/supply/hidden,
/obj/effect/turf_decal/delivery,
/turf/open/floor/plating,
/area/ruin/powered/seedvault)
"aq" = (
/obj/effect/decal/cleanable/dirt,
/turf/open/floor/plasteel/hydrofloor,
/area/ruin/powered/seedvault)
"ar" = (
/obj/machinery/atmospherics/components/unary/vent_pump/on{
	dir = 4
	},
/turf/open/floor/plasteel,
/area/ruin/powered/seedvault)
"as" = (
/obj/structure/shuttle/engine/propulsion{
	dir = 8
	},
/turf/open/floor/plasteel,
/area/ruin/powered/seedvault)
"at" = (
/obj/structure/shuttle/engine/heater{
	dir = 8
	},
/obj/structure/window/plasma/reinforced/spawner/east,
/turf/open/floor/plasteel,
/area/ruin/powered/seedvault)
"au" = (
/obj/machinery/atmospherics/components/unary/vent_pump/on{
	dir = 4
	},
/obj/effect/decal/cleanable/dirt,
/turf/open/floor/plasteel/hydrofloor,
/area/ruin/powered/seedvault)
"av" = (
/obj/effect/turf_decal/stripes/line{
	dir = 5
	},
/turf/open/floor/plating,
/area/ruin/powered/seedvault)
"aw" = (
/obj/structure/reagent_dispensers/watertank/high,
/turf/open/floor/plasteel/green/side{
	dir = 6
	},
/area/ruin/powered/seedvault)
"ax" = (
/obj/machinery/atmospherics/pipe/simple/supply/hidden{
	dir = 4
	},
/obj/effect/decal/cleanable/dirt,
/turf/open/floor/plasteel/hydrofloor,
/area/ruin/powered/seedvault)
"ay" = (
/obj/item/twohanded/required/kirbyplants{
	icon_state = "plant-10"
	},
/turf/open/floor/plasteel/green/side{
	dir = 9
	},
/area/ruin/powered/seedvault)
"az" = (
/obj/machinery/hydroponics/constructable,
/turf/open/floor/plasteel/green/side{
	dir = 1
	},
/area/ruin/powered/seedvault)
"aA" = (
/obj/machinery/atmospherics/pipe/simple/supply/hidden,
/turf/open/floor/plasteel/green/side{
	dir = 1
	},
/area/ruin/powered/seedvault)
"aB" = (
/obj/structure/rack,
/obj/item/storage/toolbox/emergency{
	pixel_x = -5;
	pixel_y = -5
	},
/obj/item/storage/toolbox/mechanical,
/obj/item/storage/toolbox/electrical{
	pixel_x = 5;
	pixel_y = 5
	},
/turf/open/floor/plasteel/hydrofloor,
/area/ruin/powered/seedvault)
"aC" = (
/obj/structure/table/reinforced,
/obj/item/gun/energy/floragun{
	pixel_x = 4;
	pixel_y = 4
	},
/obj/item/gun/energy/floragun{
	pixel_x = 2;
	pixel_y = 2
	},
/obj/item/gun/energy/floragun{
	pixel_x = -2;
	pixel_y = -2
	},
/obj/item/gun/energy/floragun{
	pixel_x = -4;
	pixel_y = -4
	},
/turf/open/floor/plasteel/hydrofloor,
/area/ruin/powered/seedvault)
"aD" = (
/obj/machinery/hydroponics/constructable,
/obj/machinery/light{
	dir = 1;
	light_color = "#d1dfff"
	},
/turf/open/floor/plasteel/green/side{
	dir = 5
	},
/area/ruin/powered/seedvault)
"aE" = (
/obj/machinery/seed_extractor,
/turf/open/floor/plasteel/hydrofloor,
/area/ruin/powered/seedvault)
"aF" = (
/obj/effect/decal/cleanable/dirt,
/turf/open/floor/plating,
/area/ruin/powered/seedvault)
"aG" = (
/obj/machinery/hydroponics/constructable,
/turf/open/floor/plasteel/green/side{
	dir = 8
	},
/area/ruin/powered/seedvault)
"aH" = (
/obj/effect/decal/cleanable/dirt,
/turf/open/floor/plasteel,
/area/ruin/powered/seedvault)
"aI" = (
/obj/machinery/computer/shuttle{
	dir = 8;
	name = "ship console"
	},
/turf/open/floor/plasteel/hydrofloor,
/area/ruin/powered/seedvault)
"aJ" = (
/obj/structure/table/glass,
/obj/item/book/manual/hydroponics_pod_people,
/obj/item/paper/guides/jobs/hydroponics,
/obj/machinery/light{
	dir = 1;
	light_color = "#d1dfff"
	},
/turf/open/floor/plasteel/green/side{
	dir = 1
	},
/area/ruin/powered/seedvault)
"aK" = (
/obj/effect/decal/cleanable/dirt,
/turf/open/floor/plasteel/green/side{
	dir = 1
	},
/area/ruin/powered/seedvault)
"aL" = (
/obj/machinery/atmospherics/pipe/simple/supply/hidden{
	dir = 9
	},
/obj/machinery/light,
/turf/open/floor/plasteel/hydrofloor,
/area/ruin/powered/seedvault)
"aM" = (
/obj/machinery/vending/hydroseeds,
/turf/open/floor/plasteel/green/side,
/area/ruin/powered/seedvault)
"aN" = (
/obj/machinery/vending/hydronutrients,
/obj/machinery/light,
/turf/open/floor/plasteel/green/side,
/area/ruin/powered/seedvault)
"aO" = (
/obj/machinery/vending/cigarette,
/turf/open/floor/plasteel/green/side{
	dir = 6
	},
/area/ruin/powered/seedvault)
"aP" = (
/obj/machinery/door/airlock/external,
/obj/effect/turf_decal/delivery,
/obj/structure/fans/tiny,
/turf/open/floor/plating,
/area/ruin/powered/seedvault)
"aQ" = (
/obj/machinery/atmospherics/pipe/simple/supply/hidden{
	dir = 4
	},
/turf/open/floor/plasteel/hydrofloor,
/area/ruin/powered/seedvault)
"aR" = (
/obj/machinery/hydroponics/constructable,
/obj/machinery/light,
/turf/open/floor/plasteel/green/side{
	dir = 6
	},
/area/ruin/powered/seedvault)
"aS" = (
/obj/machinery/atmospherics/pipe/simple/supply/hidden{
	dir = 10
	},
/turf/open/floor/plasteel/hydrofloor,
/area/ruin/powered/seedvault)
"aT" = (
/obj/structure/table/glass,
/obj/machinery/plantgenes/seedvault,
/turf/open/floor/plasteel/green/side{
	dir = 5
	},
/area/ruin/powered/seedvault)
"aU" = (
/obj/structure/table/reinforced,
/obj/effect/spawner/lootdrop/seed_vault,
/turf/open/floor/plasteel/hydrofloor,
/area/ruin/powered/seedvault)
"aV" = (
/obj/structure/closet/wardrobe/botanist,
/turf/open/floor/plasteel/hydrofloor,
/area/ruin/powered/seedvault)
"aW" = (
/obj/structure/closet/crate/beekeeping,
/turf/open/floor/plasteel/hydrofloor,
/area/ruin/powered/seedvault)
"aX" = (
/obj/machinery/light/small{
	dir = 1
	},
/obj/effect/decal/cleanable/dirt,
/turf/open/floor/plasteel/hydrofloor,
/area/ruin/powered/seedvault)
"aY" = (
/obj/machinery/atmospherics/pipe/simple/supply/hidden{
	dir = 9
	},
/turf/open/floor/plasteel/hydrofloor,
/area/ruin/powered/seedvault)
"aZ" = (
/obj/effect/turf_decal/stripes/line{
	dir = 6
	},
/obj/structure/sign/warning/vacuum{
	pixel_x = -32
	},
/obj/machinery/light,
/turf/open/floor/plating,
/area/ruin/powered/seedvault)
"ba" = (
/obj/machinery/atmospherics/pipe/manifold4w/supply/hidden,
/obj/effect/decal/cleanable/dirt,
/turf/open/floor/plasteel/hydrofloor,
/area/ruin/powered/seedvault)
"bb" = (
/turf/closed/mineral/volcanic/lava_land_surface,
/area/lavaland/surface/outdoors)
"bc" = (
/obj/structure/table/reinforced,
/obj/machinery/button/door{
	id = "seedvault_blastdoors";
	name = "blast door control"
	},
/turf/open/floor/plasteel/hydrofloor,
/area/ruin/powered/seedvault)
"bd" = (
/obj/machinery/atmospherics/components/unary/tank/air,
/obj/effect/turf_decal/bot,
/turf/open/floor/plating,
/area/ruin/powered/seedvault)
"be" = (
/obj/structure/extinguisher_cabinet{
	pixel_y = 32
	},
/obj/effect/turf_decal/stripes/line{
	dir = 5
	},
/obj/structure/sign/warning/vacuum{
	pixel_x = -32
	},
/obj/machinery/light{
	dir = 1;
	light_color = "#d1dfff"
	},
/turf/open/floor/plating,
/area/ruin/powered/seedvault)
"bf" = (
/obj/machinery/atmospherics/components/unary/vent_pump/on,
/turf/open/floor/plating,
/area/ruin/powered/seedvault)
"bg" = (
/obj/machinery/atmospherics/pipe/simple/supply/hidden,
/turf/open/floor/plating,
/area/ruin/powered/seedvault)
"bh" = (
/obj/structure/table/reinforced,
/obj/effect/spawner/lootdrop/seed_vault,
/obj/machinery/light/small,
/turf/open/floor/plasteel/hydrofloor,
/area/ruin/powered/seedvault)
"bi" = (
/obj/effect/turf_decal/stripes/line{
	dir = 4
	},
/obj/effect/decal/cleanable/dirt,
/obj/effect/turf_decal/caution{
	dir = 4
	},
/turf/open/floor/plating,
/area/ruin/powered/seedvault)
"bj" = (
/obj/machinery/atmospherics/pipe/simple/supply/hidden,
/turf/open/floor/plasteel,
/area/ruin/powered/seedvault)
"bk" = (
/obj/machinery/door/airlock/external,
/obj/machinery/atmospherics/pipe/simple/supply/hidden{
	dir = 4
	},
/obj/effect/turf_decal/delivery,
/turf/open/floor/plating,
/area/ruin/powered/seedvault)
"bl" = (
/obj/structure/table/reinforced,
/obj/item/watertank,
/obj/item/watertank{
	pixel_x = 5;
	pixel_y = 5
	},
/turf/open/floor/plasteel/hydrofloor,
/area/ruin/powered/seedvault)
"bm" = (
/obj/structure/table/reinforced,
/obj/item/storage/box/lights/mixed,
/obj/item/lightreplacer{
	pixel_x = 5;
	pixel_y = 5
	},
/turf/open/floor/plasteel/hydrofloor,
/area/ruin/powered/seedvault)
"bn" = (
/obj/machinery/hydroponics/constructable,
/turf/open/floor/plasteel/green/side{
	dir = 10
	},
/area/ruin/powered/seedvault)
"bo" = (
/obj/machinery/atmospherics/pipe/simple/supply/hidden{
	dir = 5
	},
/turf/open/floor/plasteel/green/side{
	dir = 1
	},
/area/ruin/powered/seedvault)
"bp" = (
/obj/machinery/door/airlock{
	name = "Cockpit"
	},
/obj/machinery/atmospherics/pipe/simple/supply/hidden{
	dir = 4
	},
/obj/effect/turf_decal/delivery,
/turf/open/floor/plating,
/area/ruin/powered/seedvault)
"bq" = (
/obj/item/twohanded/required/kirbyplants{
	icon_state = "plant-03"
	},
/turf/open/floor/plasteel/green/side{
	dir = 10
	},
/area/ruin/powered/seedvault)
"br" = (
/obj/machinery/door/airlock{
	name = "Inorganic Storage"
	},
/obj/machinery/atmospherics/pipe/simple/supply/hidden,
/obj/effect/turf_decal/delivery,
/turf/open/floor/plating,
/area/ruin/powered/seedvault)
"bs" = (
/obj/machinery/atmospherics/components/unary/vent_pump/on,
/obj/effect/decal/cleanable/dirt,
/turf/open/floor/plasteel/hydrofloor,
/area/ruin/powered/seedvault)
"bt" = (
/obj/machinery/atmospherics/pipe/manifold/supply/hidden{
	dir = 4
	},
/turf/open/floor/plasteel,
/area/ruin/powered/seedvault)
"bu" = (
/obj/machinery/atmospherics/pipe/manifold/supply/hidden{
	dir = 8
	},
/turf/open/floor/plasteel,
/area/ruin/powered/seedvault)
"bv" = (
/obj/machinery/atmospherics/components/unary/vent_pump/on{
	dir = 8
	},
/turf/open/floor/plasteel,
/area/ruin/powered/seedvault)
"bw" = (
/obj/machinery/atmospherics/pipe/manifold/supply/hidden{
	dir = 8
	},
/turf/open/floor/plating,
/area/ruin/powered/seedvault)
"bx" = (
/turf/open/floor/plasteel/green/side,
/area/ruin/powered/seedvault)
"by" = (
/obj/machinery/chem_dispenser/fullupgrade/mutagensaltpeter,
/turf/open/floor/plasteel/green/side,
/area/ruin/powered/seedvault)
"bz" = (
/obj/structure/table/glass,
/obj/item/storage/box/beakers_bluespace,
/obj/item/storage/box/syringes,
/turf/open/floor/plasteel/green/side,
/area/ruin/powered/seedvault)
"bA" = (
/obj/machinery/chem_master/condimaster,
/turf/open/floor/plasteel/green/side,
/area/ruin/powered/seedvault)
"bB" = (
/obj/machinery/hydroponics/constructable,
/turf/open/floor/plasteel/green/side,
/area/ruin/powered/seedvault)
"bC" = (
/obj/machinery/atmospherics/pipe/simple/supply/hidden{
	dir = 4
	},
/obj/effect/decal/cleanable/oil{
	icon_state = "floor5"
	},
/turf/open/floor/plasteel/hydrofloor,
/area/ruin/powered/seedvault)
"bD" = (
/obj/machinery/hydroponics/constructable,
/turf/open/floor/plasteel/green/side{
	dir = 9
	},
/area/ruin/powered/seedvault)
"bE" = (
/turf/open/floor/plasteel/green/side{
	dir = 1
	},
/area/ruin/powered/seedvault)
"bF" = (
/obj/machinery/biogenerator,
/turf/open/floor/plasteel/green/side{
	dir = 1
	},
/area/ruin/powered/seedvault)
"bG" = (
/obj/structure/table/glass,
/obj/machinery/reagentgrinder,
/obj/machinery/atmospherics/pipe/simple/supply/hidden,
/turf/open/floor/plasteel/green/side{
	dir = 1
	},
/area/ruin/powered/seedvault)
"bH" = (
/obj/machinery/smartfridge/food,
/turf/open/floor/plasteel/green/side{
	dir = 1
	},
/area/ruin/powered/seedvault)
"bI" = (
/obj/effect/turf_decal/stripes/line{
	dir = 6
	},
/obj/effect/decal/cleanable/dirt,
/turf/open/floor/plating,
/area/ruin/powered/seedvault)
"bJ" = (
/obj/machinery/atmospherics/pipe/simple/supply/hidden,
/turf/open/floor/plasteel/green/side,
/area/ruin/powered/seedvault)
"bK" = (
/obj/machinery/atmospherics/pipe/simple/supply/hidden{
	dir = 4
	},
/turf/open/floor/plasteel/green/side{
	dir = 5
	},
/area/ruin/powered/seedvault)
"bL" = (
/obj/machinery/atmospherics/pipe/simple/supply/hidden,
/obj/effect/decal/cleanable/dirt,
/turf/open/floor/plating,
/area/ruin/powered/seedvault)
"bM" = (
/obj/structure/closet/hydroponics_deluxe,
/obj/effect/decal/cleanable/dirt,
/turf/open/floor/plasteel/hydrofloor,
/area/ruin/powered/seedvault)
"bP" = (
/obj/machinery/hydroponics/constructable,
/obj/machinery/light,
/turf/open/floor/plasteel/green/side,
/area/ruin/powered/seedvault)
"bS" = (
/obj/machinery/hydroponics/constructable,
/obj/machinery/light{
	dir = 1;
	light_color = "#d1dfff"
	},
/turf/open/floor/plasteel/green/side{
	dir = 1
	},
/area/ruin/powered/seedvault)
"bT" = (
/obj/machinery/hydroponics/constructable,
/obj/machinery/light{
	dir = 8
	},
/turf/open/floor/plasteel/green/side{
	dir = 8
	},
/area/ruin/powered/seedvault)

(1,1,1) = {"
ab
ab
ab
ab
ab
ab
ab
ab
ab
ab
ab
ab
ab
ab
ab
ab
ab
ab
ab
ab
bb
ab
"}
(2,1,1) = {"
ab
bb
ab
ab
ab
ab
ab
ab
ab
ab
ab
ab
ab
ab
ab
ab
ab
ab
ab
bb
bb
ab
"}
(3,1,1) = {"
bb
bb
ab
ab
ab
ab
ab
ab
ab
ab
ab
ab
ab
ab
ab
ab
ab
ab
ab
bb
bb
ab
"}
(4,1,1) = {"
bb
bb
ab
ab
ab
ab
am
am
aP
am
am
am
aP
am
am
ab
ab
ab
ab
bb
bb
ab
"}
(5,1,1) = {"
bb
bb
ab
as
as
am
am
av
bi
aZ
am
be
bi
bI
am
am
as
as
ab
bb
bb
bb
"}
(6,1,1) = {"
bb
bb
am
at
at
am
ae
aF
aF
bf
bw
bg
bg
bL
bd
am
at
at
am
bb
bb
bb
"}
(7,1,1) = {"
bb
bb
am
an
al
am
am
am
am
am
bk
am
am
am
am
am
aW
aV
am
bb
bb
bb
"}
(8,1,1) = {"
bb
bb
am
aa
aq
am
ay
aG
bT
bn
ax
bD
bT
aG
bq
am
aq
bM
am
bb
bb
bb
"}
(9,1,1) = {"
bb
bb
am
af
au
am
bS
ao
aH
bx
aQ
bE
aH
aH
bP
am
au
bh
am
bb
bb
bb
"}
(10,1,1) = {"
bb
bb
am
aa
ax
am
az
aH
ar
by
ax
bF
aH
ao
bB
am
ax
bl
am
bb
bb
bb
"}
(11,1,1) = {"
bb
bb
am
aa
aS
ap
aA
bj
bt
bz
ba
bG
bu
bj
bJ
br
aY
bm
am
bb
bb
bb
"}
(12,1,1) = {"
bb
bb
am
am
am
am
aD
ao
ao
bA
ax
bH
bv
ao
aR
am
am
am
am
bb
bb
ac
"}
(13,1,1) = {"
ac
bb
bb
bb
bb
am
am
aK
aH
bB
ax
az
aH
aM
am
am
bb
bb
bb
bb
ac
ac
"}
(14,1,1) = {"
ac
bb
bb
bb
bb
bb
am
aJ
aH
bB
aQ
az
aH
aN
am
bb
bb
bb
bb
bb
bb
ac
"}
(15,1,1) = {"
ac
bb
bb
bb
bb
bb
am
ad
aH
bx
aS
bo
aH
aO
am
bb
bb
bb
bb
bb
bb
ac
"}
(16,1,1) = {"
ac
bb
bb
bb
bb
bb
am
am
aT
ag
aE
bK
aw
am
am
bb
bb
bb
bb
bb
bb
ac
"}
(17,1,1) = {"
ac
bb
bb
bb
bb
bb
bb
am
am
ah
am
bp
am
am
bb
bb
bb
bb
bb
bb
bb
ac
"}
(18,1,1) = {"
ac
ac
bb
bb
bb
bb
bb
bb
am
ai
aC
aQ
am
bb
bb
bb
bb
bb
bb
bb
bb
ac
"}
(19,1,1) = {"
ac
ac
bb
bb
bb
bb
bb
bb
am
aj
al
bC
am
bb
bb
bb
bb
bb
ac
ac
ac
ac
"}
(20,1,1) = {"
ac
ac
ac
bb
bb
bb
bb
bb
am
aX
bs
aL
am
bb
bb
bb
bb
ac
ac
ac
ac
ac
"}
(21,1,1) = {"
ac
ac
ac
ac
bb
bb
bb
bb
am
aq
aq
bc
am
bb
bb
bb
ac
ac
ac
ac
ac
ac
"}
(22,1,1) = {"
ac
ac
ac
ac
bb
bb
bb
bb
ak
aB
aq
aU
ak
bb
bb
bb
ac
ac
ac
ac
ac
ac
"}
(23,1,1) = {"
ac
ac
ac
ac
bb
bb
bb
bb
ak
ak
aI
ak
ak
bb
bb
bb
ac
ac
ac
ac
ac
ac
"}
(24,1,1) = {"
ac
ac
ac
ac
bb
bb
bb
bb
bb
ak
ak
ak
bb
bb
bb
ac
ac
ac
ac
ac
ac
ac
"}
(25,1,1) = {"
ac
ac
ac
ac
bb
bb
bb
bb
bb
bb
bb
bb
bb
bb
bb
bb
ac
ac
ac
ac
ac
ac
"}
(26,1,1) = {"
ac
ac
ac
ac
ac
bb
bb
bb
bb
bb
bb
bb
bb
bb
bb
ac
ac
ac
ac
ac
ac
ac
"}
