//MAP CONVERTED BY dmm2tgm.py THIS HEADER COMMENT PREVENTS RECONVERSION, DO NOT REMOVE
"aa" = (
/turf/closed/mineral/volcanic/lava_land_surface,
/area/lavaland/surface/outdoors)
"ab" = (
/turf/open/misc/asteroid/basalt/lava_land_surface,
/area/lavaland/surface/outdoors)
"ac" = (
/turf/closed/wall/r_wall,
/area/ruin/powered/seedvault)
"ad" = (
/obj/machinery/vending/hydronutrients,
/obj/effect/turf_decal/trimline/green/filled/line,
/turf/open/floor/iron/dark,
/area/ruin/powered/seedvault)
"ae" = (
/obj/machinery/smartfridge,
/obj/effect/turf_decal/trimline/green/filled/line,
/turf/open/floor/iron/dark,
/area/ruin/powered/seedvault)
"af" = (
/obj/machinery/vending/hydroseeds,
/obj/effect/turf_decal/trimline/green/filled/line,
/turf/open/floor/iron/dark,
/area/ruin/powered/seedvault)
"ag" = (
/obj/structure/table/wood,
/obj/effect/turf_decal/trimline/green/filled/line,
/obj/item/stack/sheet/glass{
	amount = 10
	},
/obj/item/storage/toolbox/syndicate,
/turf/open/floor/iron/dark,
/area/ruin/powered/seedvault)
"ah" = (
/turf/open/floor/iron/freezer,
/area/ruin/powered/seedvault)
"ai" = (
/obj/item/reagent_containers/cup/beaker/bluespace,
/obj/item/reagent_containers/cup/beaker/bluespace,
/obj/item/reagent_containers/cup/beaker/bluespace,
/obj/item/reagent_containers/cup/beaker/bluespace,
/obj/structure/table/wood,
/obj/effect/turf_decal/trimline/green/filled/line,
/turf/open/floor/iron/dark,
/area/ruin/powered/seedvault)
"aj" = (
/obj/structure/table/wood,
/obj/item/gun/energy/floragun{
	pixel_y = 6
	},
/obj/item/gun/energy/floragun{
	pixel_y = 4
	},
/obj/item/gun/energy/floragun{
	pixel_y = 2
	},
/obj/item/gun/energy/floragun,
/obj/effect/decal/cleanable/cobweb/cobweb2,
/obj/effect/turf_decal/trimline/green/filled/line,
/turf/open/floor/iron/dark,
/area/ruin/powered/seedvault)
"al" = (
/turf/open/floor/iron/dark,
/area/ruin/powered/seedvault)
"am" = (
/obj/machinery/light/directional/east,
/turf/open/floor/iron/dark,
/area/ruin/powered/seedvault)
"an" = (
/obj/machinery/light/directional/west,
/turf/open/floor/iron/dark,
/area/ruin/powered/seedvault)
"ao" = (
/obj/structure/loom,
/turf/open/floor/iron/dark,
/area/ruin/powered/seedvault)
"ar" = (
/obj/structure/closet/crate/hydroponics,
/obj/item/clothing/under/rank/civilian/hydroponics,
/obj/item/clothing/under/rank/civilian/hydroponics,
/obj/item/clothing/under/rank/civilian/hydroponics,
/obj/item/clothing/under/rank/civilian/hydroponics,
/obj/effect/decal/cleanable/cobweb,
/obj/effect/turf_decal/trimline/green/filled/line{
	dir = 4
	},
/turf/open/floor/iron/dark,
/area/ruin/powered/seedvault)
"as" = (
/obj/machinery/door/airlock/multi_tile/glass,
/turf/open/floor/iron/freezer,
/area/ruin/powered/seedvault)
"at" = (
/obj/structure/closet/crate/hydroponics,
/obj/item/cultivator,
/obj/item/cultivator,
/obj/item/cultivator,
/obj/item/cultivator,
/obj/item/shovel/spade,
/obj/item/shovel/spade,
/obj/item/shovel/spade,
/obj/item/shovel/spade,
/obj/item/hatchet,
/obj/item/hatchet,
/obj/item/hatchet,
/obj/item/hatchet,
/obj/effect/turf_decal/trimline/green/filled/line{
	dir = 4
	},
/turf/open/floor/iron/dark,
/area/ruin/powered/seedvault)
"au" = (
/obj/machinery/door/airlock/titanium,
/turf/open/floor/vault,
/area/ruin/powered/seedvault)
"av" = (
/obj/machinery/door/airlock/external/ruin,
/obj/effect/mapping_helpers/airlock/cyclelink_helper,
/turf/open/floor/iron/dark,
/area/ruin/powered/seedvault)
"aw" = (
/obj/machinery/reagentgrinder{
	pixel_y = 5
	},
/obj/structure/table/glass,
/obj/effect/turf_decal/trimline/green/filled/end,
/obj/machinery/airalarm/directional/north,
/turf/open/floor/iron/dark,
/area/ruin/powered/seedvault)
"ax" = (
/obj/structure/reagent_dispensers/watertank/high,
/obj/effect/turf_decal/trimline/green/line{
	dir = 9
	},
/obj/effect/turf_decal/trimline/green/filled/corner,
/turf/open/floor/iron/dark,
/area/ruin/powered/seedvault)
"ay" = (
/obj/structure/reagent_dispensers/watertank/high,
/obj/effect/turf_decal/trimline/green/line{
	dir = 5
	},
/obj/effect/turf_decal/trimline/green/filled/corner{
	dir = 8
	},
/turf/open/floor/iron/dark,
/area/ruin/powered/seedvault)
"az" = (
/obj/structure/closet/crate/hydroponics,
/obj/item/soap/homemade,
/obj/item/soap/homemade,
/obj/effect/turf_decal/trimline/green/filled/line{
	dir = 6
	},
/turf/open/floor/iron/dark,
/area/ruin/powered/seedvault)
"aA" = (
/turf/open/floor/vault,
/area/ruin/powered/seedvault)
"aB" = (
/obj/effect/spawner/random/food_or_drink/seed_vault,
/obj/structure/closet/crate/hydroponics,
/obj/effect/spawner/random/food_or_drink/seed_vault,
/obj/effect/spawner/random/food_or_drink/seed_vault,
/obj/item/vending_refill/hydronutrients,
/obj/item/vending_refill/hydroseeds,
/turf/open/floor/vault,
/area/ruin/powered/seedvault)
"aE" = (
/obj/structure/closet/crate/hydroponics,
/obj/structure/beebox,
/obj/item/melee/flyswatter,
/obj/item/honey_frame,
/obj/item/honey_frame,
/obj/item/honey_frame,
/obj/item/queen_bee/bought,
/obj/item/clothing/head/utility/beekeeper_head,
/obj/item/clothing/suit/utility/beekeeper_suit,
/obj/machinery/light/directional/west,
/turf/open/floor/vault,
/area/ruin/powered/seedvault)
"aF" = (
/obj/structure/table/wood,
/obj/item/lighter,
/obj/item/lighter,
/obj/item/storage/fancy/rollingpapers,
/obj/item/storage/fancy/rollingpapers,
/obj/item/storage/fancy/rollingpapers,
/obj/item/storage/fancy/rollingpapers,
/turf/open/floor/iron/dark,
/area/ruin/powered/seedvault)
"aG" = (
/turf/closed/mineral/volcanic/lava_land_surface,
/area/ruin/powered/seedvault)
"aH" = (
/obj/machinery/door/airlock/vault,
/obj/machinery/atmospherics/pipe/smart/manifold4w/supply/hidden,
/turf/open/floor/iron/freezer,
/area/ruin/powered/seedvault)
"aI" = (
/obj/machinery/light/directional/north,
/turf/open/floor/vault,
/area/ruin/powered/seedvault)
"aJ" = (
/obj/structure/reagent_dispensers/watertank/high,
/obj/effect/turf_decal/trimline/green/line{
	dir = 10
	},
/obj/effect/turf_decal/trimline/green/filled/corner{
	dir = 4
	},
/turf/open/floor/iron/dark,
/area/ruin/powered/seedvault)
"aL" = (
/obj/structure/table/wood,
/obj/item/geneshears{
	pixel_x = 6
	},
/obj/item/geneshears,
/obj/item/geneshears{
	pixel_x = -6
	},
/obj/item/geneshears,
/turf/open/floor/vault,
/area/ruin/powered/seedvault)
"aM" = (
/obj/structure/table/wood,
/turf/open/floor/vault,
/area/ruin/powered/seedvault)
"aN" = (
/turf/open/floor/mineral/titanium/blue,
/area/ruin/powered/seedvault)
"aO" = (
/obj/machinery/light/directional/east,
/obj/structure/reagent_dispensers/watertank/high,
/obj/effect/turf_decal/trimline/green/line{
	dir = 6
	},
/obj/effect/turf_decal/trimline/green/filled/corner{
	dir = 1
	},
/turf/open/floor/iron/dark,
/area/ruin/powered/seedvault)
"aQ" = (
/obj/effect/decal/cleanable/dirt,
/turf/open/floor/iron/freezer,
/area/ruin/powered/seedvault)
"aR" = (
/obj/machinery/door/airlock/vault,
/obj/effect/mapping_helpers/airlock/cyclelink_helper{
	dir = 1
	},
/turf/open/floor/iron/dark,
/area/ruin/powered/seedvault)
"aS" = (
/obj/structure/table/wood,
/obj/item/storage/bag/plants{
	pixel_x = -5
	},
/obj/item/storage/bag/plants{
	pixel_y = -5
	},
/obj/item/storage/bag/plants{
	pixel_y = 5
	},
/obj/item/storage/bag/plants{
	pixel_x = 5
	},
/obj/effect/turf_decal/trimline/green/filled/line{
	dir = 1
	},
/turf/open/floor/iron/dark,
/area/ruin/powered/seedvault)
"aT" = (
/obj/item/reagent_containers/cup/bucket,
/obj/structure/table/wood,
/obj/item/reagent_containers/cup/bucket,
/obj/item/reagent_containers/cup/bucket,
/obj/item/reagent_containers/cup/bucket,
/obj/effect/turf_decal/trimline/green/filled/line{
	dir = 5
	},
/turf/open/floor/iron/dark,
/area/ruin/powered/seedvault)
"aU" = (
/obj/machinery/light/directional/south,
/turf/open/floor/iron/freezer,
/area/ruin/powered/seedvault)
"aV" = (
/obj/effect/turf_decal/trimline/green/line,
/obj/effect/turf_decal/trimline/green/line{
	dir = 1
	},
/obj/structure/table/reinforced,
/turf/open/floor/mineral/plastitanium,
/area/ruin/powered/seedvault)
"aW" = (
/obj/machinery/disposal/bin,
/obj/structure/disposalpipe/trunk{
	dir = 4
	},
/turf/open/floor/mineral/titanium/blue,
/area/ruin/powered/seedvault)
"aX" = (
/obj/structure/closet/crate/hydroponics,
/obj/structure/beebox,
/obj/item/melee/flyswatter,
/obj/item/honey_frame,
/obj/item/honey_frame,
/obj/item/honey_frame,
/obj/item/queen_bee/bought,
/obj/item/clothing/head/utility/beekeeper_head,
/obj/item/clothing/suit/utility/beekeeper_suit,
/obj/effect/decal/cleanable/cobweb,
/turf/open/floor/vault,
/area/ruin/powered/seedvault)
"aY" = (
/obj/effect/decal/cleanable/food/plant_smudge,
/obj/machinery/atmospherics/components/unary/vent_pump/on{
	dir = 1
	},
/turf/open/floor/vault,
/area/ruin/powered/seedvault)
"ba" = (
/obj/effect/turf_decal/trimline/green/line{
	dir = 4
	},
/obj/effect/turf_decal/trimline/green/line{
	dir = 8
	},
/obj/structure/table/reinforced,
/turf/open/floor/mineral/plastitanium,
/area/ruin/powered/seedvault)
"bb" = (
/obj/effect/decal/cleanable/dirt,
/turf/open/floor/mineral/titanium/blue,
/area/ruin/powered/seedvault)
"bc" = (
/obj/machinery/light/directional/west,
/obj/machinery/hydroponics/constructable,
/obj/effect/decal/cleanable/dirt,
/obj/effect/turf_decal/trimline/green/line{
	dir = 8
	},
/obj/effect/turf_decal/trimline/green/line{
	dir = 4
	},
/turf/open/floor/mineral/plastitanium,
/area/ruin/powered/seedvault)
"bd" = (
/obj/machinery/chem_dispenser/mutagensaltpeter,
/obj/effect/turf_decal/trimline/green/corner,
/obj/effect/turf_decal/trimline/green/line{
	dir = 9
	},
/turf/open/floor/mineral/plastitanium,
/area/ruin/powered/seedvault)
"be" = (
/obj/effect/turf_decal/trimline/green/line,
/obj/effect/turf_decal/trimline/green/line{
	dir = 1
	},
/turf/open/floor/mineral/plastitanium,
/area/ruin/powered/seedvault)
"bf" = (
/obj/machinery/biogenerator,
/obj/effect/decal/cleanable/dirt,
/obj/effect/turf_decal/trimline/green/corner{
	dir = 8
	},
/obj/effect/turf_decal/trimline/green/line{
	dir = 5
	},
/turf/open/floor/mineral/plastitanium,
/area/ruin/powered/seedvault)
"bh" = (
/obj/machinery/hydroponics/constructable,
/obj/effect/turf_decal/trimline/green/line{
	dir = 6
	},
/turf/open/floor/mineral/plastitanium,
/area/ruin/powered/seedvault)
"bi" = (
/obj/structure/disposalpipe/segment{
	dir = 4
	},
/obj/effect/turf_decal/trimline/green/line{
	dir = 4
	},
/obj/effect/turf_decal/trimline/green/line{
	dir = 8
	},
/obj/structure/table/reinforced,
/turf/open/floor/mineral/plastitanium,
/area/ruin/powered/seedvault)
"bj" = (
/obj/machinery/hydroponics/constructable,
/obj/effect/turf_decal/trimline/green/line{
	dir = 10
	},
/turf/open/floor/mineral/plastitanium,
/area/ruin/powered/seedvault)
"bk" = (
/obj/structure/disposalpipe/segment{
	dir = 4
	},
/obj/effect/decal/cleanable/dirt,
/turf/open/floor/mineral/titanium/blue,
/area/ruin/powered/seedvault)
"bl" = (
/obj/machinery/light/directional/east,
/obj/structure/disposalpipe/segment{
	dir = 4
	},
/obj/machinery/hydroponics/constructable,
/obj/effect/decal/cleanable/dirt,
/obj/effect/turf_decal/trimline/green/line{
	dir = 8
	},
/obj/effect/turf_decal/trimline/green/line{
	dir = 4
	},
/turf/open/floor/mineral/plastitanium,
/area/ruin/powered/seedvault)
"bm" = (
/obj/structure/disposalpipe/trunk{
	dir = 8
	},
/obj/structure/flora/bush/fullgrass/style_random,
/obj/structure/disposaloutlet,
/obj/structure/flora/bush/fullgrass/style_random,
/obj/machinery/light/directional/north,
/turf/open/misc/grass/lavaland,
/area/ruin/powered/seedvault)
"bn" = (
/obj/structure/window/spawner/directional/east,
/obj/structure/flora/bush/pale/style_random,
/obj/structure/flora/bush/flowers_pp/style_random,
/turf/open/misc/grass/lavaland,
/area/ruin/powered/seedvault)
"bo" = (
/obj/machinery/chem_master/condimaster,
/obj/effect/turf_decal/trimline/green/corner{
	dir = 4
	},
/obj/effect/turf_decal/trimline/green/line{
	dir = 10
	},
/turf/open/floor/mineral/plastitanium,
/area/ruin/powered/seedvault)
"bp" = (
/obj/machinery/seed_extractor,
/obj/effect/turf_decal/trimline/green/corner{
	dir = 1
	},
/obj/effect/turf_decal/trimline/green/line{
	dir = 6
	},
/turf/open/floor/mineral/plastitanium,
/area/ruin/powered/seedvault)
"br" = (
/obj/structure/flora/bush/sunny/style_random,
/obj/structure/flora/grass/jungle/b/style_random,
/turf/open/misc/grass/lavaland,
/area/ruin/powered/seedvault)
"bs" = (
/obj/structure/window/spawner/directional/east,
/obj/structure/flora/bush/sparsegrass/style_random,
/turf/open/misc/grass/lavaland,
/area/ruin/powered/seedvault)
"bu" = (
/obj/structure/window/spawner/directional/east,
/obj/structure/flora/bush/ferny/style_random,
/obj/structure/flora/bush/flowers_yw/style_random,
/obj/structure/flora/bush/sparsegrass/style_random,
/obj/effect/decal/cleanable/glass,
/turf/open/misc/grass/lavaland,
/area/ruin/powered/seedvault)
"bw" = (
/obj/machinery/light/directional/south,
/obj/machinery/hydroponics/constructable,
/obj/effect/decal/cleanable/dirt,
/obj/effect/decal/cleanable/dirt,
/obj/effect/turf_decal/trimline/green/line{
	dir = 1
	},
/obj/effect/turf_decal/trimline/green/line,
/turf/open/floor/mineral/plastitanium,
/area/ruin/powered/seedvault)
"bx" = (
/obj/effect/decal/cleanable/glass,
/turf/open/misc/asteroid/basalt/lava_land_surface,
/area/lavaland/surface/outdoors)
"by" = (
/obj/structure/disposalpipe/segment{
	dir = 6
	},
/turf/closed/wall/r_wall,
/area/ruin/powered/seedvault)
"bz" = (
/obj/structure/disposalpipe/segment{
	dir = 4
	},
/turf/open/floor/mineral/titanium/blue,
/area/ruin/powered/seedvault)
"bA" = (
/obj/structure/disposalpipe/segment{
	dir = 9
	},
/turf/closed/wall/r_wall,
/area/ruin/powered/seedvault)
"bB" = (
/obj/machinery/hydroponics/constructable,
/obj/effect/turf_decal/trimline/green/line{
	dir = 5
	},
/turf/open/floor/mineral/plastitanium,
/area/ruin/powered/seedvault)
"bC" = (
/obj/machinery/hydroponics/constructable,
/obj/effect/turf_decal/trimline/green/line{
	dir = 9
	},
/turf/open/floor/mineral/plastitanium,
/area/ruin/powered/seedvault)
"bD" = (
/turf/closed/wall/r_wall,
/area/lavaland/surface/outdoors)
"ca" = (
/obj/machinery/atmospherics/components/tank/air{
	dir = 4
	},
/turf/open/floor/iron/freezer,
/area/ruin/powered/seedvault)
"ds" = (
/obj/effect/mob_spawn/ghost_role/human/seed_vault,
/obj/effect/decal/cleanable/cobweb/cobweb2,
/obj/machinery/light/directional/east,
/turf/open/floor/iron/freezer,
/area/ruin/powered/seedvault)
"eq" = (
/obj/effect/baseturf_helper/lava_land/surface,
/turf/closed/mineral/volcanic/lava_land_surface,
/area/lavaland/surface/outdoors)
"hf" = (
/obj/structure/sink/directional/east,
/turf/open/floor/iron/dark,
/area/ruin/powered/seedvault)
"le" = (
/obj/structure/window/spawner/directional/south,
/obj/structure/flora/bush/flowers_pp/style_random,
/obj/structure/flora/bush/generic/style_random,
/obj/structure/flora/bush/flowers_br/style_random,
/turf/open/misc/grass/lavaland,
/area/ruin/powered/seedvault)
"og" = (
/obj/effect/mob_spawn/ghost_role/human/seed_vault,
/turf/open/floor/iron/freezer,
/area/ruin/powered/seedvault)
"oR" = (
/obj/machinery/atmospherics/pipe/smart/manifold4w/supply/hidden{
	dir = 10
	},
/turf/open/floor/iron/freezer,
/area/ruin/powered/seedvault)
"pZ" = (
/obj/machinery/hydroponics/constructable,
/obj/effect/decal/cleanable/dirt,
/obj/effect/decal/cleanable/cobweb/cobweb2,
/obj/effect/turf_decal/trimline/green/line{
	dir = 8
	},
/obj/effect/turf_decal/trimline/green/line{
	dir = 4
	},
/turf/open/floor/mineral/plastitanium,
/area/ruin/powered/seedvault)
"rF" = (
/obj/machinery/hydroponics/constructable,
/obj/effect/decal/cleanable/dirt,
/obj/effect/turf_decal/trimline/green/line{
	dir = 8
	},
/obj/effect/turf_decal/trimline/green/line{
	dir = 4
	},
/turf/open/floor/mineral/plastitanium,
/area/ruin/powered/seedvault)
"rX" = (
/obj/structure/sink/directional/east,
/obj/effect/decal/cleanable/cobweb,
/turf/open/floor/iron/dark,
/area/ruin/powered/seedvault)
"sv" = (
/obj/machinery/atmospherics/pipe/smart/manifold4w/supply/hidden,
/turf/open/floor/vault,
/area/ruin/powered/seedvault)
"vc" = (
/obj/effect/decal/cleanable/dirt,
/obj/machinery/atmospherics/pipe/smart/manifold4w/supply/hidden,
/obj/machinery/light/floor,
/turf/open/floor/mineral/titanium/blue,
/area/ruin/powered/seedvault)
"Bb" = (
/obj/machinery/atmospherics/pipe/smart/manifold4w/supply/hidden,
/turf/open/floor/iron/freezer,
/area/ruin/powered/seedvault)
"GN" = (
/obj/structure/table/wood,
/obj/item/secateurs{
	pixel_x = -6
	},
/obj/item/secateurs{
	pixel_x = 6
	},
/obj/item/secateurs,
/obj/item/secateurs{
	pixel_x = -6
	},
/turf/open/floor/vault,
/area/ruin/powered/seedvault)
"Ik" = (
/obj/machinery/atmospherics/pipe/smart/manifold4w/supply/hidden,
/obj/machinery/light/floor,
/turf/open/floor/iron/freezer,
/area/ruin/powered/seedvault)
"Kq" = (
/obj/structure/sink/directional/west,
/turf/open/floor/iron/dark,
/area/ruin/powered/seedvault)
"KF" = (
/obj/machinery/door/airlock/titanium,
/obj/machinery/atmospherics/pipe/smart/manifold4w/supply/hidden,
/turf/open/floor/vault,
/area/ruin/powered/seedvault)
"OE" = (
/obj/effect/mob_spawn/ghost_role/human/seed_vault,
/obj/machinery/light/directional/west,
/turf/open/floor/iron/freezer,
/area/ruin/powered/seedvault)
"PH" = (
/obj/machinery/atmospherics/pipe/smart/manifold4w/supply/hidden{
	dir = 4
	},
/turf/open/floor/iron/freezer,
/area/ruin/powered/seedvault)
"Uz" = (
/obj/machinery/atmospherics/components/unary/vent_pump/on{
	dir = 1
	},
/turf/open/floor/mineral/titanium/blue,
/area/ruin/powered/seedvault)
"Vn" = (
/obj/machinery/atmospherics/components/unary/vent_pump/on,
/turf/open/floor/iron/freezer,
/area/ruin/powered/seedvault)
"VF" = (
/obj/machinery/hydroponics/constructable,
/obj/effect/decal/cleanable/dirt,
/obj/effect/turf_decal/trimline/green/line{
	dir = 1
	},
/obj/effect/turf_decal/trimline/green/line,
/turf/open/floor/mineral/plastitanium,
/area/ruin/powered/seedvault)

(1,1,1) = {"
eq
aa
aa
aa
aa
aa
aa
aa
aa
aa
aa
aa
aa
aa
aa
aa
aa
aa
ab
ab
"}
(2,1,1) = {"
aa
aa
aa
aa
ab
ab
aa
aa
aa
aa
aa
aa
ab
aa
aa
aa
aa
aa
aa
ab
"}
(3,1,1) = {"
aa
ac
ac
ac
ac
ac
ac
aa
aa
aa
aa
ab
ab
ab
aa
aa
aa
ab
ab
ab
"}
(4,1,1) = {"
aa
ac
OE
ah
ac
ca
ac
ac
ac
ac
ab
ab
ab
ab
ab
ab
ab
ab
aa
aa
"}
(5,1,1) = {"
aa
ac
og
ah
as
PH
aQ
av
al
aR
ab
ab
ab
ab
ab
aa
aa
aa
aa
aa
"}
(6,1,1) = {"
aa
ac
og
Vn
Bb
Bb
ah
av
am
aR
ab
ab
ac
ac
ac
ac
ac
aa
aa
aa
"}
(7,1,1) = {"
aa
ac
ds
ah
ac
PH
aU
ac
ac
ac
ac
ac
ac
rF
bc
rF
ac
ac
bD
aa
"}
(8,1,1) = {"
aa
ac
ac
ac
ac
PH
ah
aS
ac
aG
ac
bh
aN
aN
aN
aN
aN
bB
ac
aa
"}
(9,1,1) = {"
ac
ac
ar
at
az
PH
ah
aT
ac
ac
ac
bb
bb
aN
aN
aN
aN
aN
ac
ac
"}
(10,1,1) = {"
ac
ad
al
al
al
PH
ah
al
hf
ac
rX
bb
aN
bd
ba
bo
aN
aN
VF
ac
"}
(11,1,1) = {"
ac
ae
al
Vn
Bb
Bb
Bb
Ik
Bb
aH
Bb
vc
Uz
aV
aW
be
aN
aN
bw
ac
"}
(12,1,1) = {"
ac
af
am
al
al
PH
ah
al
Kq
ac
Kq
bb
aN
bf
bi
bp
aN
aN
VF
ac
"}
(13,1,1) = {"
ac
ac
ac
aw
al
PH
ah
aF
ac
ac
ac
aN
aN
aN
bz
aN
aN
aN
ac
ac
"}
(14,1,1) = {"
ac
ag
an
al
al
PH
ah
ah
au
aA
ac
bj
aN
bb
bk
aN
bb
bC
ac
aa
"}
(15,1,1) = {"
ac
ai
al
Vn
Bb
Bb
ah
aF
ac
aA
ac
ac
ac
pZ
bl
rF
ac
ac
ac
aa
"}
(16,1,1) = {"
ac
aj
al
al
al
PH
ac
ac
ac
aI
aA
aL
ac
by
bA
ac
ac
ab
ab
aa
"}
(17,1,1) = {"
ac
ac
ao
al
al
PH
ac
aX
aE
aA
aA
GN
ac
bm
br
le
ab
ab
aa
aa
"}
(18,1,1) = {"
aa
ac
ac
ax
aJ
oR
KF
sv
sv
aY
aM
ac
ac
bn
bs
bu
bx
ab
ab
ab
"}
(19,1,1) = {"
aa
aa
ac
ay
aO
ah
ac
aB
aB
aB
ac
ac
aa
aa
aa
aa
ab
ab
ab
ab
"}
(20,1,1) = {"
aa
aa
ac
ac
ac
ac
ac
ac
ac
ac
ac
aa
aa
aa
aa
aa
aa
ab
ab
aa
"}
