//MAP CONVERTED BY dmm2tgm.py THIS HEADER COMMENT PREVENTS RECONVERSION, DO NOT REMOVE
//Model dictionary trimmed on: 11-07-2017 21:18 (UTC)
"aa" = (
/turf/template_noop,
/area/template_noop)
"ab" = (
/turf/open/floor/plating/asteroid/basalt/lava_land_surface,
/area/ruin/powered)
"ac" = (
/turf/open/floor/noslip{
	baseturf = /turf/open/floor/plating/lava/smooth;
	initial_gas_mix = "o2=14;n2=23;TEMP=300"
	},
/area/ruin/powered)
"ad" = (
/mob/living/simple_animal/hostile/retaliate/clown,
/turf/open/floor/plating/asteroid/basalt/lava_land_surface,
/area/ruin/powered)
"ae" = (
/obj/machinery/light,
/turf/open/floor/plating/asteroid/basalt/lava_land_surface,
/area/ruin/powered)
"af" = (
/obj/item/clothing/head/cone,
/turf/open/floor/noslip{
	baseturf = /turf/open/floor/plating/lava/smooth;
	initial_gas_mix = "o2=14;n2=23;TEMP=300"
	},
/area/ruin/powered)
"ag" = (
/obj/item/weapon/paper/crumpled/bloody{
	info = "Abandon hope, all ye who enter here."
	},
/obj/effect/decal/cleanable/blood/old,
/turf/open/floor/noslip{
	baseturf = /turf/open/floor/plating/lava/smooth;
	initial_gas_mix = "o2=14;n2=23;TEMP=300"
	},
/area/ruin/powered)
"ah" = (
/turf/closed/wall/r_wall{
	baseturf = /turf/open/floor/plating/lava/smooth
	},
/area/ruin/powered)
"ai" = (
/obj/machinery/disposal/deliveryChute{
	desc = "The following is engraved upon the chute: A FATE WORSE THAN DEATH LIES WITHIN";
	dir = 1;
	name = "THE TRIAL OF HONKITUDE"
	},
/obj/structure/disposalpipe/trunk,
/turf/open/floor/noslip{
	baseturf = /turf/open/floor/plating/lava/smooth;
	initial_gas_mix = "o2=14;n2=23;TEMP=300"
	},
/area/ruin/powered)
"aj" = (
/obj/structure/disposalpipe/trunk,
/obj/structure/disposaloutlet{
	dir = 1
	},
/turf/open/floor/noslip{
	baseturf = /turf/open/floor/plating/lava/smooth;
	initial_gas_mix = "o2=14;n2=23;TEMP=300"
	},
/area/ruin/powered)
"ak" = (
/turf/open/floor/plating/lava/smooth,
/area/ruin/powered)
"al" = (
/obj/structure/disposalpipe/segment{
	invisibility = 101
	},
/turf/closed/wall/r_wall{
	baseturf = /turf/open/floor/plating/lava/smooth
	},
/area/ruin/powered)
"am" = (
/obj/structure/disposalpipe/segment{
	dir = 4;
	icon_state = "pipe-c";
	invisibility = 101
	},
/turf/closed/wall/r_wall{
	baseturf = /turf/open/floor/plating/lava/smooth
	},
/area/ruin/powered/clownplanet)
"an" = (
/obj/structure/disposalpipe/segment{
	dir = 2;
	icon_state = "pipe-c";
	invisibility = 101
	},
/turf/closed/wall/r_wall{
	baseturf = /turf/open/floor/plating/lava/smooth
	},
/area/ruin/powered/clownplanet)
"ao" = (
/obj/structure/disposalpipe/segment{
	dir = 4;
	icon_state = "pipe-c";
	invisibility = 101
	},
/turf/open/floor/plating{
	baseturf = /turf/open/floor/plating/lava/smooth
	},
/area/ruin/powered/clownplanet)
"ap" = (
/obj/structure/disposalpipe/segment{
	dir = 2;
	icon_state = "pipe-c";
	invisibility = 101
	},
/turf/open/floor/plating{
	baseturf = /turf/open/floor/plating/lava/smooth
	},
/area/ruin/powered/clownplanet)
"aq" = (
/obj/structure/disposalpipe/trunk,
/obj/structure/disposaloutlet{
	dir = 1
	},
/turf/open/floor/plating{
	baseturf = /turf/open/floor/plating/lava/smooth
	},
/area/ruin/powered/clownplanet)
"ar" = (
/obj/structure/disposalpipe/segment{
	invisibility = 101
	},
/turf/open/indestructible{
	icon_state = "darkyellowfull";
	wet = 5
	},
/area/ruin/powered/clownplanet)
"as" = (
/obj/effect/mob_spawn/human/corpse/damaged,
/obj/effect/decal/cleanable/blood/old,
/obj/structure/disposalpipe/segment{
	invisibility = 101
	},
/turf/open/indestructible{
	icon_state = "darkyellowfull";
	wet = 5
	},
/area/ruin/powered/clownplanet)
"at" = (
/obj/structure/disposalpipe/segment{
	dir = 4;
	icon_state = "pipe-c";
	invisibility = 101
	},
/turf/open/indestructible{
	icon_state = "darkyellowfull";
	wet = 5
	},
/area/ruin/powered/clownplanet)
"au" = (
/obj/structure/disposalpipe/segment{
	invisibility = 101
	},
/turf/open/floor/plating{
	baseturf = /turf/open/floor/plating/lava/smooth
	},
/area/ruin/powered/clownplanet)
"av" = (
/obj/structure/disposalpipe/sortjunction{
	dir = 1;
	icon_state = "pipe-j2s";
	invisibility = 101;
	sortType = 3
	},
/turf/closed/wall/r_wall{
	baseturf = /turf/open/floor/plating/lava/smooth
	},
/area/ruin/powered/clownplanet)
"aw" = (
/obj/structure/window/reinforced,
/obj/structure/disposalpipe/segment{
	invisibility = 101
	},
/turf/open/floor/plating{
	baseturf = /turf/open/floor/plating/lava/smooth
	},
/area/ruin/powered/clownplanet)
"ax" = (
/obj/effect/decal/cleanable/pie_smudge,
/obj/structure/disposalpipe/segment{
	invisibility = 101
	},
/turf/open/indestructible{
	icon_state = "darkyellowfull";
	wet = 5
	},
/area/ruin/powered/clownplanet)
"ay" = (
/obj/structure/disposalpipe/segment{
	dir = 1;
	icon_state = "pipe-c";
	invisibility = 101
	},
/obj/effect/decal/cleanable/dirt,
/turf/open/indestructible{
	icon_state = "darkyellowfull";
	wet = 5
	},
/area/ruin/powered/clownplanet)
"az" = (
/obj/structure/disposalpipe/segment{
	dir = 4;
	invisibility = 101
	},
/obj/effect/decal/cleanable/dirt,
/turf/open/indestructible{
	icon_state = "darkyellowfull";
	wet = 5
	},
/area/ruin/powered/clownplanet)
"aA" = (
/obj/structure/disposalpipe/segment{
	dir = 4;
	invisibility = 101
	},
/turf/open/indestructible{
	icon_state = "darkyellowfull";
	wet = 5
	},
/area/ruin/powered/clownplanet)
"aB" = (
/obj/structure/disposalpipe/segment{
	dir = 8;
	icon_state = "pipe-c";
	invisibility = 101
	},
/turf/open/indestructible{
	icon_state = "darkyellowfull";
	wet = 5
	},
/area/ruin/powered/clownplanet)
"aC" = (
/turf/open/indestructible{
	icon_state = "darkyellowfull";
	wet = 5
	},
/area/ruin/powered/clownplanet)
"aD" = (
/obj/effect/decal/cleanable/dirt,
/turf/open/indestructible{
	icon_state = "darkyellowfull";
	wet = 5
	},
/area/ruin/powered/clownplanet)
"aE" = (
/obj/effect/decal/cleanable/cobweb{
	icon_state = "cobweb2"
	},
/turf/open/indestructible{
	icon_state = "darkyellowfull";
	wet = 5
	},
/area/ruin/powered/clownplanet)
"aF" = (
/obj/structure/disposalpipe/segment{
	dir = 4;
	invisibility = 101
	},
/obj/effect/decal/cleanable/cobweb,
/turf/open/indestructible{
	icon_state = "darkyellowfull";
	wet = 5
	},
/area/ruin/powered/clownplanet)
"aG" = (
/obj/structure/disposalpipe/segment{
	dir = 1;
	icon_state = "pipe-c";
	invisibility = 101
	},
/turf/open/indestructible{
	icon_state = "darkyellowfull";
	wet = 5
	},
/area/ruin/powered/clownplanet)
"aH" = (
/obj/structure/disposalpipe/segment{
	dir = 8;
	icon_state = "pipe-c";
	invisibility = 101
	},
/obj/effect/decal/cleanable/dirt,
/turf/open/indestructible{
	icon_state = "darkyellowfull";
	wet = 5
	},
/area/ruin/powered/clownplanet)
"aI" = (
/obj/structure/disposalpipe/segment{
	dir = 1;
	icon_state = "pipe-c";
	invisibility = 101
	},
/obj/item/weapon/bikehorn,
/turf/open/indestructible{
	icon_state = "darkyellowfull";
	wet = 5
	},
/area/ruin/powered/clownplanet)
"aJ" = (
/obj/structure/disposalpipe/segment{
	dir = 1;
	icon_state = "pipe-c";
	invisibility = 101
	},
/turf/closed/wall/r_wall{
	baseturf = /turf/open/floor/plating/lava/smooth
	},
/area/ruin/powered/clownplanet)
"aK" = (
/obj/structure/disposalpipe/segment{
	dir = 4;
	invisibility = 101
	},
/obj/effect/decal/cleanable/pie_smudge,
/turf/open/indestructible{
	icon_state = "darkyellowfull";
	wet = 5
	},
/area/ruin/powered/clownplanet)
"aL" = (
/obj/structure/disposalpipe/segment{
	dir = 4;
	invisibility = 101
	},
/turf/closed/wall/r_wall{
	baseturf = /turf/open/floor/plating/lava/smooth
	},
/area/ruin/powered/clownplanet)
"aM" = (
/obj/structure/disposalpipe/segment{
	dir = 2;
	icon_state = "pipe-c";
	invisibility = 101
	},
/turf/open/indestructible{
	icon_state = "darkyellowfull";
	wet = 5
	},
/area/ruin/powered/clownplanet)
"aN" = (
/obj/structure/disposalpipe/segment{
	invisibility = 101
	},
/turf/open/floor/plating,
/area/ruin/powered/clownplanet)
"aO" = (
/obj/item/weapon/bikehorn,
/obj/structure/disposalpipe/segment{
	dir = 4;
	invisibility = 101
	},
/turf/open/indestructible{
	icon_state = "darkyellowfull";
	wet = 5
	},
/area/ruin/powered/clownplanet)
"aP" = (
/obj/structure/disposalpipe/segment{
	dir = 4;
	invisibility = 101
	},
/turf/open/floor/plating{
	baseturf = /turf/open/floor/plating/lava/smooth
	},
/area/ruin/powered/clownplanet)
"aQ" = (
/turf/open/floor/plating{
	baseturf = /turf/open/floor/plating/lava/smooth
	},
/area/ruin/powered)
"aR" = (
/obj/structure/disposalpipe/segment{
	dir = 4;
	icon_state = "pipe-c";
	invisibility = 101
	},
/turf/open/floor/plating,
/area/ruin/powered/clownplanet)
"aS" = (
/obj/structure/disposalpipe/segment{
	dir = 8;
	icon_state = "pipe-c";
	invisibility = 101
	},
/turf/open/floor/plating{
	baseturf = /turf/open/floor/plating/lava/smooth
	},
/area/ruin/powered/clownplanet)
"aT" = (
/obj/effect/decal/cleanable/dirt,
/obj/structure/disposalpipe/segment{
	invisibility = 101
	},
/turf/open/indestructible{
	icon_state = "darkyellowfull";
	wet = 5
	},
/area/ruin/powered/clownplanet)
"aU" = (
/obj/structure/grille,
/obj/structure/window/reinforced/fulltile,
/turf/open/floor/plating{
	baseturf = /turf/open/floor/plating/lava/smooth
	},
/area/ruin/powered/clownplanet)
"aV" = (
/obj/structure/disposalpipe/segment{
	dir = 2;
	icon_state = "pipe-c";
	invisibility = 101
	},
/obj/effect/decal/cleanable/dirt,
/turf/open/indestructible{
	icon_state = "darkyellowfull";
	wet = 5
	},
/area/ruin/powered/clownplanet)
"aW" = (
/obj/item/weapon/bikehorn,
/obj/effect/decal/cleanable/dirt,
/obj/structure/disposalpipe/segment{
	invisibility = 101
	},
/turf/open/indestructible{
	icon_state = "darkyellowfull";
	wet = 5
	},
/area/ruin/powered/clownplanet)
"aX" = (
/obj/structure/disposalpipe/trunk{
	dir = 4
	},
/obj/structure/disposaloutlet{
	dir = 8
	},
/turf/open/floor/plating{
	baseturf = /turf/open/floor/plating/lava/smooth
	},
/area/ruin/powered/clownplanet)
"aY" = (
/obj/item/weapon/bikehorn,
/obj/structure/disposalpipe/segment{
	invisibility = 101
	},
/turf/open/indestructible{
	icon_state = "darkyellowfull";
	wet = 5
	},
/area/ruin/powered/clownplanet)
"aZ" = (
/obj/structure/disposalpipe/segment{
	dir = 4;
	invisibility = 101
	},
/turf/open/indestructible{
	icon_state = "darkredfull"
	},
/area/ruin/powered/clownplanet)
"ba" = (
/obj/effect/decal/cleanable/pie_smudge,
/turf/open/indestructible{
	icon_state = "darkyellowfull";
	wet = 5
	},
/area/ruin/powered/clownplanet)
"bb" = (
/obj/structure/disposalpipe/segment{
	dir = 4;
	invisibility = 101
	},
/turf/open/indestructible{
	icon_state = "white"
	},
/area/ruin/powered/clownplanet)
"bc" = (
/obj/structure/disposalpipe/segment{
	dir = 4;
	icon_state = "pipe-c";
	invisibility = 101
	},
/obj/effect/decal/cleanable/dirt,
/turf/open/indestructible{
	icon_state = "darkyellowfull";
	wet = 5
	},
/area/ruin/powered/clownplanet)
"bd" = (
/obj/structure/disposalpipe/segment{
	dir = 4;
	invisibility = 101
	},
/obj/structure/table,
/obj/item/weapon/paper/crumpled/bloody{
	info = "If you dare not continue down this path of madness, escape can be found through the chute in this room. "
	},
/obj/item/weapon/pen/fourcolor,
/turf/open/indestructible{
	icon_state = "white"
	},
/area/ruin/powered/clownplanet)
"be" = (
/obj/structure/disposalpipe/segment{
	dir = 4;
	invisibility = 101
	},
/obj/structure/table,
/obj/item/device/flashlight/lamp/bananalamp,
/turf/open/indestructible{
	icon_state = "white"
	},
/area/ruin/powered/clownplanet)
"bf" = (
/obj/structure/disposalpipe/segment{
	dir = 2;
	icon_state = "pipe-c";
	invisibility = 101
	},
/obj/effect/decal/cleanable/pie_smudge,
/turf/open/indestructible{
	icon_state = "darkyellowfull";
	wet = 5
	},
/area/ruin/powered/clownplanet)
"bg" = (
/obj/structure/disposalpipe/segment{
	dir = 4;
	invisibility = 101
	},
/obj/item/weapon/pickaxe,
/turf/open/indestructible{
	icon_state = "white"
	},
/area/ruin/powered/clownplanet)
"bh" = (
/obj/structure/disposalpipe/segment{
	dir = 4;
	icon_state = "pipe-c";
	invisibility = 101
	},
/turf/open/indestructible{
	icon_state = "white"
	},
/area/ruin/powered/clownplanet)
"bi" = (
/obj/structure/disposalpipe/segment{
	dir = 2;
	icon_state = "pipe-c";
	invisibility = 101
	},
/turf/open/indestructible{
	icon_state = "white"
	},
/area/ruin/powered/clownplanet)
"bj" = (
/obj/structure/disposalpipe/segment{
	dir = 4;
	invisibility = 101
	},
/turf/open/indestructible{
	icon_state = "light_on"
	},
/area/ruin/powered/clownplanet)
"bk" = (
/obj/structure/disposalpipe/segment{
	invisibility = 101
	},
/obj/machinery/light/small{
	brightness = 3;
	dir = 8
	},
/turf/open/indestructible{
	icon_state = "white"
	},
/area/ruin/powered/clownplanet)
"bl" = (
/turf/open/indestructible{
	icon_state = "light_on"
	},
/area/ruin/powered/clownplanet)
"bm" = (
/obj/structure/disposalpipe/segment{
	dir = 1;
	icon_state = "pipe-c";
	invisibility = 101
	},
/turf/open/indestructible{
	icon_state = "white"
	},
/area/ruin/powered/clownplanet)
"bn" = (
/obj/structure/disposalpipe/segment{
	dir = 8;
	icon_state = "pipe-c";
	invisibility = 101
	},
/turf/open/indestructible{
	icon_state = "white"
	},
/area/ruin/powered/clownplanet)
"bo" = (
/obj/machinery/light{
	dir = 4
	},
/turf/open/floor/plating/asteroid/basalt/lava_land_surface,
/area/ruin/powered)
"bp" = (
/turf/closed/mineral/clown,
/area/ruin/powered/clownplanet)
"bq" = (
/obj/item/weapon/pickaxe,
/turf/open/indestructible{
	icon_state = "white"
	},
/area/ruin/powered/clownplanet)
"br" = (
/turf/open/indestructible{
	icon_state = "white"
	},
/area/ruin/powered/clownplanet)
"bs" = (
/obj/structure/disposalpipe/segment{
	dir = 4;
	icon_state = "pipe-c";
	invisibility = 101
	},
/turf/open/indestructible{
	icon_state = "darkredfull"
	},
/area/ruin/powered/clownplanet)
"bt" = (
/obj/structure/disposalpipe/segment{
	dir = 1;
	icon_state = "pipe-c";
	invisibility = 101
	},
/turf/open/floor/plating{
	baseturf = /turf/open/floor/plating/lava/smooth
	},
/area/ruin/powered/clownplanet)
"bu" = (
/obj/item/weapon/bikehorn,
/obj/structure/disposalpipe/segment{
	dir = 2;
	icon_state = "pipe-c";
	invisibility = 101
	},
/turf/open/indestructible{
	icon_state = "darkyellowfull";
	wet = 5
	},
/area/ruin/powered/clownplanet)
"bv" = (
/obj/machinery/light{
	dir = 8
	},
/turf/open/floor/plating/asteroid/basalt/lava_land_surface,
/area/ruin/powered)
"bw" = (
/turf/open/chasm/straight_down/lava_land_surface,
/area/ruin/powered)
"bx" = (
/obj/effect/decal/cleanable/cobweb,
/turf/open/indestructible{
	icon_state = "darkredfull";
	wet = 5
	},
/area/ruin/powered/clownplanet)
"by" = (
/obj/structure/disposalpipe/segment,
/turf/open/indestructible{
	icon_state = "darkyellowfull";
	wet = 5
	},
/area/ruin/powered/clownplanet)
"bz" = (
/obj/machinery/disposal/deliveryChute{
	dir = 1
	},
/obj/structure/disposalpipe/trunk,
/turf/open/indestructible{
	icon_state = "white"
	},
/area/ruin/powered/clownplanet)
"bA" = (
/turf/open/indestructible{
	icon_state = "darkredfull";
	wet = 5
	},
/area/ruin/powered/clownplanet)
"bB" = (
/turf/open/indestructible/sound{
	icon_state = "bananium";
	name = "bananium floor";
	sound = 'sound/effects/clownstep1.ogg';
	wet = 5
	},
/area/ruin/powered/clownplanet)
"bC" = (
/obj/structure/disposalpipe/junction{
	dir = 1;
	icon_state = "pipe-y";
	invisibility = 101
	},
/obj/effect/decal/cleanable/dirt,
/turf/open/indestructible{
	icon_state = "darkyellowfull";
	wet = 5
	},
/area/ruin/powered/clownplanet)
"bD" = (
/obj/structure/mecha_wreckage/honker,
/obj/structure/disposalpipe/segment{
	dir = 4;
	invisibility = 101
	},
/turf/open/floor/plating{
	baseturf = /turf/open/floor/plating/lava/smooth
	},
/area/ruin/powered/clownplanet)
"bE" = (
/obj/effect/decal/cleanable/oil,
/obj/structure/disposalpipe/segment{
	dir = 2;
	icon_state = "pipe-c";
	invisibility = 101
	},
/turf/open/floor/plating{
	baseturf = /turf/open/floor/plating/lava/smooth
	},
/area/ruin/powered/clownplanet)
"bF" = (
/obj/effect/decal/cleanable/cobweb{
	icon_state = "cobweb2"
	},
/turf/open/indestructible/sound{
	icon_state = "bananium";
	name = "bananium floor";
	sound = 'sound/effects/clownstep1.ogg';
	wet = 5
	},
/area/ruin/powered/clownplanet)
"bG" = (
/obj/item/weapon/grown/bananapeel{
	color = "#2F3000";
	name = "stealth banana peel"
	},
/turf/open/floor/plating/asteroid/basalt/lava_land_surface,
/area/ruin/powered)
"bH" = (
/obj/effect/decal/cleanable/dirt,
/turf/open/indestructible/sound{
	icon_state = "bananium";
	name = "bananium floor";
	sound = 'sound/effects/clownstep1.ogg';
	wet = 5
	},
/area/ruin/powered/clownplanet)
"bI" = (
/obj/effect/mob_spawn/human/corpse/damaged,
/obj/effect/decal/cleanable/blood/old,
/turf/open/indestructible{
	icon_state = "darkyellowfull";
	wet = 5
	},
/area/ruin/powered/clownplanet)
"bJ" = (
/obj/structure/disposalpipe/segment{
	dir = 4;
	invisibility = 101
	},
/turf/open/indestructible{
	icon_state = "darkredfull";
	wet = 5
	},
/area/ruin/powered/clownplanet)
"bK" = (
/obj/structure/disposalpipe/segment{
	dir = 8;
	icon_state = "pipe-c";
	invisibility = 101
	},
/turf/open/indestructible{
	icon_state = "darkredfull";
	wet = 5
	},
/area/ruin/powered/clownplanet)
"bL" = (
/obj/item/weapon/reagent_containers/food/drinks/trophy/gold_cup,
/obj/structure/table/glass,
/turf/open/floor/carpet{
	baseturf = /turf/open/floor/plating/lava/smooth
	},
/area/ruin/powered/clownplanet)
"bM" = (
/turf/open/floor/carpet{
	baseturf = /turf/open/floor/plating/lava/smooth
	},
/area/ruin/powered/clownplanet)
"bN" = (
/obj/machinery/disposal/deliveryChute,
/obj/structure/disposalpipe/trunk{
	dir = 1
	},
/turf/open/floor/carpet{
	baseturf = /turf/open/floor/plating/lava/smooth
	},
/area/ruin/powered/clownplanet)
"bO" = (
/obj/effect/decal/cleanable/cobweb,
/turf/open/indestructible/sound{
	icon_state = "bananium";
	name = "bananium floor";
	sound = 'sound/effects/clownstep1.ogg';
	wet = 5
	},
/area/ruin/powered/clownplanet)
"bP" = (
/obj/structure/statue/bananium/clown,
/turf/open/floor/carpet{
	baseturf = /turf/open/floor/plating/lava/smooth
	},
/area/ruin/powered/clownplanet)
"bQ" = (
/obj/structure/table/glass,
/obj/item/weapon/grown/bananapeel/bluespace,
/turf/open/floor/carpet{
	baseturf = /turf/open/floor/plating/lava/smooth
	},
/area/ruin/powered/clownplanet)
"bR" = (
/obj/structure/table/glass,
/obj/item/clothing/shoes/clown_shoes/banana_shoes,
/turf/open/floor/carpet{
	baseturf = /turf/open/floor/plating/lava/smooth
	},
/area/ruin/powered/clownplanet)
"bS" = (
/obj/item/weapon/coin/clown,
/obj/item/weapon/coin/clown,
/obj/item/weapon/coin/clown,
/obj/item/weapon/coin/clown,
/obj/machinery/light/small{
	dir = 8
	},
/turf/open/floor/carpet{
	baseturf = /turf/open/floor/plating/lava/smooth
	},
/area/ruin/powered/clownplanet)
"bT" = (
/obj/item/slime_extract/rainbow,
/obj/structure/table/glass,
/turf/open/floor/carpet{
	baseturf = /turf/open/floor/plating/lava/smooth
	},
/area/ruin/powered/clownplanet)
"bU" = (
/obj/item/weapon/bikehorn/airhorn,
/turf/open/floor/carpet{
	baseturf = /turf/open/floor/plating/lava/smooth
	},
/area/ruin/powered/clownplanet)
"bV" = (
/obj/structure/table/glass,
/obj/item/weapon/gun/magic/staff/honk,
/turf/open/floor/carpet{
	baseturf = /turf/open/floor/plating/lava/smooth
	},
/area/ruin/powered/clownplanet)
"bW" = (
/obj/item/weapon/bikehorn,
/turf/open/indestructible/sound{
	icon_state = "bananium";
	name = "bananium floor";
	sound = 'sound/effects/clownstep1.ogg';
	wet = 5
	},
/area/ruin/powered/clownplanet)
"bX" = (
/obj/structure/grille,
/obj/structure/window/reinforced/fulltile,
/turf/open/floor/plating,
/area/ruin/powered)
"bY" = (
/obj/effect/mob_spawn/human/corpse/damaged,
/obj/effect/decal/cleanable/blood/old,
/turf/open/indestructible/sound{
	icon_state = "bananium";
	name = "bananium floor";
	sound = 'sound/effects/clownstep1.ogg';
	wet = 5
	},
/area/ruin/powered/clownplanet)
"bZ" = (
/obj/machinery/door/airlock/clown,
/turf/open/indestructible/sound{
	icon_state = "bananium";
	name = "bananium floor";
	sound = 'sound/effects/clownstep1.ogg';
	wet = 5
	},
/area/ruin/powered/clownplanet)
"ca" = (
/obj/item/weapon/bikehorn,
/obj/effect/decal/cleanable/dirt,
/turf/open/indestructible/sound{
	icon_state = "bananium";
	name = "bananium floor";
	sound = 'sound/effects/clownstep1.ogg';
	wet = 5
	},
/area/ruin/powered/clownplanet)
"cb" = (
/obj/machinery/light{
	dir = 1
	},
/turf/open/floor/plating/asteroid/basalt/lava_land_surface,
/area/ruin/powered)
"cc" = (
/turf/closed/wall/r_wall{
	baseturf = /turf/open/floor/plating/lava/smooth
	},
/area/ruin/powered/clownplanet)
"cd" = (
/obj/structure/disposalpipe/segment{
	invisibility = 101
	},
/turf/closed/wall/r_wall{
	baseturf = /turf/open/floor/plating/lava/smooth
	},
/area/ruin/powered/clownplanet)
"ce" = (
/turf/open/floor/plating{
	baseturf = /turf/open/floor/plating/lava/smooth
	},
/area/ruin/powered/clownplanet)
"cf" = (
/obj/machinery/light/small,
/turf/open/floor/noslip{
	baseturf = /turf/open/floor/plating/lava/smooth;
	initial_gas_mix = "o2=14;n2=23;TEMP=300"
	},
/area/ruin/powered)
"cg" = (
/obj/structure/disposalpipe/segment{
	invisibility = 101
	},
/obj/machinery/light/small{
	dir = 1
	},
/turf/open/indestructible{
	icon_state = "darkyellowfull";
	wet = 5
	},
/area/ruin/powered/clownplanet)
"ch" = (
/obj/structure/disposalpipe/segment{
	dir = 4;
	invisibility = 101
	},
/obj/machinery/light/small{
	dir = 1
	},
/turf/open/indestructible{
	icon_state = "darkyellowfull";
	wet = 5
	},
/area/ruin/powered/clownplanet)
"ci" = (
/obj/structure/disposalpipe/segment{
	dir = 2;
	icon_state = "pipe-c";
	invisibility = 101
	},
/obj/machinery/light/small{
	dir = 4
	},
/turf/open/indestructible{
	icon_state = "darkyellowfull";
	wet = 5
	},
/area/ruin/powered/clownplanet)
"cj" = (
/obj/structure/disposalpipe/segment{
	dir = 2;
	icon_state = "pipe-c";
	invisibility = 101
	},
/obj/effect/decal/cleanable/dirt,
/obj/machinery/light/small{
	dir = 8
	},
/turf/open/indestructible{
	icon_state = "darkyellowfull";
	wet = 5
	},
/area/ruin/powered/clownplanet)
"ck" = (
/obj/structure/disposalpipe/segment{
	dir = 4;
	invisibility = 101
	},
/obj/machinery/light/small{
	brightness = 3;
	dir = 8
	},
/turf/open/indestructible{
	icon_state = "white"
	},
/area/ruin/powered/clownplanet)
"cl" = (
/obj/structure/disposalpipe/segment{
	dir = 4;
	invisibility = 101
	},
/obj/machinery/light/small{
	dir = 4
	},
/turf/open/indestructible{
	icon_state = "white"
	},
/area/ruin/powered/clownplanet)
"cm" = (
/obj/structure/disposalpipe/segment{
	dir = 8;
	icon_state = "pipe-c";
	invisibility = 101
	},
/obj/machinery/light/small{
	dir = 4
	},
/turf/open/indestructible{
	icon_state = "white"
	},
/area/ruin/powered/clownplanet)
"cn" = (
/obj/machinery/light{
	dir = 1
	},
/turf/open/indestructible{
	icon_state = "darkredfull";
	wet = 5
	},
/area/ruin/powered/clownplanet)
"co" = (
/obj/machinery/light{
	dir = 1
	},
/turf/open/indestructible{
	icon_state = "darkredfull";
	wet = 5
	},
/area/ruin/powered/clownplanet)
"cp" = (
/obj/machinery/light/small{
	dir = 1
	},
/turf/open/floor/carpet{
	baseturf = /turf/open/floor/plating/lava/smooth
	},
/area/ruin/powered/clownplanet)
"cq" = (
/obj/item/weapon/coin/clown,
/obj/item/weapon/coin/clown,
/obj/item/weapon/coin/clown,
/obj/item/weapon/coin/clown,
/obj/machinery/light/small{
	dir = 4
	},
/turf/open/floor/carpet{
	baseturf = /turf/open/floor/plating/lava/smooth
	},
/area/ruin/powered/clownplanet)
"cr" = (
/obj/machinery/light{
	dir = 1
	},
/turf/open/indestructible/sound{
	icon_state = "bananium";
	name = "bananium floor";
	sound = 'sound/effects/clownstep1.ogg';
	wet = 5
	},
/area/ruin/powered/clownplanet)
"cs" = (
/obj/machinery/light{
	dir = 1
	},
/turf/open/indestructible/sound{
	icon_state = "bananium";
	name = "bananium floor";
	sound = 'sound/effects/clownstep1.ogg';
	wet = 5
	},
/area/ruin/powered/clownplanet)
"ct" = (
/obj/machinery/light,
/turf/open/indestructible/sound{
	icon_state = "bananium";
	name = "bananium floor";
	sound = 'sound/effects/clownstep1.ogg';
	wet = 5
	},
/area/ruin/powered/clownplanet)
"cu" = (
/obj/machinery/light,
/turf/open/indestructible/sound{
	icon_state = "bananium";
	name = "bananium floor";
	sound = 'sound/effects/clownstep1.ogg';
	wet = 5
	},
/area/ruin/powered/clownplanet)

(1,1,1) = {"
aa
aa
aa
aa
aa
aa
aa
aa
aa
aa
aa
aa
aa
aa
aa
ab
ab
ab
ab
ab
aa
aa
aa
aa
aa
aa
aa
aa
aa
aa
aa
aa
"}
(2,1,1) = {"
aa
aa
aa
aa
aa
aa
aa
ah
ah
ah
ah
ah
ah
ah
bo
ab
bw
ab
ab
bw
bo
ah
ah
ah
ah
ah
aa
aa
aa
aa
aa
aa
"}
(3,1,1) = {"
aa
aa
aa
aa
aa
ah
ah
ah
ak
ak
ak
ak
ak
ah
ah
bw
bw
bG
bw
bw
ah
ah
ak
ak
ak
ah
ah
ah
aa
aa
aa
aa
"}
(4,1,1) = {"
aa
aa
aa
aa
ah
ah
ak
ak
ak
aR
aJ
ao
aJ
ak
ah
ah
bw
bw
bw
ah
ah
ak
ak
bX
aQ
ak
ak
ah
ah
aa
aa
aa
"}
(5,1,1) = {"
aa
aa
aa
ah
ah
ak
ak
am
aN
aS
cj
aH
bf
aJ
ak
ah
ah
ah
ah
ah
bO
bB
bX
ak
ak
ak
ak
ak
ah
ah
aa
aa
"}
(6,1,1) = {"
aa
aa
aa
ah
ak
ak
cc
aF
at
ar
aW
ar
aG
aL
ak
ah
bB
bH
bB
ah
bB
bH
bY
bB
bX
ak
bX
ak
ak
ah
cb
aa
"}
(7,1,1) = {"
aa
aa
ah
ah
ak
am
ax
aB
az
am
ar
aJ
aL
aL
cc
bx
bA
bB
bH
bH
bB
bH
bB
bB
bB
ah
ak
aQ
ak
ah
ah
aa
"}
(8,1,1) = {"
aa
aa
ah
ak
ak
ap
ar
aG
az
aL
aX
aL
bb
ck
bp
cc
cn
bA
bB
cc
cc
bH
cc
bB
bB
bB
bX
ak
ak
ak
ah
aa
"}
(9,1,1) = {"
aa
aa
ah
ak
am
ar
ar
aH
aA
aA
aL
bb
bb
bb
bq
bp
cc
cc
bA
bB
bB
bH
bB
bB
ca
bH
ct
ah
ak
ak
ah
aa
"}
(10,1,1) = {"
aa
ad
ah
ak
an
as
ar
aG
aL
az
aL
bb
bb
bj
bl
br
bA
bA
bA
bB
cc
bB
bB
bH
bH
bB
bB
ak
bX
ak
ah
ah
"}
(11,1,1) = {"
aa
ae
ah
ak
ao
cd
cg
aH
az
az
aL
bb
bg
bj
bl
bp
cc
bA
bA
bB
bB
cc
bB
bB
bB
bB
bH
ak
bX
ak
ak
ah
"}
(12,1,1) = {"
aa
ad
ah
ak
ap
ar
ar
aI
az
an
aB
aL
bb
cl
br
cc
cc
bA
bB
bB
cc
cc
bB
bB
cc
bB
bH
ak
aQ
bX
ak
ah
"}
(13,1,1) = {"
ab
ad
ah
ak
cc
at
ar
aB
aM
ax
ar
aB
aL
aL
bs
cd
aJ
cc
cc
cc
bP
bS
cc
cr
bB
bH
ca
bB
ak
bX
ak
ah
"}
(14,1,1) = {"
ab
af
ah
ah
ak
an
ar
ar
ar
ar
aY
ar
aH
aA
aV
ay
az
cc
cc
bL
bM
bM
bM
cc
bB
bH
bH
bB
ak
bX
ak
ah
"}
(15,1,1) = {"
ac
ac
ai
al
al
au
ar
cd
ar
aT
cd
ax
ar
aH
aD
aA
aM
aG
cc
cp
bQ
bT
bM
cc
cc
bH
bB
bB
ak
bX
ak
ah
"}
(16,1,1) = {"
ac
ag
cf
ah
ak
ao
ar
aJ
at
aG
at
ar
ar
au
bt
aM
aG
aV
cd
bN
bM
bU
bM
bZ
bB
bH
bB
cc
ak
bX
ak
ah
"}
(17,1,1) = {"
ac
ac
aj
al
al
av
ay
aA
aA
aL
aA
bc
ar
aG
bu
by
bC
aD
cc
bM
bR
bV
bM
cc
bB
bB
bB
bB
ak
bX
ak
ah
"}
(18,1,1) = {"
ab
ac
ah
ah
ak
cc
az
az
az
aA
aA
aA
aC
aM
aG
ba
aL
bI
cc
bL
bM
bM
bM
cc
bB
bB
bB
bB
ak
bX
ak
ah
"}
(19,1,1) = {"
ab
ad
ah
ak
ak
cc
az
az
aO
aA
aA
aL
cc
cc
aZ
cc
bD
cc
bB
cc
bP
cq
cc
cs
bB
bH
bH
bB
ak
bX
ak
ah
"}
(20,1,1) = {"
aa
ad
ah
ak
cc
cc
aA
aA
aA
az
aA
aL
bh
bk
bn
cc
bE
aJ
bB
bB
cc
cc
bY
bB
bB
bH
bB
ak
bX
aQ
ak
ah
"}
(21,1,1) = {"
aa
ae
ah
ak
cc
cc
ch
aK
aL
az
aL
bd
bb
bl
bl
bp
cc
bJ
bA
bB
bB
cc
bB
bH
bB
bB
bB
ak
bX
ak
ak
ah
"}
(22,1,1) = {"
aa
ad
ah
ak
aq
aw
aB
aL
aP
az
aL
be
bb
bl
bl
bz
cd
bK
cc
bB
bB
bH
bH
bH
bB
bW
cu
ah
bX
ak
ah
ah
"}
(23,1,1) = {"
aa
aa
ah
ak
cc
cc
aC
aA
aA
aO
aZ
bb
bi
bm
br
bp
cc
bA
bA
bB
bB
bH
bH
bB
bB
ah
ah
ak
aQ
ak
ah
aa
"}
(24,1,1) = {"
aa
aa
ah
ak
cc
cc
aD
aA
aL
aA
aL
aL
bh
cm
bp
cc
co
bA
bB
bB
bB
bB
bB
cc
bB
bB
ak
aQ
ak
ak
ah
aa
"}
(25,1,1) = {"
aa
aa
ah
ak
ak
cc
aE
aA
aA
aA
aM
aB
aL
cc
cc
bA
bA
bB
bB
bB
bH
bW
bB
bB
bB
ah
ak
bX
ak
ah
ah
aa
"}
(26,1,1) = {"
aa
aa
ah
ah
ak
cc
cc
aM
aB
ci
ar
ar
aS
cc
ak
ah
bF
bB
bB
ah
bB
bB
cc
bB
bB
ak
aQ
ak
ak
ah
cb
aa
"}
(27,1,1) = {"
aa
aa
aa
ah
ah
ak
ak
cc
ce
cc
ba
aC
ce
cc
ak
ah
ah
ah
ah
ah
bB
bB
bB
ak
ak
ak
ak
ak
ah
ah
aa
aa
"}
(28,1,1) = {"
aa
aa
aa
aa
ah
ah
ak
ak
ak
aU
aU
aU
cc
ak
ah
ah
bw
bw
bw
ah
ah
ak
ak
aQ
bX
ak
ak
ah
ah
aa
aa
aa
"}
(29,1,1) = {"
aa
aa
aa
aa
aa
ah
ah
ah
ak
ak
ak
ak
ak
ah
ah
bw
bw
bG
bw
bw
ah
ah
ak
ak
ak
ah
ah
ah
aa
aa
aa
aa
"}
(30,1,1) = {"
aa
aa
aa
aa
aa
aa
aa
ah
ah
ah
ah
ah
ah
ah
bv
ab
ab
ab
ab
bw
bv
ah
ah
ah
ah
ah
aa
aa
aa
aa
aa
aa
"}
(31,1,1) = {"
aa
aa
aa
aa
aa
aa
aa
aa
aa
aa
aa
aa
aa
aa
aa
ab
bw
ab
ab
ab
aa
aa
aa
aa
aa
aa
aa
aa
aa
aa
aa
aa
"}
(32,1,1) = {"
aa
aa
aa
aa
aa
aa
aa
aa
aa
aa
aa
aa
aa
aa
aa
aa
aa
aa
aa
aa
aa
aa
aa
aa
aa
aa
aa
aa
aa
aa
aa
aa
"}
