"a" = (/turf/template_noop,/area/template_noop)
"b" = (/turf/closed/mineral/volcanic,/area/template_noop)
"c" = (/turf/open/floor/plating/asteroid/basalt/lava_land_surface,/area/template_noop)
"d" = (/mob/living/simple_animal/hostile/russian/sniper,/turf/open/floor/plating/asteroid/basalt/lava_land_surface,/area/template_noop)
"e" = (/obj/structure/barricade/wooden,/turf/open/floor/plating/asteroid/basalt/lava_land_surface,/area/template_noop)
"f" = (/obj/effect/spawner/lootdrop/armory_contraband,/obj/structure/closet/crate,/turf/open/floor/plating/asteroid/basalt/lava_land_surface,/area/template_noop)
"g" = (/mob/living/simple_animal/hostile/russian/engineer,/turf/open/floor/plating/asteroid/basalt/lava_land_surface,/area/template_noop)
"h" = (/obj/structure/russian_command_post,/turf/open/floor/plating/asteroid/basalt/lava_land_surface,/area/template_noop)
"i" = (/mob/living/simple_animal/hostile/russian,/turf/open/floor/plating/asteroid/basalt/lava_land_surface,/area/template_noop)
"j" = (/mob/living/simple_animal/hostile/russian/medic,/turf/open/floor/plating/asteroid/basalt/lava_land_surface,/area/template_noop)
"k" = (/obj/structure/barricade/sandbags,/turf/open/floor/plating/asteroid/basalt/lava_land_surface,/area/template_noop)

(1,1,1) = {"
aaaaaaaaaaaaaaa
aaaaaaaaaaaaaaa
aaaaaaaaaaaaaaa
aabbbbbbbbbbbba
aabccccccccdcba
aabcccefffcccba
aabccccgheccbba
aabcciccgfccbba
abbccccccfcjbba
abjccciccicbbba
abbccccccccccba
aabbbbbkkkccbba
aaaaabbcccccbaa
aaaaaabbbbbbbaa
aaaaaaaaaaaaaaa
"}
