//MAP CONVERTED BY dmm2tgm.py THIS HEADER COMMENT PREVENTS RECONVERSION, DO NOT REMOVE
"a" = (
/obj/effect/mapping_helpers/no_atoms_ontop,
/turf/template_noop,
/area/template_noop)
"l" = (
/obj/effect/mapping_helpers/no_atoms_ontop,
/turf/open/misc/asteroid/snow/icemoon,
/area/icemoon/surface/outdoors/unexplored/rivers/no_monsters)
"L" = (
/obj/structure/ore_vent/random/icebox,
/obj/effect/mapping_helpers/no_atoms_ontop,
/turf/open/misc/asteroid/snow/icemoon,
/area/icemoon/surface/outdoors/unexplored/rivers/no_monsters)

(1,1,1) = {"
a
l
a
"}
(2,1,1) = {"
l
L
l
"}
(3,1,1) = {"
a
l
a
"}
