//MAP CONVERTED BY dmm2tgm.py THIS HEADER COMMENT PREVENTS RECONVERSION, DO NOT REMOVE
"aa" = (
/turf/open/floor/plating/asteroid/snow/icemoon,
/area/icemoon/surface/outdoors)
"ab" = (
/turf/open/floor/plating/snowed/icemoon,
/area/icemoon/surface/outdoors)
"ac" = (
/obj/effect/mob_spawn/corpse/human/engineer/rig,
/turf/open/floor/plating/snowed/icemoon,
/area/icemoon/surface/outdoors)
"ad" = (
/obj/machinery/power/floodlight,
/obj/structure/cable,
/turf/open/floor/plating/snowed/icemoon,
/area/icemoon/surface/outdoors)
"ae" = (
/turf/closed/wall/r_wall,
/area/icemoon/surface/outdoors)
"af" = (
/obj/structure/lattice,
/turf/open/floor/plating/asteroid/snow/icemoon,
/area/icemoon/surface/outdoors)
"ag" = (
/obj/structure/cable,
/turf/open/floor/plating/icemoon,
/area/icemoon/surface/outdoors)
"ah" = (
/obj/effect/decal/cleanable/blood,
/turf/open/floor/plating/icemoon,
/area/icemoon/surface/outdoors)
"ai" = (
/obj/item/disk/holodisk/ruin/snowengieruin,
/turf/open/floor/plating/icemoon,
/area/icemoon/surface/outdoors)
"aj" = (
/turf/open/floor/iron/icemoon,
/area/icemoon/surface/outdoors)
"ak" = (
/turf/closed/wall/ice,
/area/icemoon/surface/outdoors)
"al" = (
/turf/open/floor/plating/icemoon,
/area/icemoon/surface/outdoors)
"am" = (
/obj/machinery/power/emitter,
/obj/structure/cable,
/obj/effect/turf_decal/stripes/end{
	dir = 1
	},
/turf/open/floor/plating/icemoon,
/area/icemoon/surface/outdoors)
"an" = (
/turf/closed/wall/mineral/snow,
/area/icemoon/surface/outdoors)
"ao" = (
/obj/effect/decal/cleanable/dirt,
/turf/open/floor/plating/snowed/icemoon,
/area/icemoon/surface/outdoors)
"ap" = (
/obj/effect/turf_decal/stripes/line{
	dir = 1
	},
/turf/open/floor/plating/icemoon,
/area/icemoon/surface/outdoors)
"aq" = (
/obj/machinery/field/generator,
/obj/effect/turf_decal/stripes/line{
	dir = 1
	},
/turf/open/floor/plating/icemoon,
/area/icemoon/surface/outdoors)
"ar" = (
/obj/structure/cable,
/obj/effect/turf_decal/stripes/line{
	dir = 5
	},
/turf/open/floor/plating/icemoon,
/area/icemoon/surface/outdoors)
"as" = (
/obj/effect/decal/cleanable/blood/tracks,
/turf/open/floor/plating/icemoon,
/area/icemoon/surface/outdoors)
"at" = (
/obj/structure/cable,
/obj/effect/turf_decal/stripes/line{
	dir = 4
	},
/turf/open/floor/plating/icemoon,
/area/icemoon/surface/outdoors)
"au" = (
/obj/effect/decal/cleanable/blood/splatter,
/obj/effect/decal/cleanable/blood/tracks,
/turf/open/floor/plating/icemoon,
/area/icemoon/surface/outdoors)
"av" = (
/obj/item/clothing/under/rank/engineering/chief_engineer,
/turf/open/floor/iron/icemoon,
/area/icemoon/surface/outdoors)
"aw" = (
/obj/structure/cable,
/turf/open/floor/iron/icemoon,
/area/icemoon/surface/outdoors)
"ax" = (
/obj/machinery/atmospherics/components/unary/vent_scrubber,
/turf/open/floor/engine/o2,
/area/icemoon/surface/outdoors)
"ay" = (
/obj/machinery/atmospherics/components/unary/vent_pump/high_volume,
/turf/open/floor/engine/o2,
/area/icemoon/surface/outdoors)
"az" = (
/obj/machinery/atmospherics/components/unary/vent_scrubber,
/turf/open/floor/engine/n2,
/area/icemoon/surface/outdoors)
"aA" = (
/obj/machinery/atmospherics/components/unary/vent_pump/high_volume,
/turf/open/floor/engine/n2,
/area/icemoon/surface/outdoors)
"aB" = (
/turf/closed/wall,
/area/icemoon/surface/outdoors)
"aC" = (
/obj/effect/turf_decal/trimline/yellow/filled/line{
	dir = 4
	},
/turf/open/floor/iron/icemoon,
/area/icemoon/surface/outdoors)
"aD" = (
/obj/machinery/atmospherics/pipe/smart/manifold4w/cyan/visible,
/turf/open/floor/engine/o2,
/area/icemoon/surface/outdoors)
"aE" = (
/obj/machinery/atmospherics/pipe/smart/manifold4w/brown,
/turf/open/floor/engine/o2,
/area/icemoon/surface/outdoors)
"aF" = (
/obj/machinery/atmospherics/pipe/smart/manifold4w/cyan/visible,
/turf/open/floor/engine/n2,
/area/icemoon/surface/outdoors)
"aG" = (
/obj/machinery/atmospherics/pipe/smart/manifold4w/brown,
/turf/open/floor/engine/n2,
/area/icemoon/surface/outdoors)
"aH" = (
/obj/effect/turf_decal/stripes/line{
	dir = 8
	},
/turf/open/floor/plating/snowed/icemoon,
/area/icemoon/surface/outdoors)
"aI" = (
/obj/item/pda/engineering{
	note = "To-do: Check on singularity status. Get a pint at eat. Nag the research manager for RCDs."
	},
/turf/open/floor/plating/asteroid/snow/icemoon,
/area/icemoon/surface/outdoors)
"aJ" = (
/obj/effect/decal/cleanable/dirt,
/turf/open/floor/plating/icemoon,
/area/icemoon/surface/outdoors)
"aK" = (
/obj/effect/turf_decal/trimline/yellow/filled/line{
	dir = 8
	},
/obj/machinery/light/small/broken/directional/west,
/turf/open/floor/iron/icemoon,
/area/icemoon/surface/outdoors)
"aL" = (
/obj/effect/turf_decal/trimline/yellow/filled/line{
	dir = 4
	},
/obj/machinery/light/small/directional/east,
/turf/open/floor/iron/icemoon,
/area/icemoon/surface/outdoors)
"aM" = (
/obj/effect/spawner/structure/window/reinforced/plasma,
/obj/machinery/atmospherics/pipe/smart/manifold4w/cyan/visible,
/turf/open/floor/engine/airless,
/area/icemoon/surface/outdoors)
"aO" = (
/turf/closed/wall/r_wall/rust,
/area/icemoon/surface/outdoors)
"aP" = (
/obj/effect/turf_decal/tile/yellow{
	dir = 1
	},
/obj/effect/turf_decal/tile/yellow{
	dir = 8
	},
/obj/effect/turf_decal/stripes/line{
	dir = 8
	},
/turf/open/floor/iron/icemoon,
/area/icemoon/surface/outdoors)
"aQ" = (
/obj/effect/spawner/structure/window/reinforced,
/turf/open/floor/iron/icemoon,
/area/icemoon/surface/outdoors)
"aR" = (
/obj/effect/turf_decal/trimline/yellow/filled/line{
	dir = 8
	},
/turf/open/floor/iron/icemoon,
/area/icemoon/surface/outdoors)
"aT" = (
/obj/machinery/atmospherics/pipe/smart/manifold4w/supply/hidden{
	dir = 4
	},
/obj/structure/cable,
/turf/open/floor/iron/icemoon,
/area/icemoon/surface/outdoors)
"aV" = (
/obj/effect/turf_decal/stripes/line{
	dir = 1
	},
/turf/open/floor/iron/icemoon,
/area/icemoon/surface/outdoors)
"aW" = (
/obj/machinery/atmospherics/pipe/smart/manifold4w/brown,
/obj/effect/turf_decal/stripes/line{
	dir = 1
	},
/turf/open/floor/iron/icemoon,
/area/icemoon/surface/outdoors)
"aX" = (
/obj/effect/turf_decal/stripes/corner{
	dir = 4
	},
/obj/effect/turf_decal/stripes/corner{
	dir = 1
	},
/obj/machinery/light/small/directional/north,
/turf/open/floor/iron/icemoon,
/area/icemoon/surface/outdoors)
"ba" = (
/obj/effect/turf_decal/stripes/corner{
	dir = 1
	},
/obj/machinery/atmospherics/pipe/smart/manifold4w/green/visible,
/turf/open/floor/iron/icemoon,
/area/icemoon/surface/outdoors)
"bc" = (
/obj/structure/cable,
/obj/effect/turf_decal/stripes/line{
	dir = 8
	},
/turf/open/floor/plating/icemoon,
/area/icemoon/surface/outdoors)
"bd" = (
/obj/effect/decal/cleanable/blood/splatter,
/turf/open/floor/plating/asteroid/snow/icemoon,
/area/icemoon/surface/outdoors)
"be" = (
/obj/item/card/id/advanced/engioutpost,
/turf/open/floor/plating/asteroid/snow/icemoon,
/area/icemoon/surface/outdoors)
"bf" = (
/obj/effect/gibspawner/generic,
/obj/effect/decal/cleanable/blood,
/obj/effect/decal/cleanable/blood/gibs/core,
/turf/open/floor/plating/asteroid/snow/icemoon,
/area/icemoon/surface/outdoors)
"bi" = (
/obj/machinery/door/airlock/engineering{
	name = "The Singularity Engine"
	},
/obj/structure/cable,
/turf/open/floor/plating/icemoon,
/area/icemoon/surface/outdoors)
"bj" = (
/obj/structure/cable,
/obj/effect/turf_decal/tile/yellow{
	dir = 1
	},
/obj/effect/turf_decal/tile/yellow{
	dir = 8
	},
/obj/effect/turf_decal/stripes/line{
	dir = 8
	},
/obj/machinery/atmospherics/pipe/smart/manifold4w/supply/hidden{
	dir = 4
	},
/turf/open/floor/iron/icemoon,
/area/icemoon/surface/outdoors)
"bk" = (
/obj/structure/cable,
/obj/machinery/atmospherics/pipe/smart/manifold4w/supply/hidden{
	dir = 4
	},
/turf/open/floor/iron/icemoon,
/area/icemoon/surface/outdoors)
"bl" = (
/obj/machinery/door/airlock/engineering{
	name = "Engine Entry";
	req_access_txt = "204"
	},
/obj/structure/cable,
/obj/machinery/atmospherics/pipe/smart/manifold4w/supply/hidden{
	dir = 4
	},
/turf/open/floor/iron/icemoon,
/area/icemoon/surface/outdoors)
"bm" = (
/obj/structure/cable,
/obj/effect/turf_decal/trimline/yellow/filled/warning{
	dir = 8
	},
/obj/machinery/atmospherics/pipe/smart/manifold4w/supply/hidden{
	dir = 4
	},
/turf/open/floor/iron/icemoon,
/area/icemoon/surface/outdoors)
"bo" = (
/obj/machinery/atmospherics/components/unary/vent_pump/on{
	dir = 4
	},
/obj/structure/cable,
/turf/open/floor/iron/icemoon,
/area/icemoon/surface/outdoors)
"bq" = (
/obj/machinery/atmospherics/pipe/smart/manifold4w/supply/visible{
	dir = 1
	},
/obj/structure/cable,
/turf/open/floor/iron/icemoon,
/area/icemoon/surface/outdoors)
"br" = (
/obj/effect/turf_decal/trimline/yellow/filled/warning{
	dir = 4
	},
/obj/machinery/atmospherics/pipe/smart/manifold4w/supply/hidden{
	dir = 4
	},
/obj/structure/cable,
/turf/open/floor/iron/icemoon,
/area/icemoon/surface/outdoors)
"bs" = (
/obj/effect/turf_decal/trimline/yellow/filled/warning{
	dir = 8
	},
/obj/machinery/atmospherics/pipe/smart/manifold4w/supply/hidden{
	dir = 4
	},
/obj/structure/cable,
/turf/open/floor/iron/icemoon,
/area/icemoon/surface/outdoors)
"bv" = (
/obj/machinery/atmospherics/pipe/smart/manifold4w/brown,
/obj/structure/cable,
/turf/open/floor/iron/icemoon,
/area/icemoon/surface/outdoors)
"bx" = (
/obj/machinery/power/apc/unlocked{
	dir = 4;
	pixel_x = 26
	},
/obj/structure/cable,
/obj/machinery/atmospherics/pipe/smart/manifold4w/green/visible,
/turf/open/floor/iron/icemoon,
/area/icemoon/surface/outdoors)
"by" = (
/obj/item/stack/rods{
	amount = 2
	},
/obj/item/shard/plasma,
/turf/open/floor/plating/snowed/icemoon,
/area/icemoon/surface/outdoors)
"bz" = (
/obj/item/clothing/suit/space/hardsuit/engine,
/turf/open/floor/plating/asteroid/snow/icemoon,
/area/icemoon/surface/outdoors)
"bA" = (
/obj/item/flashlight/flare,
/turf/open/floor/plating/asteroid/snow/icemoon,
/area/icemoon/surface/outdoors)
"bB" = (
/obj/structure/cable,
/obj/effect/turf_decal/stripes/line{
	dir = 4
	},
/turf/open/floor/plating/snowed/icemoon,
/area/icemoon/surface/outdoors)
"bC" = (
/obj/machinery/atmospherics/pipe/smart/manifold4w/supply/visible,
/turf/open/floor/plating/icemoon,
/area/icemoon/surface/outdoors)
"bD" = (
/obj/effect/decal/cleanable/robot_debris,
/obj/effect/turf_decal/tile/yellow{
	dir = 1
	},
/obj/effect/turf_decal/tile/yellow{
	dir = 8
	},
/obj/effect/turf_decal/stripes/line{
	dir = 8
	},
/turf/open/floor/iron/icemoon,
/area/icemoon/surface/outdoors)
"bE" = (
/obj/effect/turf_decal/trimline/yellow/filled/line{
	dir = 8
	},
/obj/structure/cable,
/turf/open/floor/iron/icemoon,
/area/icemoon/surface/outdoors)
"bF" = (
/obj/machinery/atmospherics/pipe/smart/manifold4w/supply/hidden,
/obj/structure/cable,
/turf/open/floor/iron/icemoon,
/area/icemoon/surface/outdoors)
"bG" = (
/obj/effect/turf_decal/trimline/yellow/filled/warning{
	dir = 4
	},
/obj/machinery/atmospherics/pipe/smart/manifold4w/scrubbers/hidden/layer2,
/turf/open/floor/iron/icemoon,
/area/icemoon/surface/outdoors)
"bH" = (
/obj/effect/turf_decal/trimline/yellow/filled/warning{
	dir = 8
	},
/obj/machinery/atmospherics/pipe/smart/manifold4w/scrubbers/hidden/layer2,
/turf/open/floor/iron/icemoon,
/area/icemoon/surface/outdoors)
"bI" = (
/obj/item/pda/clear{
	note = "Chief's asked me to check on the machinery inside PDA. He's also worried about Build, but i'm sure Harry'll handle the construction. I just need to work on Internals. Fuck i'm hungry"
	},
/obj/machinery/atmospherics/pipe/smart/manifold4w/scrubbers/hidden/layer2,
/turf/open/floor/iron/icemoon,
/area/icemoon/surface/outdoors)
"bL" = (
/obj/machinery/atmospherics/pipe/smart/manifold4w/scrubbers/visible{
	dir = 1;
	icon_state = "manifold-2"
	},
/turf/open/floor/iron/icemoon,
/area/icemoon/surface/outdoors)
"bM" = (
/obj/machinery/atmospherics/pipe/smart/manifold4w/supply/visible,
/obj/machinery/atmospherics/pipe/smart/manifold4w/scrubbers/hidden/layer2,
/turf/open/floor/iron/icemoon,
/area/icemoon/surface/outdoors)
"bQ" = (
/obj/machinery/atmospherics/components/binary/pump,
/turf/open/floor/iron/icemoon,
/area/icemoon/surface/outdoors)
"bR" = (
/obj/effect/spawner/structure/window/plasma,
/turf/open/floor/plating/snowed/icemoon,
/area/icemoon/surface/outdoors)
"bS" = (
/obj/structure/cable,
/turf/open/floor/plating/snowed/icemoon,
/area/icemoon/surface/outdoors)
"bT" = (
/obj/item/pipe_dispenser,
/turf/open/floor/plating/asteroid/snow/icemoon,
/area/icemoon/surface/outdoors)
"bU" = (
/obj/structure/sign/poster/official/build{
	pixel_x = -32
	},
/obj/effect/turf_decal/trimline/yellow/filled/line{
	dir = 8
	},
/obj/structure/cable,
/turf/open/floor/iron/icemoon,
/area/icemoon/surface/outdoors)
"bV" = (
/obj/effect/mob_spawn/corpse/human/assistant,
/turf/open/floor/iron/icemoon,
/area/icemoon/surface/outdoors)
"bW" = (
/obj/machinery/atmospherics/components/unary/vent_scrubber/on{
	dir = 4;
	icon_state = "scrub_map_on-2"
	},
/turf/open/floor/iron/icemoon,
/area/icemoon/surface/outdoors)
"bY" = (
/obj/machinery/atmospherics/pipe/smart/manifold4w/supply/hidden,
/obj/structure/cable,
/obj/machinery/atmospherics/pipe/smart/manifold4w/scrubbers/hidden/layer2,
/turf/open/floor/iron/icemoon,
/area/icemoon/surface/outdoors)
"bZ" = (
/obj/structure/sign/poster/official/safety_internals{
	pixel_x = 32
	},
/obj/effect/turf_decal/trimline/yellow/filled/line{
	dir = 4
	},
/obj/machinery/atmospherics/pipe/smart/manifold4w/scrubbers/hidden/layer2,
/turf/open/floor/iron/icemoon,
/area/icemoon/surface/outdoors)
"ca" = (
/obj/machinery/atmospherics/components/binary/pump{
	dir = 1;
	icon_state = "pump_map-2"
	},
/turf/open/floor/iron/icemoon,
/area/icemoon/surface/outdoors)
"cb" = (
/obj/item/flashlight,
/turf/open/floor/iron/icemoon,
/area/icemoon/surface/outdoors)
"cc" = (
/obj/item/book/manual/wiki/atmospherics,
/turf/open/floor/iron/icemoon,
/area/icemoon/surface/outdoors)
"cd" = (
/obj/machinery/atmospherics/components/unary/portables_connector/visible{
	dir = 4;
	icon_state = "connector_map-2"
	},
/turf/open/floor/iron/icemoon,
/area/icemoon/surface/outdoors)
"ce" = (
/obj/machinery/atmospherics/pipe/smart/manifold4w/dark/visible{
	dir = 4;
	icon_state = "manifold-2"
	},
/turf/open/floor/iron/icemoon,
/area/icemoon/surface/outdoors)
"cf" = (
/obj/machinery/airalarm/directional/east,
/obj/machinery/atmospherics/pipe/smart/manifold4w/green/visible,
/turf/open/floor/iron/icemoon,
/area/icemoon/surface/outdoors)
"cg" = (
/obj/item/wallframe/apc,
/turf/open/floor/plating/icemoon,
/area/icemoon/surface/outdoors)
"ch" = (
/obj/effect/turf_decal/trimline/yellow/filled/line{
	dir = 10
	},
/obj/structure/cable,
/turf/open/floor/iron/icemoon,
/area/icemoon/surface/outdoors)
"ci" = (
/obj/machinery/light/broken/directional/south,
/turf/open/floor/iron/icemoon,
/area/icemoon/surface/outdoors)
"cj" = (
/obj/structure/sign/poster/official/pda_ad{
	pixel_y = -32
	},
/turf/open/floor/iron/icemoon,
/area/icemoon/surface/outdoors)
"ck" = (
/obj/machinery/atmospherics/pipe/smart/manifold4w/scrubbers/hidden/layer2,
/turf/open/floor/iron/icemoon,
/area/icemoon/surface/outdoors)
"cl" = (
/obj/effect/turf_decal/trimline/yellow/filled/line{
	dir = 4
	},
/obj/machinery/light/directional/east,
/turf/open/floor/iron/icemoon,
/area/icemoon/surface/outdoors)
"cm" = (
/obj/structure/sign/poster/contraband/atmosia_independence{
	pixel_x = -32
	},
/turf/open/floor/iron/icemoon,
/area/icemoon/surface/outdoors)
"cn" = (
/obj/machinery/atmospherics/pipe/smart/manifold4w/supply/visible,
/turf/open/floor/iron/icemoon,
/area/icemoon/surface/outdoors)
"cp" = (
/obj/machinery/atmospherics/components/unary/portables_connector/visible,
/turf/open/floor/iron/icemoon,
/area/icemoon/surface/outdoors)
"cs" = (
/obj/machinery/light/directional/east,
/obj/machinery/atmospherics/pipe/smart/manifold4w/green/visible,
/turf/open/floor/iron/icemoon,
/area/icemoon/surface/outdoors)
"ct" = (
/obj/machinery/door/airlock/engineering/glass{
	name = "Production Room";
	req_access_txt = "204"
	},
/obj/effect/turf_decal/trimline/yellow/filled/line{
	dir = 1
	},
/obj/effect/turf_decal/trimline/yellow/filled/line,
/obj/structure/cable,
/turf/open/floor/iron/icemoon,
/area/icemoon/surface/outdoors)
"cu" = (
/obj/structure/girder,
/turf/open/floor/plating/asteroid/snow/icemoon,
/area/icemoon/surface/outdoors)
"cv" = (
/obj/machinery/atmospherics/components/binary/thermomachine/heater{
	dir = 4
	},
/turf/open/floor/iron/icemoon,
/area/icemoon/surface/outdoors)
"cx" = (
/obj/machinery/atmospherics/pipe/smart/manifold4w/green/visible,
/turf/open/floor/iron/icemoon,
/area/icemoon/surface/outdoors)
"cC" = (
/obj/structure/cable,
/obj/effect/decal/cleanable/oil,
/obj/effect/turf_decal/stripes/line{
	dir = 10
	},
/turf/open/floor/plating/icemoon,
/area/icemoon/surface/outdoors)
"cD" = (
/obj/effect/decal/cleanable/blood,
/obj/effect/turf_decal/stripes/line,
/turf/open/floor/plating/icemoon,
/area/icemoon/surface/outdoors)
"cE" = (
/obj/effect/turf_decal/stripes/line,
/turf/open/floor/plating/snowed/icemoon,
/area/icemoon/surface/outdoors)
"cF" = (
/obj/effect/decal/cleanable/dirt,
/obj/effect/turf_decal/stripes/line,
/turf/open/floor/plating/icemoon,
/area/icemoon/surface/outdoors)
"cG" = (
/obj/structure/cable,
/obj/machinery/field/generator,
/obj/effect/turf_decal/stripes/line{
	dir = 6
	},
/turf/open/floor/plating/icemoon,
/area/icemoon/surface/outdoors)
"cH" = (
/obj/effect/turf_decal/trimline/yellow/filled/line{
	dir = 1
	},
/obj/structure/cable,
/turf/open/floor/iron/icemoon,
/area/icemoon/surface/outdoors)
"cI" = (
/obj/machinery/modular_computer/console/preset/civilian,
/turf/open/floor/iron/icemoon,
/area/icemoon/surface/outdoors)
"cJ" = (
/obj/item/construction/rcd,
/obj/structure/rack,
/obj/item/rcd_ammo,
/obj/item/rcd_ammo,
/obj/item/rcd_upgrade/frames,
/turf/open/floor/iron/icemoon,
/area/icemoon/surface/outdoors)
"cK" = (
/obj/machinery/airalarm/directional/west,
/turf/open/floor/iron/icemoon,
/area/icemoon/surface/outdoors)
"cL" = (
/obj/structure/cable,
/obj/machinery/atmospherics/pipe/smart/manifold4w/supply/hidden,
/turf/open/floor/iron/icemoon,
/area/icemoon/surface/outdoors)
"cM" = (
/obj/machinery/atmospherics/components/unary/vent_pump/on{
	dir = 8
	},
/obj/effect/turf_decal/trimline/yellow/filled/line{
	dir = 4
	},
/turf/open/floor/iron/icemoon,
/area/icemoon/surface/outdoors)
"cN" = (
/obj/effect/turf_decal/stripes/corner,
/obj/machinery/space_heater,
/turf/open/floor/iron/icemoon,
/area/icemoon/surface/outdoors)
"cO" = (
/obj/effect/turf_decal/stripes/line,
/obj/machinery/atmospherics/components/binary/pump{
	dir = 1
	},
/turf/open/floor/iron/icemoon,
/area/icemoon/surface/outdoors)
"cP" = (
/obj/machinery/atmospherics/components/binary/pump,
/obj/effect/turf_decal/stripes/line,
/turf/open/floor/iron/icemoon,
/area/icemoon/surface/outdoors)
"cQ" = (
/obj/effect/turf_decal/stripes/corner,
/obj/effect/turf_decal/stripes/corner{
	dir = 8
	},
/obj/machinery/light/small/directional/south,
/turf/open/floor/iron/icemoon,
/area/icemoon/surface/outdoors)
"cR" = (
/obj/effect/turf_decal/stripes/line,
/turf/open/floor/iron/icemoon,
/area/icemoon/surface/outdoors)
"cS" = (
/obj/effect/turf_decal/stripes/corner{
	dir = 8
	},
/turf/open/floor/iron/icemoon,
/area/icemoon/surface/outdoors)
"cT" = (
/obj/machinery/power/emitter{
	dir = 1
	},
/obj/structure/cable,
/obj/effect/turf_decal/stripes/end,
/turf/open/floor/plating/icemoon,
/area/icemoon/surface/outdoors)
"cU" = (
/obj/structure/cable,
/obj/effect/mob_spawn/corpse/human/engineer/rig,
/turf/open/floor/plating/icemoon,
/area/icemoon/surface/outdoors)
"cV" = (
/obj/effect/turf_decal/trimline/neutral/filled/line,
/obj/machinery/space_heater,
/turf/open/floor/iron/icemoon,
/area/icemoon/surface/outdoors)
"cW" = (
/obj/effect/turf_decal/trimline/neutral/filled/line,
/obj/machinery/atmospherics/pipe/smart/manifold4w/scrubbers/hidden/layer2,
/turf/open/floor/iron/icemoon,
/area/icemoon/surface/outdoors)
"cX" = (
/obj/effect/turf_decal/trimline/neutral/filled/line,
/obj/machinery/atmospherics/pipe/smart/manifold4w/supply/hidden,
/obj/structure/cable,
/turf/open/floor/iron/icemoon,
/area/icemoon/surface/outdoors)
"cY" = (
/obj/effect/turf_decal/trimline/neutral/filled/line,
/obj/effect/turf_decal/trimline/yellow/filled/corner{
	dir = 4
	},
/turf/open/floor/iron/icemoon,
/area/icemoon/surface/outdoors)
"cZ" = (
/obj/effect/spawner/structure/window/reinforced/plasma,
/obj/machinery/atmospherics/pipe/smart/manifold4w/supply/visible,
/turf/open/floor/engine/airless,
/area/icemoon/surface/outdoors)
"db" = (
/obj/effect/spawner/structure/window/reinforced/plasma,
/obj/machinery/atmospherics/pipe/smart/manifold4w/brown/visible,
/turf/open/floor/engine/airless,
/area/icemoon/surface/outdoors)
"de" = (
/obj/machinery/rnd/production/circuit_imprinter/offstation,
/turf/open/floor/iron/icemoon,
/area/icemoon/surface/outdoors)
"df" = (
/obj/machinery/rnd/production/protolathe/department/engineering,
/obj/machinery/light/small/broken/directional/south,
/turf/open/floor/iron/icemoon,
/area/icemoon/surface/outdoors)
"dg" = (
/obj/machinery/autolathe,
/turf/open/floor/iron/icemoon,
/area/icemoon/surface/outdoors)
"dh" = (
/obj/structure/sign/poster/contraband/grey_tide,
/obj/machinery/atmospherics/pipe/smart/manifold4w/scrubbers/hidden/layer2,
/turf/closed/wall,
/area/icemoon/surface/outdoors)
"di" = (
/obj/machinery/door/airlock,
/obj/machinery/atmospherics/pipe/smart/manifold4w/supply/hidden,
/obj/structure/cable,
/turf/open/floor/iron/icemoon,
/area/icemoon/surface/outdoors)
"dj" = (
/turf/closed/wall/rust,
/area/icemoon/surface/outdoors)
"dk" = (
/obj/machinery/atmospherics/pipe/smart/manifold4w/supply/visible,
/turf/open/floor/engine/air,
/area/icemoon/surface/outdoors)
"dl" = (
/obj/machinery/atmospherics/pipe/smart/manifold4w/brown,
/turf/open/floor/engine/air,
/area/icemoon/surface/outdoors)
"dn" = (
/obj/machinery/atmospherics/pipe/smart/manifold4w/brown/visible,
/turf/open/floor/engine/vacuum,
/area/icemoon/surface/outdoors)
"do" = (
/obj/machinery/power/port_gen/pacman,
/obj/structure/cable,
/obj/effect/decal/cleanable/oil/streak,
/turf/open/floor/plating/icemoon,
/area/icemoon/surface/outdoors)
"dp" = (
/obj/machinery/light/built/directional/south,
/turf/open/floor/plating/icemoon,
/area/icemoon/surface/outdoors)
"dq" = (
/obj/item/tank/internals/plasma,
/turf/open/floor/plating/icemoon,
/area/icemoon/surface/outdoors)
"dr" = (
/obj/machinery/power/floodlight,
/obj/structure/cable,
/turf/open/floor/plating/icemoon,
/area/icemoon/surface/outdoors)
"ds" = (
/obj/structure/tank_dispenser,
/turf/open/floor/plating/icemoon,
/area/icemoon/surface/outdoors)
"dt" = (
/obj/effect/turf_decal/trimline/neutral/filled/line{
	dir = 1
	},
/obj/machinery/atmospherics/pipe/smart/manifold4w/scrubbers/hidden,
/obj/structure/cable,
/turf/open/floor/iron/icemoon,
/area/icemoon/surface/outdoors)
"du" = (
/obj/effect/turf_decal/trimline/neutral/filled/line{
	dir = 1
	},
/obj/machinery/atmospherics/pipe/smart/manifold4w/supply/hidden,
/obj/structure/cable,
/turf/open/floor/iron/icemoon,
/area/icemoon/surface/outdoors)
"dv" = (
/obj/effect/turf_decal/trimline/neutral/filled/line{
	dir = 1
	},
/obj/machinery/airalarm/directional/north,
/turf/open/floor/iron/icemoon,
/area/icemoon/surface/outdoors)
"dw" = (
/obj/machinery/atmospherics/components/unary/vent_scrubber{
	dir = 1
	},
/turf/open/floor/engine/air,
/area/icemoon/surface/outdoors)
"dx" = (
/obj/machinery/atmospherics/components/unary/vent_pump/high_volume{
	dir = 1
	},
/turf/open/floor/engine/air,
/area/icemoon/surface/outdoors)
"dy" = (
/obj/machinery/atmospherics/components/unary/vent_scrubber{
	dir = 1
	},
/turf/open/floor/engine/vacuum,
/area/icemoon/surface/outdoors)
"dz" = (
/obj/machinery/atmospherics/components/unary/vent_pump/high_volume{
	dir = 1
	},
/turf/open/floor/engine/vacuum,
/area/icemoon/surface/outdoors)
"dA" = (
/obj/machinery/atmospherics/components/unary/vent_scrubber/on{
	dir = 1;
	icon_state = "scrub_map_on-2"
	},
/obj/effect/turf_decal/trimline/neutral/filled/line,
/obj/effect/turf_decal/weather/snow/corner{
	dir = 10
	},
/turf/open/floor/iron/icemoon,
/area/icemoon/surface/outdoors)
"dB" = (
/obj/effect/turf_decal/trimline/neutral/filled/line,
/obj/effect/turf_decal/weather/snow/corner,
/turf/open/floor/iron/icemoon,
/area/icemoon/surface/outdoors)
"dC" = (
/obj/machinery/atmospherics/components/unary/vent_pump/on{
	dir = 8;
	icon_state = "vent_map_on-2"
	},
/obj/effect/turf_decal/trimline/neutral/filled/line,
/obj/effect/turf_decal/weather/snow/corner,
/turf/open/floor/iron/icemoon,
/area/icemoon/surface/outdoors)
"dD" = (
/obj/structure/girder,
/turf/open/floor/iron/icemoon,
/area/icemoon/surface/outdoors)
"dE" = (
/obj/structure/door_assembly/door_assembly_eng,
/turf/open/floor/iron/icemoon,
/area/icemoon/surface/outdoors)
"na" = (
/obj/effect/spawner/structure/window/reinforced/plasma,
/obj/machinery/atmospherics/pipe/smart/manifold4w/dark/visible,
/turf/open/floor/engine/airless,
/area/icemoon/surface/outdoors)
"tH" = (
/obj/machinery/atmospherics/pipe/smart/manifold4w/brown,
/obj/effect/spawner/structure/window/reinforced/plasma,
/turf/open/floor/engine/airless,
/area/icemoon/surface/outdoors)
"xA" = (
/obj/effect/spawner/structure/window/reinforced/plasma,
/obj/machinery/atmospherics/pipe/smart/manifold4w/brown,
/turf/open/floor/engine/airless,
/area/icemoon/surface/outdoors)
"UK" = (
/obj/machinery/atmospherics/pipe/smart/manifold4w/dark/visible,
/turf/open/floor/engine/vacuum,
/area/icemoon/surface/outdoors)

(1,1,1) = {"
aa
aa
aa
aa
aa
aa
aa
aa
aa
aa
aa
aa
aa
aa
aa
aa
aa
aa
aa
"}
(2,1,1) = {"
aa
aa
ak
an
ak
ae
an
ab
aa
by
bR
bR
ae
ae
ae
ae
ae
aO
aa
"}
(3,1,1) = {"
aa
aa
aa
ao
ab
al
al
ab
ab
ab
ab
ab
ab
al
al
al
do
ae
aa
"}
(4,1,1) = {"
aa
aa
aa
aa
aa
ao
al
al
al
al
al
al
al
al
al
al
ag
ak
aa
"}
(5,1,1) = {"
aa
aa
aa
aa
aa
aa
aH
aH
bc
bc
bS
bc
bc
cC
cT
ag
ag
aO
aa
"}
(6,1,1) = {"
aa
aa
aa
aa
aa
aa
aa
aa
aa
aa
aa
af
al
cD
ag
al
al
aO
aa
"}
(7,1,1) = {"
aa
aa
aa
aa
aa
aa
aa
aa
bd
aa
aa
aa
af
cE
ag
ag
al
ae
aa
"}
(8,1,1) = {"
ab
ab
aa
aa
aa
aa
aI
aa
be
aa
aa
aa
af
af
ag
ag
al
ak
aa
"}
(9,1,1) = {"
ac
ab
al
ap
aa
aa
aa
aa
bf
bz
aa
aa
af
af
ag
ag
dp
ae
aa
"}
(10,1,1) = {"
ab
ab
ag
ap
al
aa
aa
aa
aa
aa
bT
aa
af
ab
ag
al
dq
ak
aa
"}
(11,1,1) = {"
ad
ag
ag
aq
ab
aa
aa
aa
aa
bA
aa
aa
af
cE
ag
ag
al
ak
aa
"}
(12,1,1) = {"
ab
ab
ag
ap
al
ab
aJ
aa
aa
aa
aa
ab
ab
cF
cU
al
al
aO
aa
"}
(13,1,1) = {"
ab
ab
am
ar
at
at
at
at
at
bB
bB
bB
at
cG
cT
ag
dr
ae
aa
"}
(14,1,1) = {"
ab
ah
al
as
au
as
as
as
ag
al
al
cg
ag
al
al
al
al
ae
aa
"}
(15,1,1) = {"
ab
ai
al
al
al
al
al
al
ag
bC
al
al
ag
al
al
al
ds
ae
aa
"}
(16,1,1) = {"
ae
ae
ae
ae
ae
ae
ae
aO
bi
ae
ae
ae
ae
ae
ae
ae
ae
ae
aa
"}
(17,1,1) = {"
aa
aa
aa
aa
aa
aa
ae
aP
bj
bD
ae
aa
aa
aa
aa
aa
aa
aa
aa
"}
(18,1,1) = {"
aa
aa
aa
aa
aa
aa
ae
aj
bk
aj
ae
aa
aa
aa
aa
aa
aa
aa
aa
"}
(19,1,1) = {"
af
aa
aa
aa
an
aB
ae
aQ
bl
aQ
ae
aB
aB
aB
aB
aB
aB
aa
aa
"}
(20,1,1) = {"
af
af
aj
aa
aa
af
aK
aR
bm
bE
bU
ch
ct
cH
cK
de
aB
aa
aa
"}
(21,1,1) = {"
af
aj
aj
af
af
aj
aj
aj
aT
aj
bV
ci
aB
cI
aj
df
aB
aa
aa
"}
(22,1,1) = {"
aa
aa
af
aj
aj
aj
aj
aj
aT
aj
bW
aj
aQ
cJ
aj
dg
aB
aa
aa
"}
(23,1,1) = {"
ab
aa
af
aj
av
aj
aj
aj
aw
aj
ck
cj
aB
aB
aQ
aB
aB
ab
aa
"}
(24,1,1) = {"
aa
af
aj
ag
aw
aw
aw
aT
bo
aj
ck
aj
aj
cK
cV
aB
dj
ak
ak
"}
(25,1,1) = {"
aa
af
aj
aj
aj
aj
aj
aj
bF
aj
ck
ck
ck
ck
cW
dh
dt
dA
ak
"}
(26,1,1) = {"
aa
af
af
an
an
aj
aj
aj
bq
bF
bY
bF
bF
cL
cX
di
du
dB
dD
"}
(27,1,1) = {"
aa
aa
aa
aa
an
aC
aL
aC
br
bG
bZ
cl
aC
cM
cY
aB
dv
dC
dE
"}
(28,1,1) = {"
aa
aa
aa
aa
an
an
aB
ae
bs
bH
ae
aB
cu
cu
aB
dj
ak
ak
dj
"}
(29,1,1) = {"
aa
aa
aa
aa
aa
aa
aa
ae
aT
bI
ae
aa
aa
aa
aa
aa
aa
aa
ak
"}
(30,1,1) = {"
aa
aa
aa
aa
aa
aa
aa
ae
aw
ck
ae
aa
aa
aa
aa
aa
aa
aa
ak
"}
(31,1,1) = {"
aa
aa
aa
aa
aa
aa
aa
ae
aw
ck
ae
ae
ae
ae
ae
aa
aa
aa
aa
"}
(32,1,1) = {"
aa
aa
aa
ae
ae
ae
ae
ae
aw
bL
ca
cm
cv
cN
ae
ae
ae
ae
aa
"}
(33,1,1) = {"
aa
aa
aa
ae
ax
aD
aM
aV
aw
bM
ca
cn
cn
cO
cZ
dk
dw
ae
aa
"}
(34,1,1) = {"
aa
aa
aa
ae
ay
aE
xA
aW
bv
aj
aj
aj
cx
cP
tH
dl
dx
ae
aa
"}
(35,1,1) = {"
aa
aa
aa
ae
ae
ae
ae
aX
aw
aj
cb
cp
cx
cQ
ae
ae
ae
ae
aa
"}
(36,1,1) = {"
aa
aa
aa
ae
az
aF
aM
aV
aw
aj
cc
cx
cx
cO
db
dn
dy
ae
aa
"}
(37,1,1) = {"
aa
aa
aa
ae
aA
aG
tH
aW
bv
aj
cd
aj
cx
cR
na
UK
dz
ae
aa
"}
(38,1,1) = {"
aa
aa
aa
ae
ae
ae
ae
ba
aw
aj
ce
aj
cx
cS
ae
ae
ae
ae
aa
"}
(39,1,1) = {"
aa
aa
aa
aa
aa
aa
ae
cx
bx
bQ
cf
cs
cx
aj
ae
aa
aa
aa
aa
"}
(40,1,1) = {"
aa
aa
aa
aa
aa
aa
ae
ae
ae
ae
ae
ae
ae
ae
ae
aa
aa
aa
aa
"}
