//MAP CONVERTED BY dmm2tgm.py THIS HEADER COMMENT PREVENTS RECONVERSION, DO NOT REMOVE
"a" = (
/turf/closed/mineral/random/snow,
/area/icemoon/surface/outdoors)
"b" = (
/turf/closed/wall/mineral/wood/nonmetal,
/area/ruin/unpowered)
"c" = (
/obj/structure/closet/toolcloset,
/obj/item/wrench,
/obj/item/screwdriver,
/obj/item/crowbar,
/obj/item/weldingtool/largetank,
/obj/item/wirecutters,
/obj/item/radio/off,
/turf/open/floor/wood,
/area/ruin/unpowered)
"d" = (
/turf/open/openspace/icemoon,
/area/icemoon/surface/outdoors)
"e" = (
/obj/item/clothing/suit/hooded/explorer,
/obj/item/clothing/mask/gas/explorer,
/obj/item/clothing/gloves/color/black,
/obj/item/storage/backpack/explorer,
/obj/item/flashlight/lantern,
/obj/item/storage/bag/ore,
/obj/structure/closet,
/obj/item/clothing/shoes/winterboots/ice_boots,
/turf/open/floor/wood,
/area/ruin/unpowered)
"f" = (
/turf/open/floor/wood,
/area/ruin/unpowered)
"g" = (
/obj/structure/fireplace,
/turf/open/floor/wood,
/area/ruin/unpowered)
"h" = (
/obj/structure/flora/rock/icy,
/turf/closed/mineral/random/snow,
/area/icemoon/surface/outdoors)
"i" = (
/turf/template_noop,
/area/template_noop)
"j" = (
/obj/structure/sink/kitchen,
/turf/open/floor/wood,
/area/ruin/unpowered)
"k" = (
/obj/structure/closet/crate/freezer,
/turf/open/floor/wood,
/area/ruin/unpowered)
"l" = (
/obj/machinery/vending/dinnerware,
/turf/open/floor/wood,
/area/ruin/unpowered)
"n" = (
/obj/structure/mineral_door/wood,
/turf/open/floor/wood,
/area/ruin/unpowered)
"o" = (
/obj/item/reagent_containers/food/drinks/beer,
/turf/open/floor/wood,
/area/ruin/unpowered)
"p" = (
/obj/machinery/light/broken{
	dir = 4
	},
/turf/open/floor/wood,
/area/ruin/unpowered)
"q" = (
/obj/structure/table/wood,
/obj/item/pen,
/obj/machinery/light/broken{
	dir = 8
	},
/obj/item/paper/crumpled/bloody{
	info = "help...";
	text = ""
	},
/turf/open/floor/wood,
/area/ruin/unpowered)
"r" = (
/obj/item/chair/wood,
/obj/effect/decal/cleanable/blood/splatter,
/obj/effect/mob_spawn/human/miner/explorer,
/obj/effect/decal/cleanable/blood/drip,
/turf/open/floor/wood,
/area/ruin/unpowered)
"s" = (
/obj/effect/decal/cleanable/trail_holder,
/turf/open/floor/wood,
/area/ruin/unpowered)
"u" = (
/obj/structure/ladder{
	travel_time = 40
	},
/turf/open/floor/wood,
/area/ruin/unpowered)
"G" = (
/turf/open/openspace/icemoon/ruins,
/area/icemoon/surface/outdoors)
"Q" = (
/turf/open/openspace/icemoon,
/area/template_noop)

(1,1,1) = {"
i
i
i
i
i
i
i
i
i
i
i
i
i
i
i
i
i
i
i
i
i
i
i
i
i
"}
(2,1,1) = {"
i
i
i
i
i
i
i
G
G
G
G
G
G
G
G
G
G
G
i
i
i
i
i
i
i
"}
(3,1,1) = {"
i
i
i
i
i
G
G
G
G
G
G
G
G
G
G
G
G
G
G
i
i
i
i
i
i
"}
(4,1,1) = {"
i
i
i
d
G
G
G
G
G
G
G
G
G
G
G
G
G
G
G
G
i
i
i
i
i
"}
(5,1,1) = {"
i
i
i
G
G
G
G
G
G
G
G
G
G
G
G
G
G
G
G
G
G
i
i
i
i
"}
(6,1,1) = {"
i
i
G
G
G
G
G
G
G
G
G
G
G
G
G
G
G
G
G
G
G
G
i
i
i
"}
(7,1,1) = {"
i
i
G
G
G
G
G
G
G
G
G
G
G
G
G
G
G
G
G
G
G
G
G
i
i
"}
(8,1,1) = {"
i
G
G
G
G
G
G
G
G
G
G
G
G
G
G
G
G
G
G
G
G
G
G
i
i
"}
(9,1,1) = {"
i
G
G
G
G
G
G
G
G
b
b
b
b
b
b
b
G
G
G
G
G
G
G
G
i
"}
(10,1,1) = {"
i
G
G
G
G
G
G
G
b
b
b
b
b
b
b
b
b
G
G
G
G
G
G
G
i
"}
(11,1,1) = {"
i
G
G
G
G
G
G
G
b
b
c
f
f
o
q
b
b
G
G
G
G
G
G
G
i
"}
(12,1,1) = {"
i
G
G
G
G
G
G
G
b
b
e
f
f
f
r
b
b
G
G
G
G
G
G
G
i
"}
(13,1,1) = {"
i
G
G
G
G
G
G
G
b
b
f
f
f
f
s
b
b
G
G
G
G
G
G
G
i
"}
(14,1,1) = {"
i
G
G
G
G
G
G
G
b
b
g
f
f
f
s
b
b
G
G
G
G
G
G
G
i
"}
(15,1,1) = {"
i
G
G
G
G
G
G
G
b
b
f
f
f
f
s
b
b
G
G
G
G
G
G
G
i
"}
(16,1,1) = {"
i
G
G
G
G
G
G
G
b
b
j
f
f
f
s
b
b
G
G
G
G
G
G
G
i
"}
(17,1,1) = {"
i
G
G
G
G
G
G
G
b
b
k
f
f
f
s
b
b
G
G
G
G
G
G
G
i
"}
(18,1,1) = {"
i
G
G
G
G
G
G
G
b
b
l
f
f
f
u
b
b
G
G
G
G
G
G
G
i
"}
(19,1,1) = {"
i
G
G
G
G
G
G
G
b
b
b
f
f
p
b
b
b
G
G
G
G
G
G
G
i
"}
(20,1,1) = {"
i
G
G
G
G
G
G
G
G
b
b
b
f
b
b
b
G
G
G
G
G
G
G
G
i
"}
(21,1,1) = {"
i
G
G
G
G
G
G
G
G
G
G
b
f
b
G
G
G
G
G
G
G
G
G
G
i
"}
(22,1,1) = {"
i
G
G
G
G
G
G
G
G
G
G
b
f
b
G
G
G
G
G
G
G
G
G
G
i
"}
(23,1,1) = {"
i
G
G
G
G
G
G
G
G
G
G
b
f
b
G
G
G
G
G
G
G
G
G
i
i
"}
(24,1,1) = {"
i
i
G
G
G
G
G
G
G
G
G
b
n
b
G
G
G
G
G
G
G
G
d
i
i
"}
(25,1,1) = {"
i
i
i
G
G
G
G
G
G
G
a
h
h
h
a
G
G
G
G
G
G
d
i
i
i
"}
(26,1,1) = {"
i
i
i
d
G
G
G
G
G
a
a
a
h
a
a
a
G
G
G
G
d
d
i
i
i
"}
(27,1,1) = {"
i
i
i
i
d
G
G
G
a
a
a
a
a
a
a
a
a
G
G
d
d
i
i
i
i
"}
(28,1,1) = {"
i
i
i
i
i
d
d
a
a
a
a
a
a
a
a
a
a
a
d
Q
i
i
i
i
i
"}
(29,1,1) = {"
i
i
i
i
i
i
i
a
a
a
a
a
a
a
a
a
a
a
i
i
i
i
i
i
i
"}
