//MAP CONVERTED BY dmm2tgm.py THIS HEADER COMMENT PREVENTS RECONVERSION, DO NOT REMOVE
"a" = (
/turf/open/floor/plating/ice/icemoon,
/area/icemoon/underground/explored)
"b" = (
/obj/structure/ladder{
	travel_time = 40
	},
/turf/open/floor/plating/ice/icemoon,
/area/icemoon/underground/explored)
"d" = (
/turf/template_noop,
/area/icemoon/underground/unexplored)
"f" = (
/obj/item/flashlight/lantern{
	on = 1
	},
/turf/open/floor/plating/ice/icemoon,
/area/icemoon/underground/explored)
"g" = (
/obj/item/clothing/suit/hooded/explorer,
/obj/effect/decal/cleanable/blood/gibs/up,
/turf/open/floor/plating/ice/icemoon,
/area/icemoon/underground/explored)
"h" = (
/obj/item/clothing/shoes/winterboots/ice_boots,
/turf/open/floor/plating/ice/icemoon,
/area/icemoon/underground/explored)
"i" = (
/obj/item/kitchen/knife/combat/survival,
/turf/open/floor/plating/ice/icemoon,
/area/icemoon/underground/explored)
"l" = (
/turf/closed/indestructible/rock/snow/ice/ore,
/area/icemoon/underground/explored)
"T" = (
/mob/living/simple_animal/hostile/megafauna/demonic_frost_miner,
/turf/open/floor/plating/ice/icemoon,
/area/icemoon/underground/explored)

(1,1,1) = {"
d
d
d
d
d
d
d
d
d
d
d
d
d
d
d
d
d
d
d
d
d
d
d
d
d
d
d
"}
(2,1,1) = {"
d
d
d
d
d
d
d
l
l
l
l
l
l
l
l
l
l
l
l
l
d
d
d
d
d
d
d
"}
(3,1,1) = {"
d
d
d
d
d
l
l
l
a
a
a
a
a
a
a
a
a
a
a
l
l
d
d
d
d
d
d
"}
(4,1,1) = {"
d
d
d
d
l
l
a
a
a
a
a
a
a
a
a
a
a
a
a
a
l
l
d
d
d
d
d
"}
(5,1,1) = {"
d
d
d
l
l
a
a
a
a
a
a
a
a
a
a
a
a
a
a
a
a
l
l
d
d
d
d
"}
(6,1,1) = {"
d
d
l
l
a
a
a
a
a
a
a
a
a
a
a
a
a
a
a
a
a
a
l
l
d
d
d
"}
(7,1,1) = {"
d
d
l
a
a
a
a
a
a
a
a
a
a
a
a
a
a
a
a
a
a
a
a
l
l
d
d
"}
(8,1,1) = {"
d
l
l
a
a
a
a
a
a
a
a
a
a
a
a
a
a
a
a
a
a
a
a
a
l
d
d
"}
(9,1,1) = {"
d
l
a
a
a
a
a
a
a
a
a
a
a
a
a
a
a
a
a
a
a
a
a
a
l
l
d
"}
(10,1,1) = {"
d
l
a
a
a
a
a
a
a
a
a
a
a
a
a
a
a
a
a
a
a
a
a
a
a
l
d
"}
(11,1,1) = {"
d
l
a
a
a
a
a
a
a
a
a
a
a
a
a
a
a
a
a
a
a
a
a
a
a
l
d
"}
(12,1,1) = {"
d
l
a
a
a
a
a
a
a
a
a
a
a
a
a
a
a
a
a
a
a
a
a
a
a
l
d
"}
(13,1,1) = {"
d
l
a
a
a
a
a
a
a
a
a
a
a
a
a
a
a
a
a
a
a
a
a
a
a
l
d
"}
(14,1,1) = {"
d
l
a
a
a
a
a
a
a
a
a
a
a
a
a
a
a
a
a
a
a
a
a
a
a
l
d
"}
(15,1,1) = {"
d
l
a
a
a
a
a
a
a
a
a
a
a
T
a
a
a
a
a
a
a
a
a
a
a
l
d
"}
(16,1,1) = {"
d
l
a
a
a
a
a
a
a
a
a
a
a
a
a
a
a
a
a
a
a
a
a
a
a
l
d
"}
(17,1,1) = {"
d
l
a
a
a
a
a
a
a
a
a
a
a
a
a
a
a
a
a
a
a
a
a
a
a
l
d
"}
(18,1,1) = {"
d
l
a
a
a
a
a
a
a
a
a
a
a
a
a
a
a
a
a
a
a
a
a
a
a
l
d
"}
(19,1,1) = {"
d
l
a
a
a
a
a
a
a
a
a
a
a
a
a
b
a
a
a
a
a
a
a
a
a
l
d
"}
(20,1,1) = {"
d
l
a
a
a
a
a
a
a
a
a
a
a
a
a
a
a
a
a
a
a
a
a
a
a
l
d
"}
(21,1,1) = {"
d
l
a
a
a
a
a
a
a
a
a
a
a
a
a
a
a
a
a
a
a
a
a
a
a
l
d
"}
(22,1,1) = {"
d
l
a
a
a
a
a
a
a
a
a
a
a
a
a
a
a
a
a
a
a
a
a
a
a
l
d
"}
(23,1,1) = {"
d
l
a
a
a
a
a
a
a
a
a
a
a
a
a
a
a
a
a
a
a
a
a
a
a
l
d
"}
(24,1,1) = {"
d
l
a
a
a
a
a
a
a
a
a
a
a
a
a
a
a
a
a
a
a
a
a
a
l
l
d
"}
(25,1,1) = {"
d
l
l
a
a
a
a
f
i
a
a
a
a
a
a
a
a
a
a
a
a
a
a
l
l
d
d
"}
(26,1,1) = {"
d
d
l
l
a
a
a
a
g
a
a
a
a
a
a
a
a
a
a
a
a
a
l
l
d
d
d
"}
(27,1,1) = {"
d
d
d
l
l
a
a
a
h
a
a
a
a
a
a
a
a
a
a
a
a
l
l
d
d
d
d
"}
(28,1,1) = {"
d
d
d
d
l
l
a
a
a
a
a
a
a
a
a
a
a
a
a
a
l
l
d
d
d
d
d
"}
(29,1,1) = {"
d
d
d
d
d
l
l
l
a
a
a
a
a
a
a
a
a
a
a
l
l
d
d
d
d
d
d
"}
(30,1,1) = {"
d
d
d
d
d
d
d
l
l
l
l
l
l
l
l
l
l
l
l
l
d
d
d
d
d
d
d
"}
(31,1,1) = {"
d
d
d
d
d
d
d
d
d
d
d
d
d
d
d
d
d
d
d
d
d
d
d
d
d
d
d
"}
