//MAP CONVERTED BY dmm2tgm.py THIS HEADER COMMENT PREVENTS RECONVERSION, DO NOT REMOVE
"a" = (
/turf/closed/mineral/random/more_caves,
/area/icemoon/surface/outdoors/unexplored)
"b" = (
/turf/closed/mineral/random/snow/no_caves,
/area/icemoon/surface/outdoors)
"c" = (
/turf/closed/wall/mineral/bronze,
/area/icemoon/surface/outdoors)
"d" = (
/obj/structure/fluff/clockwork/fallen_armor,
/turf/open/floor/bronze,
/area/icemoon/surface/outdoors)
"i" = (
/turf/open/floor/bronze,
/area/icemoon/surface/outdoors)
"k" = (
/obj/structure/fluff/clockwork/alloy_shards,
/turf/open/floor/bronze,
/area/icemoon/surface/outdoors)
"m" = (
/turf/closed/wall/mineral/bronze,
/area/icemoon/surface/outdoors/unexplored)
"n" = (
/obj/effect/mob_spawn/human/skeleton,
/turf/open/floor/bronze,
/area/icemoon/surface/outdoors)
"p" = (
/obj/structure/fluff/clockwork/alloy_shards/large,
/turf/open/floor/bronze,
/area/icemoon/surface/outdoors)
"r" = (
/obj/structure/fluff/clockwork/blind_eye,
/turf/open/floor/bronze,
/area/icemoon/surface/outdoors)
"u" = (
/obj/structure/table/bronze,
/turf/open/floor/bronze,
/area/icemoon/surface/outdoors)
"v" = (
/obj/structure/fluff/clockwork/alloy_shards/medium_gearbit,
/turf/open/floor/bronze,
/area/icemoon/surface/outdoors)
"x" = (
/obj/effect/mob_spawn/human/skeleton,
/obj/item/clothing/suit/bronze,
/obj/item/clothing/shoes/bronze,
/obj/item/clothing/head/bronze,
/turf/open/floor/bronze,
/area/icemoon/surface/outdoors)
"z" = (
/obj/structure/table/bronze,
/obj/item/toy/clockwork_watch{
	desc = "You can still feel the embers of a once great empire in your hand...";
	name = "drained clockwork slab"
	},
/turf/open/floor/bronze,
/area/icemoon/surface/outdoors)
"H" = (
/obj/machinery/door/airlock/bronze/seethru,
/obj/structure/fans/tiny,
/turf/open/floor/bronze,
/area/icemoon/surface/outdoors)
"P" = (
/obj/structure/fluff/clockwork/clockgolem_remains,
/turf/open/floor/bronze,
/area/icemoon/surface/outdoors)
"Q" = (
/obj/item/paper{
	info = "We tried to use the power of this moon to bring him back, but we've failed... I've contained what remains of his power here... if you find this, make sure those Nar-Sian Dogs don't last a second."
	},
/obj/item/pen,
/turf/open/floor/bronze,
/area/icemoon/surface/outdoors)
"R" = (
/obj/item/nullrod/spear{
	name = "empowered bronze spear"
	},
/turf/open/floor/bronze,
/area/icemoon/surface/outdoors)
"U" = (
/obj/machinery/door/airlock/bronze,
/obj/structure/fans/tiny,
/turf/open/floor/bronze,
/area/icemoon/surface/outdoors)
"V" = (
/obj/structure/fluff/clockwork/alloy_shards/medium,
/turf/open/floor/bronze,
/area/icemoon/surface/outdoors)

(1,1,1) = {"
b
b
b
b
b
b
b
b
b
b
b
b
b
b
b
b
b
b
b
b
b
b
b
b
b
b
b
b
b
b
b
b
b
b
b
b
b
b
b
b
"}
(2,1,1) = {"
b
c
c
c
c
c
c
c
c
c
c
c
c
c
c
c
c
c
c
U
U
c
c
c
c
c
c
c
c
c
c
c
c
c
c
c
c
c
c
b
"}
(3,1,1) = {"
b
c
c
m
a
a
a
a
a
a
a
a
a
a
a
a
c
u
v
i
P
i
u
c
a
a
a
a
a
a
a
a
a
a
a
a
m
c
c
b
"}
(4,1,1) = {"
b
c
m
a
a
a
a
a
a
a
a
a
a
a
a
a
c
r
i
n
i
i
r
c
a
a
a
a
a
a
a
a
a
a
a
a
a
m
c
b
"}
(5,1,1) = {"
b
c
a
a
a
a
a
a
a
a
a
a
a
a
a
a
c
c
c
H
H
c
c
c
a
a
a
a
a
a
a
a
a
a
a
a
a
a
c
b
"}
(6,1,1) = {"
b
c
a
a
a
a
a
a
a
a
a
a
a
a
a
a
a
a
a
a
a
a
a
a
a
a
a
a
a
a
a
a
a
a
a
a
a
a
c
b
"}
(7,1,1) = {"
b
c
a
a
a
a
a
a
a
a
a
a
a
a
a
a
a
a
a
a
a
a
a
a
a
a
a
a
a
a
a
a
a
a
a
a
a
a
c
b
"}
(8,1,1) = {"
b
c
a
a
a
a
a
a
a
a
a
a
a
a
a
a
a
a
a
a
a
a
a
a
a
a
a
a
a
a
a
a
a
a
a
a
a
a
c
b
"}
(9,1,1) = {"
b
c
a
a
a
a
a
a
a
a
a
a
a
a
a
a
a
a
a
a
a
a
a
a
a
a
a
a
a
a
a
a
a
a
a
a
a
a
c
b
"}
(10,1,1) = {"
b
c
a
a
a
a
a
a
a
a
a
a
a
a
a
a
a
a
a
a
a
a
a
a
a
a
a
a
a
a
a
a
a
a
a
a
a
a
c
b
"}
(11,1,1) = {"
b
c
a
a
a
a
a
a
a
a
a
a
a
a
a
a
a
a
a
a
a
a
a
a
a
a
a
a
a
a
a
a
a
a
a
a
a
a
c
b
"}
(12,1,1) = {"
b
c
a
a
a
a
a
a
a
a
a
a
a
a
a
a
a
a
a
a
a
a
a
a
a
a
a
a
a
a
a
a
a
a
a
a
a
a
c
b
"}
(13,1,1) = {"
b
c
a
a
a
a
a
a
a
a
a
a
a
a
a
a
a
a
a
a
a
a
a
a
a
a
a
a
a
a
a
a
a
a
a
a
a
a
c
b
"}
(14,1,1) = {"
b
c
a
a
a
a
a
a
a
a
a
a
a
a
a
a
a
a
a
a
a
a
a
a
a
a
a
a
a
a
a
a
a
a
a
a
a
a
c
b
"}
(15,1,1) = {"
b
c
a
a
a
a
a
a
a
a
a
a
a
a
a
a
a
a
a
a
a
a
a
a
a
a
a
a
a
a
a
a
a
a
a
a
a
a
c
b
"}
(16,1,1) = {"
b
c
a
a
a
a
a
a
a
a
a
a
a
a
a
a
a
a
a
a
a
a
a
a
a
a
a
a
a
a
a
a
a
a
a
a
a
a
c
b
"}
(17,1,1) = {"
b
c
c
c
c
a
a
a
a
a
a
a
a
a
a
a
a
a
a
a
a
a
a
a
a
a
a
a
a
a
a
a
a
a
a
c
c
c
c
b
"}
(18,1,1) = {"
b
c
u
r
c
a
a
a
a
a
a
a
a
a
a
a
a
a
a
a
a
a
a
a
a
a
a
a
a
a
a
a
a
a
a
c
r
z
c
b
"}
(19,1,1) = {"
b
c
i
i
c
a
a
a
a
a
a
a
a
a
a
a
a
a
c
i
i
c
a
a
a
a
a
a
a
a
a
a
a
a
a
c
i
p
c
b
"}
(20,1,1) = {"
b
U
k
n
H
a
a
a
a
a
a
a
a
a
a
a
a
a
i
x
i
i
a
a
a
a
a
a
a
a
a
a
a
a
a
H
n
i
U
b
"}
(21,1,1) = {"
b
U
i
P
H
a
a
a
a
a
a
a
a
a
a
a
a
a
i
R
Q
i
a
a
a
a
a
a
a
a
a
a
a
a
a
H
v
d
U
b
"}
(22,1,1) = {"
b
c
i
i
c
a
a
a
a
a
a
a
a
a
a
a
a
a
c
i
i
c
a
a
a
a
a
a
a
a
a
a
a
a
a
c
i
i
c
b
"}
(23,1,1) = {"
b
c
u
r
c
a
a
a
a
a
a
a
a
a
a
a
a
a
a
a
a
a
a
a
a
a
a
a
a
a
a
a
a
a
a
c
r
u
c
b
"}
(24,1,1) = {"
b
c
c
c
c
a
a
a
a
a
a
a
a
a
a
a
a
a
a
a
a
a
a
a
a
a
a
a
a
a
a
a
a
a
a
c
c
c
c
b
"}
(25,1,1) = {"
b
c
a
a
a
a
a
a
a
a
a
a
a
a
a
a
a
a
a
a
a
a
a
a
a
a
a
a
a
a
a
a
a
a
a
a
a
a
c
b
"}
(26,1,1) = {"
b
c
a
a
a
a
a
a
a
a
a
a
a
a
a
a
a
a
a
a
a
a
a
a
a
a
a
a
a
a
a
a
a
a
a
a
a
a
c
b
"}
(27,1,1) = {"
b
c
a
a
a
a
a
a
a
a
a
a
a
a
a
a
a
a
a
a
a
a
a
a
a
a
a
a
a
a
a
a
a
a
a
a
a
a
c
b
"}
(28,1,1) = {"
b
c
a
a
a
a
a
a
a
a
a
a
a
a
a
a
a
a
a
a
a
a
a
a
a
a
a
a
a
a
a
a
a
a
a
a
a
a
c
b
"}
(29,1,1) = {"
b
c
a
a
a
a
a
a
a
a
a
a
a
a
a
a
a
a
a
a
a
a
a
a
a
a
a
a
a
a
a
a
a
a
a
a
a
a
c
b
"}
(30,1,1) = {"
b
c
a
a
a
a
a
a
a
a
a
a
a
a
a
a
a
a
a
a
a
a
a
a
a
a
a
a
a
a
a
a
a
a
a
a
a
a
c
b
"}
(31,1,1) = {"
b
c
a
a
a
a
a
a
a
a
a
a
a
a
a
a
a
a
a
a
a
a
a
a
a
a
a
a
a
a
a
a
a
a
a
a
a
a
c
b
"}
(32,1,1) = {"
b
c
a
a
a
a
a
a
a
a
a
a
a
a
a
a
a
a
a
a
a
a
a
a
a
a
a
a
a
a
a
a
a
a
a
a
a
a
c
b
"}
(33,1,1) = {"
b
c
a
a
a
a
a
a
a
a
a
a
a
a
a
a
a
a
a
a
a
a
a
a
a
a
a
a
a
a
a
a
a
a
a
a
a
a
c
b
"}
(34,1,1) = {"
b
c
a
a
a
a
a
a
a
a
a
a
a
a
a
a
a
a
a
a
a
a
a
a
a
a
a
a
a
a
a
a
a
a
a
a
a
a
c
b
"}
(35,1,1) = {"
b
c
a
a
a
a
a
a
a
a
a
a
a
a
a
a
a
a
a
a
a
a
a
a
a
a
a
a
a
a
a
a
a
a
a
a
a
a
c
b
"}
(36,1,1) = {"
b
c
a
a
a
a
a
a
a
a
a
a
a
a
a
a
c
c
c
H
H
c
c
c
a
a
a
a
a
a
a
a
a
a
a
a
a
a
c
b
"}
(37,1,1) = {"
b
c
m
a
a
a
a
a
a
a
a
a
a
a
a
a
c
r
i
n
V
i
r
c
a
a
a
a
a
a
a
a
a
a
a
a
a
m
c
b
"}
(38,1,1) = {"
b
c
c
m
a
a
a
a
a
a
a
a
a
a
a
a
c
u
i
P
i
i
u
c
a
a
a
a
a
a
a
a
a
a
a
a
m
c
c
b
"}
(39,1,1) = {"
b
c
c
c
c
c
c
c
c
c
c
c
c
c
c
c
c
c
c
U
U
c
c
c
c
c
c
c
c
c
c
c
c
c
c
c
c
c
c
b
"}
(40,1,1) = {"
b
b
b
b
b
b
b
b
b
b
b
b
b
b
b
b
b
b
b
b
b
b
b
b
b
b
b
b
b
b
b
b
b
b
b
b
b
b
b
b
"}
