//MAP CONVERTED BY dmm2tgm.py THIS HEADER COMMENT PREVENTS RECONVERSION, DO NOT REMOVE
"ai" = (
/obj/effect/decal/cleanable/wrapping,
/obj/item/c_tube,
/obj/effect/turf_decal/siding/yellow,
/turf/open/floor/iron/smooth_large,
/area/tdome)
"bw" = (
/obj/effect/turf_decal/siding/yellow,
/obj/structure/railing{
	dir = 4
	},
/obj/machinery/vending/coffee,
/turf/open/floor/iron/smooth_large,
/area/tdome)
"bx" = (
/obj/structure/closet/crate/mail{
	icon_state = "mailopen"
	},
/obj/effect/turf_decal/siding/yellow,
/turf/open/floor/iron/smooth_large,
/area/tdome)
"bE" = (
/obj/item/food/strawberryicecreamsandwich,
/turf/open/floor/iron/smooth_corner{
	dir = 1
	},
/area/tdome)
"dC" = (
/obj/structure/fence/door,
/turf/open/floor/plating/grass,
/area/tdome)
"dX" = (
/obj/effect/decal/cleanable/oil,
/obj/machinery/door/keycard/eventone,
/turf/open/floor/iron/white,
/area/tdome)
"fA" = (
/obj/structure/holobox,
/obj/effect/turf_decal/stripes/white/box,
/turf/open/floor/plating,
/area/tdome)
"gS" = (
/obj/structure/holobox,
/obj/effect/turf_decal/stripes{
	dir = 8
	},
/turf/open/floor/plating,
/area/tdome)
"hU" = (
/obj/structure/flora/tree/pine,
/turf/open/floor/plating/grass,
/area/tdome)
"jK" = (
/obj/machinery/modular_computer/console/preset/civilian{
	dir = 8
	},
/turf/open/floor/carpet/green,
/area/tdome)
"kw" = (
/obj/structure/closet/crate/bin,
/obj/item/mail/junkmail,
/obj/item/mail/junkmail,
/obj/item/mail/junkmail,
/obj/item/mail/junkmail,
/obj/item/mail/junkmail,
/obj/item/mail/junkmail,
/obj/item/mail/junkmail,
/obj/item/mail/junkmail,
/obj/item/mail/junkmail,
/obj/item/mail/junkmail,
/turf/open/floor/iron/smooth_large,
/area/tdome)
"lg" = (
/obj/machinery/modular_computer/console/preset/civilian{
	dir = 4
	},
/turf/open/floor/carpet/green,
/area/tdome)
"lk" = (
/obj/structure/chair/office/light{
	dir = 4
	},
/obj/effect/mob_spawn/human/skeleton,
/obj/effect/decal/cleanable/blood/old,
/turf/open/floor/carpet/royalblack,
/area/tdome)
"mG" = (
/obj/effect/turf_decal/stripes{
	dir = 8
	},
/turf/open/floor/plating,
/area/tdome)
"mY" = (
/turf/open/floor/plating,
/area/tdome)
"nk" = (
/obj/structure/chair/plastic{
	dir = 4
	},
/obj/effect/decal/remains/human,
/turf/open/floor/iron/white,
/area/tdome)
"nn" = (
/obj/structure/window/reinforced{
	dir = 4
	},
/obj/machinery/light/cold/directional/north,
/turf/open/floor/iron/textured,
/area/tdome)
"nz" = (
/turf/open/floor/iron/smooth_corner{
	dir = 4
	},
/area/tdome)
"og" = (
/obj/structure/sign/warning/securearea,
/turf/closed/indestructible/reinforced,
/area/tdome)
"oq" = (
/obj/effect/turf_decal/stripes{
	dir = 8
	},
/turf/open/floor/plating{
	icon_state = "panelscorched"
	},
/area/tdome)
"ox" = (
/obj/effect/turf_decal/trimline/brown/arrow_ccw{
	dir = 4
	},
/obj/item/pressure_plate/hologrid{
	reward = /obj/item/keycard/eventone
	},
/turf/open/floor/plating,
/area/tdome)
"oO" = (
/obj/machinery/ticket_machine/directional/north,
/turf/open/floor/iron/white,
/area/tdome)
"oU" = (
/obj/structure/sign/poster/official/obey,
/turf/closed/wall/r_wall,
/area/tdome)
"pf" = (
/turf/open/space/basic,
/area/space)
"pC" = (
/turf/open/floor/plating{
	icon_state = "panelscorched"
	},
/area/tdome)
"qW" = (
/obj/machinery/door/keycard/eventtwo,
/turf/open/floor/iron/white,
/area/tdome)
"rf" = (
/obj/effect/spawner/structure/window/reinforced/indestructable,
/turf/open/floor/plating,
/area/tdome)
"rk" = (
/obj/effect/spawner/lootdrop/crate_spawner,
/turf/open/floor/plating,
/area/tdome)
"rt" = (
/turf/closed/indestructible/riveted,
/area/tdome)
"rV" = (
/obj/effect/spawner/lootdrop/crate_spawner,
/obj/effect/turf_decal/stripes/white/box,
/turf/open/floor/plating,
/area/tdome)
"rZ" = (
/turf/open/floor/carpet/green,
/area/tdome)
"sj" = (
/turf/open/floor/carpet/royalblack,
/area/tdome)
"tH" = (
/obj/machinery/light/cold/directional/east,
/turf/open/floor/carpet/royalblack,
/area/tdome)
"tS" = (
/obj/structure/holobox,
/turf/open/floor/plating{
	icon_state = "panelscorched"
	},
/area/tdome)
"tW" = (
/obj/effect/decal/cleanable/blood/drip,
/turf/open/floor/carpet/green,
/area/tdome)
"ug" = (
/obj/machinery/computer/launchpad,
/turf/open/floor/iron/smooth_large,
/area/tdome)
"uQ" = (
/obj/item/ticket_machine_ticket,
/turf/open/floor/iron/white,
/area/tdome)
"vj" = (
/obj/item/paper_bin{
	pixel_y = 5
	},
/obj/structure/table/rolling,
/turf/open/floor/iron/smooth_large,
/area/tdome)
"wF" = (
/obj/structure/chair/office/light{
	dir = 1
	},
/turf/open/floor/iron/smooth_corner,
/area/tdome)
"wN" = (
/obj/structure/fence/corner,
/turf/open/floor/plating/grass,
/area/tdome)
"yG" = (
/obj/structure/table/reinforced,
/obj/machinery/door/window{
	dir = 1
	},
/obj/machinery/door/window{
	dir = 2
	},
/obj/structure/window/spawner/east,
/obj/item/toy/figure/cargotech,
/turf/open/floor/noslip,
/area/tdome)
"zf" = (
/obj/machinery/status_display/evac/directional/west,
/obj/structure/chair/plastic{
	dir = 4
	},
/obj/item/reagent_containers/food/drinks/ice{
	pixel_x = 4;
	pixel_y = 3
	},
/turf/open/floor/iron/white,
/area/tdome)
"zo" = (
/obj/structure/sign/poster/official/obey,
/turf/closed/indestructible/reinforced,
/area/tdome)
"Ac" = (
/obj/effect/spawner/structure/window/ice,
/turf/open/floor/plating,
/area/tdome)
"Au" = (
/obj/structure/chair/plastic{
	dir = 4
	},
/obj/item/flashlight/glowstick/orange,
/turf/open/floor/iron/white,
/area/tdome)
"Bg" = (
/obj/effect/turf_decal/trimline/white/arrow_ccw{
	dir = 4
	},
/obj/item/pressure_plate/hologrid{
	reward = /obj/item/toy/plush/moth
	},
/turf/open/floor/plating,
/area/tdome)
"Bh" = (
/obj/structure/fence{
	dir = 4
	},
/turf/open/floor/plating/grass,
/area/tdome)
"BH" = (
/obj/structure/fence/post{
	dir = 4
	},
/turf/open/floor/plating/grass,
/area/tdome)
"Cq" = (
/obj/structure/fence/corner{
	dir = 1
	},
/turf/open/floor/plating/grass,
/area/tdome)
"CC" = (
/obj/machinery/door/keycard,
/turf/open/floor/plating,
/area/tdome)
"CH" = (
/turf/open/floor/iron/white,
/area/tdome)
"CK" = (
/obj/item/food/grown/coffee/robusta,
/turf/open/floor/iron/smooth_half,
/area/tdome)
"CR" = (
/turf/open/floor/iron/smooth_corner{
	dir = 8
	},
/area/tdome)
"CW" = (
/obj/item/storage/toolbox/syndicate,
/turf/open/floor/plating/grass,
/area/tdome)
"Dp" = (
/obj/effect/decal/cleanable/plasma,
/obj/machinery/light/small/red/directional/north,
/turf/open/floor/plating,
/area/tdome)
"Dq" = (
/turf/open/floor/plating/grass,
/area/tdome)
"DD" = (
/obj/item/reagent_containers/food/drinks/coffee,
/turf/open/floor/iron/smooth_large,
/area/tdome)
"DX" = (
/obj/structure/table/greyscale,
/turf/open/floor/carpet/royalblack,
/area/tdome)
"EC" = (
/obj/item/pressure_plate/hologrid{
	reward = /obj/item/keycard/eventone
	},
/obj/effect/turf_decal/trimline/brown/arrow_ccw{
	dir = 4
	},
/turf/open/floor/plating,
/area/tdome)
"Fg" = (
/turf/closed/indestructible/rock,
/area/tdome)
"Fx" = (
/obj/item/food/grown/coffee/robusta,
/obj/machinery/light_switch/directional/west,
/turf/open/floor/iron/smooth_large,
/area/tdome)
"FD" = (
/obj/machinery/launchpad,
/turf/open/floor/iron/smooth_large,
/area/tdome)
"FM" = (
/obj/machinery/door/airlock/mining/glass,
/turf/open/floor/noslip,
/area/tdome)
"FW" = (
/obj/effect/decal/cleanable/wrapping,
/obj/machinery/light/warm/directional/west,
/turf/open/floor/iron/smooth_half,
/area/tdome)
"FX" = (
/obj/structure/closet/crate/mail{
	icon_state = "mailopen"
	},
/turf/open/floor/plating,
/area/tdome)
"FZ" = (
/obj/effect/decal/cleanable/oil,
/turf/open/floor/iron/smooth_large,
/area/tdome)
"Ga" = (
/obj/structure/grille,
/turf/open/floor/plating,
/area/tdome)
"GP" = (
/turf/closed/indestructible/reinforced,
/area/tdome)
"GQ" = (
/obj/structure/chair/plastic{
	dir = 4
	},
/turf/open/floor/iron/white,
/area/tdome)
"Hz" = (
/turf/open/floor/iron/smooth_half,
/area/tdome)
"Ir" = (
/obj/structure/holobox,
/turf/open/floor/plating/grass,
/area/tdome)
"IK" = (
/obj/item/reagent_containers/food/drinks/trophy/gold_cup,
/turf/open/floor/carpet/green,
/area/tdome)
"IZ" = (
/obj/structure/fence,
/turf/open/floor/plating/grass,
/area/tdome)
"Jl" = (
/obj/structure/flora/rock/icy,
/turf/open/floor/plating/grass,
/area/tdome)
"Js" = (
/obj/structure/filingcabinet/chestdrawer/wheeled,
/obj/item/storage/fancy/heart_box,
/obj/item/food/tinychocolate,
/turf/open/floor/carpet/royalblack,
/area/tdome)
"Jy" = (
/obj/machinery/door/keycard/eventtwo,
/turf/open/floor/plating/grass,
/area/tdome)
"Ke" = (
/obj/machinery/arena_spawn/red,
/turf/open/floor/plating/grass,
/area/tdome)
"KB" = (
/obj/effect/decal/cleanable/blood/drip,
/turf/open/floor/carpet/royalblack,
/area/tdome)
"Lh" = (
/obj/structure/closet/crate/mail{
	icon_state = "mailopen"
	},
/obj/effect/turf_decal/stripes{
	dir = 8
	},
/turf/open/floor/plating,
/area/tdome)
"LH" = (
/obj/structure/sign/warning/nosmoking/circle,
/turf/closed/indestructible/reinforced,
/area/tdome)
"Ma" = (
/obj/effect/turf_decal/trimline/yellow/arrow_ccw{
	dir = 4
	},
/obj/item/pressure_plate/hologrid{
	reward = /mob/living/simple_animal/pet/dog/bullterrier
	},
/turf/open/floor/plating,
/area/tdome)
"OF" = (
/obj/structure/closet/crate/secure,
/turf/open/floor/plating,
/area/tdome)
"OI" = (
/obj/structure/chair/office/light{
	dir = 8
	},
/turf/open/floor/carpet/royalblack,
/area/tdome)
"Pm" = (
/obj/structure/sign/warning/securearea,
/turf/closed/wall/r_wall,
/area/tdome)
"PY" = (
/obj/item/trash/can,
/turf/open/floor/plating/grass,
/area/tdome)
"QG" = (
/obj/item/food/grown/coffee,
/obj/effect/turf_decal/siding/yellow,
/turf/open/floor/iron/smooth_large,
/area/tdome)
"QU" = (
/obj/effect/turf_decal/bot,
/obj/item/pressure_plate/hologrid{
	reward = /obj/item/keycard/eventtwo
	},
/turf/open/floor/plating,
/area/tdome)
"Ru" = (
/turf/closed/wall/r_wall,
/area/tdome)
"Sp" = (
/obj/structure/sign/departments/cargo,
/turf/closed/indestructible/reinforced,
/area/tdome)
"Ti" = (
/obj/structure/filingcabinet/chestdrawer/wheeled,
/obj/item/valentine,
/obj/item/grenade/c4,
/obj/item/clothing/accessory/medal/conduct,
/turf/open/floor/carpet/royalblack,
/area/tdome)
"UD" = (
/obj/effect/turf_decal/stripes/white/box,
/obj/effect/spawner/lootdrop/crate_spawner,
/turf/open/floor/plating,
/area/tdome)
"VA" = (
/obj/structure/sign/poster/ripped,
/turf/closed/indestructible/reinforced,
/area/tdome)
"Wc" = (
/obj/effect/turf_decal/loading_area{
	dir = 4
	},
/obj/effect/decal/remains/human,
/obj/machinery/light/cold/directional/south,
/turf/open/floor/iron/textured,
/area/tdome)
"Wq" = (
/obj/structure/marker_beacon/burgundy,
/turf/open/floor/plating/grass,
/area/tdome)
"WI" = (
/obj/structure/table/greyscale,
/obj/item/flashlight/lamp,
/obj/item/trash/candle,
/turf/open/floor/carpet/royalblack,
/area/tdome)
"Xa" = (
/obj/structure/closet/crate/mail/full,
/turf/open/floor/iron/smooth_large,
/area/tdome)
"YA" = (
/obj/structure/window/reinforced{
	dir = 4
	},
/turf/open/floor/iron/textured,
/area/tdome)
"YI" = (
/obj/structure/sign/departments/cargo,
/turf/closed/wall/r_wall,
/area/tdome)
"YY" = (
/obj/machinery/arena_spawn/green,
/turf/open/floor/plating/grass,
/area/tdome)

(1,1,1) = {"
pf
pf
pf
pf
pf
pf
pf
pf
pf
pf
pf
pf
pf
pf
pf
pf
pf
pf
pf
pf
pf
pf
pf
pf
pf
pf
pf
pf
pf
pf
pf
pf
pf
pf
pf
pf
pf
pf
pf
pf
pf
pf
pf
pf
pf
pf
pf
pf
pf
pf
pf
pf
pf
pf
pf
pf
pf
pf
pf
pf
pf
pf
pf
pf
"}
(2,1,1) = {"
pf
pf
pf
pf
pf
pf
pf
pf
pf
pf
pf
pf
pf
pf
pf
pf
pf
pf
pf
pf
pf
pf
pf
pf
pf
pf
pf
pf
pf
pf
pf
pf
pf
pf
pf
pf
pf
pf
pf
pf
pf
pf
pf
pf
pf
pf
pf
pf
pf
pf
pf
pf
pf
pf
pf
pf
pf
pf
pf
pf
pf
pf
pf
pf
"}
(3,1,1) = {"
pf
pf
pf
pf
pf
pf
pf
pf
pf
pf
pf
pf
pf
pf
pf
pf
pf
pf
pf
pf
pf
pf
pf
pf
pf
pf
pf
pf
pf
pf
pf
pf
pf
pf
pf
pf
pf
pf
pf
pf
pf
pf
pf
pf
pf
pf
pf
pf
pf
pf
pf
pf
pf
pf
pf
pf
pf
pf
pf
pf
pf
pf
pf
pf
"}
(4,1,1) = {"
pf
pf
pf
pf
pf
pf
pf
pf
pf
pf
pf
pf
pf
pf
pf
pf
pf
pf
pf
pf
pf
pf
pf
pf
pf
pf
pf
pf
pf
pf
pf
pf
pf
pf
pf
pf
pf
pf
pf
pf
pf
pf
pf
pf
pf
pf
pf
pf
pf
pf
pf
pf
pf
pf
pf
pf
pf
pf
pf
pf
pf
pf
pf
pf
"}
(5,1,1) = {"
pf
pf
pf
pf
pf
pf
pf
pf
pf
pf
pf
pf
pf
pf
pf
pf
pf
pf
pf
pf
pf
pf
pf
pf
pf
pf
pf
pf
pf
pf
pf
pf
pf
pf
pf
pf
pf
pf
pf
pf
pf
pf
pf
pf
pf
pf
pf
pf
pf
pf
pf
pf
pf
pf
pf
pf
pf
pf
pf
pf
pf
pf
pf
pf
"}
(6,1,1) = {"
pf
pf
pf
pf
pf
pf
pf
pf
pf
pf
pf
pf
pf
pf
pf
pf
pf
pf
pf
pf
pf
pf
pf
pf
pf
pf
pf
pf
pf
pf
pf
pf
pf
pf
pf
pf
pf
pf
pf
pf
pf
pf
pf
pf
pf
pf
pf
pf
pf
pf
pf
pf
pf
pf
pf
pf
pf
pf
pf
pf
pf
pf
pf
pf
"}
(7,1,1) = {"
pf
pf
pf
pf
pf
pf
pf
pf
pf
pf
pf
pf
pf
pf
pf
pf
pf
pf
pf
pf
pf
pf
pf
pf
pf
pf
pf
pf
pf
pf
pf
pf
pf
pf
pf
pf
pf
pf
pf
pf
pf
pf
pf
pf
pf
pf
pf
pf
pf
pf
pf
pf
pf
pf
pf
pf
pf
pf
pf
pf
pf
pf
pf
pf
"}
(8,1,1) = {"
pf
pf
pf
pf
pf
pf
pf
pf
pf
pf
pf
pf
pf
pf
pf
pf
pf
pf
pf
pf
pf
pf
pf
pf
pf
pf
pf
pf
pf
pf
pf
pf
pf
pf
pf
pf
pf
pf
pf
pf
pf
pf
pf
pf
pf
pf
pf
pf
pf
pf
pf
pf
pf
pf
pf
pf
pf
pf
pf
pf
pf
pf
pf
pf
"}
(9,1,1) = {"
pf
pf
pf
pf
pf
pf
pf
pf
pf
pf
pf
pf
pf
pf
pf
pf
pf
pf
pf
pf
pf
pf
pf
pf
pf
pf
pf
pf
pf
pf
pf
pf
pf
pf
pf
pf
pf
pf
pf
pf
pf
pf
pf
pf
pf
pf
pf
pf
pf
pf
pf
pf
pf
pf
pf
pf
pf
pf
pf
pf
pf
pf
pf
pf
"}
(10,1,1) = {"
pf
pf
pf
pf
pf
pf
pf
pf
pf
pf
pf
pf
pf
pf
pf
pf
pf
pf
pf
pf
pf
pf
pf
pf
Fg
Fg
Fg
Fg
Fg
Fg
Fg
Fg
Fg
Fg
Fg
Fg
Fg
Fg
Fg
Fg
Fg
Fg
Fg
Fg
Fg
pf
pf
pf
pf
pf
pf
pf
pf
pf
pf
pf
pf
pf
pf
pf
pf
pf
pf
pf
"}
(11,1,1) = {"
pf
pf
pf
pf
pf
pf
pf
pf
pf
pf
pf
pf
pf
pf
pf
pf
pf
pf
pf
pf
pf
pf
pf
pf
Fg
Dq
Bh
Wq
Dq
Dq
Fg
Dq
Dq
Wq
Bh
Fg
Dq
Dq
Dq
Dq
Fg
Fg
Fg
Fg
Fg
pf
pf
pf
pf
pf
pf
pf
pf
pf
pf
pf
pf
pf
pf
pf
pf
pf
pf
pf
"}
(12,1,1) = {"
pf
pf
pf
pf
pf
pf
pf
pf
pf
pf
pf
pf
pf
pf
pf
pf
pf
pf
pf
pf
pf
pf
pf
pf
Fg
CW
Fg
Dq
Dq
Dq
Dq
Dq
Dq
Dq
Bh
Fg
CW
Fg
Dq
Dq
Dq
Dq
Dq
Dq
Fg
pf
pf
pf
pf
pf
pf
pf
pf
pf
pf
pf
pf
pf
pf
pf
pf
pf
pf
pf
"}
(13,1,1) = {"
pf
pf
pf
pf
pf
pf
pf
pf
pf
pf
pf
pf
pf
pf
pf
pf
pf
pf
pf
pf
pf
pf
pf
pf
Fg
Dq
Bh
Ir
Dq
Dq
Dq
Dq
Dq
Dq
Bh
Fg
Fg
Fg
Fg
Fg
Fg
Fg
Fg
Dq
Fg
pf
pf
pf
pf
pf
pf
pf
pf
pf
pf
pf
pf
pf
pf
pf
pf
pf
pf
pf
"}
(14,1,1) = {"
pf
pf
pf
pf
pf
pf
pf
pf
pf
pf
pf
pf
pf
pf
pf
pf
pf
pf
pf
pf
pf
pf
pf
pf
Fg
Dq
Bh
Wq
Dq
PY
Dq
Dq
Dq
Wq
dC
Dq
Dq
Dq
YY
Fg
Fg
Dq
Dq
Dq
Fg
pf
pf
pf
pf
pf
pf
pf
pf
pf
pf
pf
pf
pf
pf
pf
pf
pf
pf
pf
"}
(15,1,1) = {"
pf
pf
pf
pf
pf
pf
pf
pf
pf
pf
pf
pf
pf
pf
pf
pf
pf
pf
pf
pf
pf
pf
pf
pf
Fg
Dq
Fg
Fg
Fg
Fg
Fg
Fg
Fg
Fg
Fg
Fg
Fg
Dq
Dq
Dq
Fg
Fg
Dq
Fg
Fg
pf
pf
pf
pf
pf
pf
pf
pf
pf
pf
pf
pf
pf
pf
pf
pf
pf
pf
pf
"}
(16,1,1) = {"
pf
pf
pf
pf
pf
pf
pf
pf
pf
pf
pf
pf
pf
pf
pf
pf
pf
pf
pf
pf
pf
pf
pf
pf
Fg
Dq
GP
GP
GP
VA
GP
GP
GP
GP
GP
Ac
GP
IZ
Cq
Dq
Fg
Fg
Dq
Dq
Fg
pf
pf
pf
pf
pf
pf
pf
pf
pf
pf
pf
pf
pf
pf
pf
pf
pf
pf
pf
"}
(17,1,1) = {"
pf
pf
pf
pf
pf
pf
pf
pf
pf
pf
pf
pf
pf
pf
pf
pf
pf
pf
pf
pf
pf
pf
pf
pf
Fg
Dq
GP
FD
Fx
FW
bx
og
zf
nk
GQ
Au
GP
Jl
BH
Dq
Dq
Fg
Fg
Dq
Fg
pf
pf
pf
pf
pf
pf
pf
pf
pf
pf
pf
pf
pf
pf
pf
pf
pf
pf
pf
"}
(18,1,1) = {"
pf
pf
pf
pf
pf
pf
pf
pf
pf
pf
pf
pf
pf
pf
pf
pf
pf
pf
pf
pf
pf
pf
pf
pf
Fg
Dq
GP
ug
wF
bE
QG
dX
CH
CH
CH
uQ
yG
Dq
BH
Dq
Dq
Dq
Dq
Dq
Fg
pf
pf
pf
pf
pf
pf
pf
pf
pf
pf
pf
pf
pf
pf
pf
pf
pf
pf
pf
"}
(19,1,1) = {"
pf
pf
pf
pf
pf
pf
pf
pf
pf
pf
pf
pf
pf
pf
pf
pf
pf
pf
pf
pf
pf
pf
pf
pf
Fg
Dq
GP
vj
Hz
DD
bw
Ru
oO
uQ
CH
CH
FM
Dq
dC
Dq
Dq
Dq
Dq
Dq
Fg
pf
pf
pf
pf
pf
pf
pf
pf
pf
pf
pf
pf
pf
pf
pf
pf
pf
pf
pf
"}
(20,1,1) = {"
pf
pf
pf
pf
pf
pf
pf
pf
pf
pf
pf
pf
pf
pf
pf
pf
pf
pf
pf
pf
pf
pf
pf
pf
Fg
Dq
zo
kw
CR
nz
bx
LH
nn
YA
YA
Wc
Sp
Dq
Bh
Fg
Dq
Dq
Fg
Fg
Fg
pf
pf
pf
pf
pf
pf
pf
pf
pf
pf
pf
pf
pf
pf
pf
pf
pf
pf
pf
"}
(21,1,1) = {"
pf
pf
pf
pf
pf
pf
pf
pf
pf
pf
pf
pf
pf
pf
pf
pf
pf
pf
pf
pf
pf
pf
pf
pf
Fg
Dq
GP
Xa
FZ
CK
ai
GP
QU
Bg
Ma
EC
GP
IZ
wN
Dq
Dq
Dq
Fg
Fg
Fg
pf
pf
pf
pf
pf
pf
pf
pf
pf
pf
pf
pf
pf
pf
pf
pf
pf
pf
pf
"}
(22,1,1) = {"
pf
pf
pf
pf
pf
pf
pf
pf
pf
pf
pf
pf
pf
pf
pf
pf
pf
pf
pf
pf
pf
pf
pf
pf
Fg
Dq
GP
rf
rf
rf
CC
GP
GP
oU
GP
Ga
GP
GP
GP
GP
GP
Dq
Dq
Dq
Fg
pf
pf
pf
pf
pf
pf
pf
pf
pf
pf
pf
pf
pf
pf
pf
pf
pf
pf
pf
"}
(23,1,1) = {"
pf
pf
pf
pf
pf
pf
pf
pf
pf
pf
pf
pf
pf
pf
pf
pf
pf
pf
pf
pf
pf
pf
pf
pf
Fg
Dq
GP
mG
Lh
mG
mY
gS
oq
mG
GP
rf
GP
sj
lk
Js
GP
Dq
Dq
Dq
Fg
pf
pf
pf
pf
pf
pf
pf
pf
pf
pf
pf
pf
pf
pf
pf
pf
pf
pf
pf
"}
(24,1,1) = {"
pf
pf
pf
pf
pf
pf
pf
pf
pf
pf
pf
pf
pf
pf
pf
pf
pf
pf
pf
pf
pf
pf
pf
pf
Fg
Dq
GP
mY
mY
mY
mY
mY
mY
rk
GP
sj
rZ
rZ
jK
WI
GP
hU
Dq
Fg
Fg
pf
pf
pf
pf
pf
pf
pf
pf
pf
pf
pf
pf
pf
pf
pf
pf
pf
pf
pf
"}
(25,1,1) = {"
pf
pf
pf
pf
pf
pf
pf
pf
pf
pf
pf
pf
pf
pf
pf
pf
pf
pf
pf
pf
pf
pf
pf
pf
Fg
Dq
GP
Dp
mY
pC
mY
mY
mY
mY
GP
KB
IK
rZ
tW
sj
Jy
Dq
Dq
Fg
Fg
pf
pf
pf
pf
pf
pf
pf
pf
pf
pf
pf
pf
pf
pf
pf
pf
pf
pf
pf
"}
(26,1,1) = {"
pf
pf
pf
pf
pf
pf
pf
pf
pf
pf
pf
pf
pf
pf
pf
pf
pf
pf
pf
pf
pf
pf
pf
pf
Fg
Dq
GP
OF
mY
mY
FX
mY
pC
mY
GP
sj
rZ
rZ
lg
DX
GP
Dq
Dq
Dq
Fg
pf
pf
pf
pf
pf
pf
pf
pf
pf
pf
pf
pf
pf
pf
pf
pf
pf
pf
pf
"}
(27,1,1) = {"
pf
pf
pf
pf
pf
pf
pf
pf
pf
pf
pf
pf
pf
pf
pf
pf
pf
pf
pf
pf
pf
pf
pf
pf
Fg
Dq
GP
fA
mY
UD
mY
rV
mY
tS
GP
sj
KB
tH
OI
Ti
GP
Dq
Dq
Dq
Fg
pf
pf
pf
pf
pf
pf
pf
pf
pf
pf
pf
pf
pf
pf
pf
pf
pf
pf
pf
"}
(28,1,1) = {"
pf
pf
pf
pf
pf
pf
pf
pf
pf
pf
pf
pf
pf
pf
pf
pf
pf
pf
pf
pf
pf
pf
pf
pf
Fg
Dq
GP
GP
zo
GP
GP
VA
GP
GP
GP
VA
zo
VA
zo
zo
GP
Dq
Dq
Fg
Fg
pf
pf
pf
pf
pf
pf
pf
pf
pf
pf
pf
pf
pf
pf
pf
pf
pf
pf
pf
"}
(29,1,1) = {"
pf
pf
pf
pf
pf
pf
pf
pf
pf
pf
pf
pf
pf
pf
pf
pf
pf
pf
pf
pf
pf
pf
pf
pf
Fg
Dq
Dq
Dq
Fg
Fg
Fg
Dq
Dq
Dq
Dq
Dq
Fg
Dq
Dq
Dq
Dq
Dq
Dq
Fg
Fg
pf
pf
pf
pf
pf
pf
pf
pf
pf
pf
pf
pf
pf
pf
pf
pf
pf
pf
pf
"}
(30,1,1) = {"
pf
pf
pf
pf
pf
pf
pf
pf
pf
pf
pf
pf
pf
pf
pf
pf
pf
pf
pf
pf
pf
pf
pf
pf
Fg
Dq
Jl
Dq
Fg
Fg
Dq
Dq
Jl
Dq
Fg
Dq
Dq
Dq
Fg
Fg
Fg
Dq
Dq
Dq
Fg
pf
pf
pf
pf
pf
pf
pf
pf
pf
pf
pf
pf
pf
pf
pf
pf
pf
pf
pf
"}
(31,1,1) = {"
pf
pf
pf
pf
pf
pf
pf
pf
pf
pf
pf
pf
pf
pf
pf
pf
pf
pf
pf
pf
pf
pf
pf
pf
Fg
Fg
Fg
Dq
Dq
Dq
Dq
Fg
Fg
Fg
Fg
Fg
Fg
Fg
Fg
Fg
Fg
Fg
Fg
Fg
Fg
pf
pf
pf
pf
pf
pf
pf
pf
pf
pf
pf
pf
pf
pf
pf
pf
pf
pf
pf
"}
(32,1,1) = {"
pf
pf
pf
pf
pf
pf
pf
pf
pf
pf
pf
pf
pf
pf
pf
pf
pf
pf
pf
pf
pf
pf
pf
pf
rt
rt
rt
rt
rt
rt
rt
rt
rt
rt
rt
rt
rt
rt
rt
rt
rt
rt
rt
rt
rt
pf
pf
pf
pf
pf
pf
pf
pf
pf
pf
pf
pf
pf
pf
pf
pf
pf
pf
pf
"}
(33,1,1) = {"
pf
pf
pf
pf
pf
pf
pf
pf
pf
pf
pf
pf
pf
pf
pf
pf
pf
pf
pf
pf
pf
pf
pf
pf
Fg
Fg
Fg
Fg
Fg
Fg
Fg
Fg
Fg
Fg
Fg
Fg
Fg
Fg
Fg
Fg
Fg
Fg
Fg
Fg
Fg
pf
pf
pf
pf
pf
pf
pf
pf
pf
pf
pf
pf
pf
pf
pf
pf
pf
pf
pf
"}
(34,1,1) = {"
pf
pf
pf
pf
pf
pf
pf
pf
pf
pf
pf
pf
pf
pf
pf
pf
pf
pf
pf
pf
pf
pf
pf
pf
Fg
Dq
Bh
Wq
Dq
Dq
Fg
Dq
Dq
Wq
Bh
Fg
Dq
Dq
Dq
Dq
Fg
Fg
Fg
Fg
Fg
pf
pf
pf
pf
pf
pf
pf
pf
pf
pf
pf
pf
pf
pf
pf
pf
pf
pf
pf
"}
(35,1,1) = {"
pf
pf
pf
pf
pf
pf
pf
pf
pf
pf
pf
pf
pf
pf
pf
pf
pf
pf
pf
pf
pf
pf
pf
pf
Fg
CW
Fg
Dq
Dq
Dq
Dq
Dq
Dq
Dq
Bh
Fg
CW
Fg
Dq
Dq
Dq
Dq
Dq
Dq
Fg
pf
pf
pf
pf
pf
pf
pf
pf
pf
pf
pf
pf
pf
pf
pf
pf
pf
pf
pf
"}
(36,1,1) = {"
pf
pf
pf
pf
pf
pf
pf
pf
pf
pf
pf
pf
pf
pf
pf
pf
pf
pf
pf
pf
pf
pf
pf
pf
Fg
Dq
Bh
Ir
Dq
Dq
Dq
Dq
Dq
Dq
Bh
Fg
Fg
Fg
Fg
Fg
Fg
Fg
Fg
Dq
Fg
pf
pf
pf
pf
pf
pf
pf
pf
pf
pf
pf
pf
pf
pf
pf
pf
pf
pf
pf
"}
(37,1,1) = {"
pf
pf
pf
pf
pf
pf
pf
pf
pf
pf
pf
pf
pf
pf
pf
pf
pf
pf
pf
pf
pf
pf
pf
pf
Fg
Dq
Bh
Wq
Dq
PY
Dq
Dq
Dq
Wq
dC
Dq
Dq
Dq
Ke
Fg
Fg
Dq
Dq
Dq
Fg
pf
pf
pf
pf
pf
pf
pf
pf
pf
pf
pf
pf
pf
pf
pf
pf
pf
pf
pf
"}
(38,1,1) = {"
pf
pf
pf
pf
pf
pf
pf
pf
pf
pf
pf
pf
pf
pf
pf
pf
pf
pf
pf
pf
pf
pf
pf
pf
Fg
Dq
Fg
Fg
Fg
Fg
Fg
Fg
Fg
Fg
Fg
Fg
Fg
Dq
Dq
Dq
Fg
Fg
Dq
Fg
Fg
pf
pf
pf
pf
pf
pf
pf
pf
pf
pf
pf
pf
pf
pf
pf
pf
pf
pf
pf
"}
(39,1,1) = {"
pf
pf
pf
pf
pf
pf
pf
pf
pf
pf
pf
pf
pf
pf
pf
pf
pf
pf
pf
pf
pf
pf
pf
pf
Fg
Dq
GP
GP
GP
VA
GP
GP
GP
GP
GP
Ac
GP
IZ
Cq
Dq
Fg
Fg
Dq
Dq
Fg
pf
pf
pf
pf
pf
pf
pf
pf
pf
pf
pf
pf
pf
pf
pf
pf
pf
pf
pf
"}
(40,1,1) = {"
pf
pf
pf
pf
pf
pf
pf
pf
pf
pf
pf
pf
pf
pf
pf
pf
pf
pf
pf
pf
pf
pf
pf
pf
Fg
Dq
GP
FD
Fx
FW
bx
Pm
zf
nk
GQ
Au
GP
Jl
BH
Dq
Dq
Fg
Fg
Dq
Fg
pf
pf
pf
pf
pf
pf
pf
pf
pf
pf
pf
pf
pf
pf
pf
pf
pf
pf
pf
"}
(41,1,1) = {"
pf
pf
pf
pf
pf
pf
pf
pf
pf
pf
pf
pf
pf
pf
pf
pf
pf
pf
pf
pf
pf
pf
pf
pf
Fg
Dq
GP
ug
wF
bE
QG
dX
CH
CH
CH
uQ
yG
Dq
BH
Dq
Dq
Dq
Dq
Dq
Fg
pf
pf
pf
pf
pf
pf
pf
pf
pf
pf
pf
pf
pf
pf
pf
pf
pf
pf
pf
"}
(42,1,1) = {"
pf
pf
pf
pf
pf
pf
pf
pf
pf
pf
pf
pf
pf
pf
pf
pf
pf
pf
pf
pf
pf
pf
pf
pf
Fg
Dq
GP
vj
Hz
DD
bw
Ru
oO
uQ
CH
CH
FM
Dq
dC
Dq
Dq
Dq
Dq
Dq
Fg
pf
pf
pf
pf
pf
pf
pf
pf
pf
pf
pf
pf
pf
pf
pf
pf
pf
pf
pf
"}
(43,1,1) = {"
pf
pf
pf
pf
pf
pf
pf
pf
pf
pf
pf
pf
pf
pf
pf
pf
pf
pf
pf
pf
pf
pf
pf
pf
Fg
Dq
zo
kw
CR
nz
bx
LH
nn
YA
YA
Wc
YI
Dq
Bh
Fg
Dq
Dq
Fg
Fg
Fg
pf
pf
pf
pf
pf
pf
pf
pf
pf
pf
pf
pf
pf
pf
pf
pf
pf
pf
pf
"}
(44,1,1) = {"
pf
pf
pf
pf
pf
pf
pf
pf
pf
pf
pf
pf
pf
pf
pf
pf
pf
pf
pf
pf
pf
pf
pf
pf
Fg
Dq
GP
Xa
FZ
CK
ai
GP
QU
Bg
Ma
ox
GP
IZ
wN
Dq
Dq
Dq
Fg
Fg
Fg
pf
pf
pf
pf
pf
pf
pf
pf
pf
pf
pf
pf
pf
pf
pf
pf
pf
pf
pf
"}
(45,1,1) = {"
pf
pf
pf
pf
pf
pf
pf
pf
pf
pf
pf
pf
pf
pf
pf
pf
pf
pf
pf
pf
pf
pf
pf
pf
Fg
Dq
GP
rf
rf
rf
CC
GP
GP
zo
GP
Ga
GP
GP
GP
GP
GP
Dq
Dq
Dq
Fg
pf
pf
pf
pf
pf
pf
pf
pf
pf
pf
pf
pf
pf
pf
pf
pf
pf
pf
pf
"}
(46,1,1) = {"
pf
pf
pf
pf
pf
pf
pf
pf
pf
pf
pf
pf
pf
pf
pf
pf
pf
pf
pf
pf
pf
pf
pf
pf
Fg
Dq
GP
mG
Lh
mG
mY
gS
oq
mG
GP
rf
GP
sj
lk
Js
GP
Dq
Dq
Dq
Fg
pf
pf
pf
pf
pf
pf
pf
pf
pf
pf
pf
pf
pf
pf
pf
pf
pf
pf
pf
"}
(47,1,1) = {"
pf
pf
pf
pf
pf
pf
pf
pf
pf
pf
pf
pf
pf
pf
pf
pf
pf
pf
pf
pf
pf
pf
pf
pf
Fg
Dq
GP
mY
mY
mY
mY
mY
mY
rk
GP
sj
rZ
rZ
jK
WI
GP
hU
Dq
Fg
Fg
pf
pf
pf
pf
pf
pf
pf
pf
pf
pf
pf
pf
pf
pf
pf
pf
pf
pf
pf
"}
(48,1,1) = {"
pf
pf
pf
pf
pf
pf
pf
pf
pf
pf
pf
pf
pf
pf
pf
pf
pf
pf
pf
pf
pf
pf
pf
pf
Fg
Dq
GP
Dp
mY
pC
mY
mY
mY
mY
GP
KB
IK
rZ
tW
sj
qW
Dq
Dq
Fg
Fg
pf
pf
pf
pf
pf
pf
pf
pf
pf
pf
pf
pf
pf
pf
pf
pf
pf
pf
pf
"}
(49,1,1) = {"
pf
pf
pf
pf
pf
pf
pf
pf
pf
pf
pf
pf
pf
pf
pf
pf
pf
pf
pf
pf
pf
pf
pf
pf
Fg
Dq
GP
OF
mY
mY
FX
mY
pC
mY
GP
sj
rZ
rZ
lg
DX
GP
Dq
Dq
Dq
Fg
pf
pf
pf
pf
pf
pf
pf
pf
pf
pf
pf
pf
pf
pf
pf
pf
pf
pf
pf
"}
(50,1,1) = {"
pf
pf
pf
pf
pf
pf
pf
pf
pf
pf
pf
pf
pf
pf
pf
pf
pf
pf
pf
pf
pf
pf
pf
pf
Fg
Dq
GP
fA
mY
UD
mY
rV
mY
tS
GP
sj
KB
tH
OI
Ti
GP
Dq
Dq
Dq
Fg
pf
pf
pf
pf
pf
pf
pf
pf
pf
pf
pf
pf
pf
pf
pf
pf
pf
pf
pf
"}
(51,1,1) = {"
pf
pf
pf
pf
pf
pf
pf
pf
pf
pf
pf
pf
pf
pf
pf
pf
pf
pf
pf
pf
pf
pf
pf
pf
Fg
Dq
GP
GP
zo
GP
GP
VA
GP
GP
GP
VA
zo
VA
zo
zo
GP
Dq
Dq
Fg
Fg
pf
pf
pf
pf
pf
pf
pf
pf
pf
pf
pf
pf
pf
pf
pf
pf
pf
pf
pf
"}
(52,1,1) = {"
pf
pf
pf
pf
pf
pf
pf
pf
pf
pf
pf
pf
pf
pf
pf
pf
pf
pf
pf
pf
pf
pf
pf
pf
Fg
Dq
Dq
Dq
Fg
Fg
Fg
Dq
Dq
Dq
Dq
Dq
Fg
Dq
Dq
Dq
Dq
Dq
Dq
Fg
Fg
pf
pf
pf
pf
pf
pf
pf
pf
pf
pf
pf
pf
pf
pf
pf
pf
pf
pf
pf
"}
(53,1,1) = {"
pf
pf
pf
pf
pf
pf
pf
pf
pf
pf
pf
pf
pf
pf
pf
pf
pf
pf
pf
pf
pf
pf
pf
pf
Fg
Dq
Jl
Dq
Dq
Dq
Dq
Dq
Jl
Dq
Fg
Dq
Dq
Dq
Fg
Fg
Fg
Dq
Dq
Dq
Fg
pf
pf
pf
pf
pf
pf
pf
pf
pf
pf
pf
pf
pf
pf
pf
pf
pf
pf
pf
"}
(54,1,1) = {"
pf
pf
pf
pf
pf
pf
pf
pf
pf
pf
pf
pf
pf
pf
pf
pf
pf
pf
pf
pf
pf
pf
pf
pf
Fg
Fg
Fg
Fg
Fg
Fg
Fg
Fg
Fg
Fg
Fg
Fg
Fg
Fg
Fg
Fg
Fg
Fg
Fg
Fg
Fg
pf
pf
pf
pf
pf
pf
pf
pf
pf
pf
pf
pf
pf
pf
pf
pf
pf
pf
pf
"}
(55,1,1) = {"
pf
pf
pf
pf
pf
pf
pf
pf
pf
pf
pf
pf
pf
pf
pf
pf
pf
pf
pf
pf
pf
pf
pf
pf
pf
pf
pf
pf
pf
pf
pf
pf
pf
pf
pf
pf
pf
pf
pf
pf
pf
pf
pf
pf
pf
pf
pf
pf
pf
pf
pf
pf
pf
pf
pf
pf
pf
pf
pf
pf
pf
pf
pf
pf
"}
(56,1,1) = {"
pf
pf
pf
pf
pf
pf
pf
pf
pf
pf
pf
pf
pf
pf
pf
pf
pf
pf
pf
pf
pf
pf
pf
pf
pf
pf
pf
pf
pf
pf
pf
pf
pf
pf
pf
pf
pf
pf
pf
pf
pf
pf
pf
pf
pf
pf
pf
pf
pf
pf
pf
pf
pf
pf
pf
pf
pf
pf
pf
pf
pf
pf
pf
pf
"}
(57,1,1) = {"
pf
pf
pf
pf
pf
pf
pf
pf
pf
pf
pf
pf
pf
pf
pf
pf
pf
pf
pf
pf
pf
pf
pf
pf
pf
pf
pf
pf
pf
pf
pf
pf
pf
pf
pf
pf
pf
pf
pf
pf
pf
pf
pf
pf
pf
pf
pf
pf
pf
pf
pf
pf
pf
pf
pf
pf
pf
pf
pf
pf
pf
pf
pf
pf
"}
(58,1,1) = {"
pf
pf
pf
pf
pf
pf
pf
pf
pf
pf
pf
pf
pf
pf
pf
pf
pf
pf
pf
pf
pf
pf
pf
pf
pf
pf
pf
pf
pf
pf
pf
pf
pf
pf
pf
pf
pf
pf
pf
pf
pf
pf
pf
pf
pf
pf
pf
pf
pf
pf
pf
pf
pf
pf
pf
pf
pf
pf
pf
pf
pf
pf
pf
pf
"}
(59,1,1) = {"
pf
pf
pf
pf
pf
pf
pf
pf
pf
pf
pf
pf
pf
pf
pf
pf
pf
pf
pf
pf
pf
pf
pf
pf
pf
pf
pf
pf
pf
pf
pf
pf
pf
pf
pf
pf
pf
pf
pf
pf
pf
pf
pf
pf
pf
pf
pf
pf
pf
pf
pf
pf
pf
pf
pf
pf
pf
pf
pf
pf
pf
pf
pf
pf
"}
(60,1,1) = {"
pf
pf
pf
pf
pf
pf
pf
pf
pf
pf
pf
pf
pf
pf
pf
pf
pf
pf
pf
pf
pf
pf
pf
pf
pf
pf
pf
pf
pf
pf
pf
pf
pf
pf
pf
pf
pf
pf
pf
pf
pf
pf
pf
pf
pf
pf
pf
pf
pf
pf
pf
pf
pf
pf
pf
pf
pf
pf
pf
pf
pf
pf
pf
pf
"}
(61,1,1) = {"
pf
pf
pf
pf
pf
pf
pf
pf
pf
pf
pf
pf
pf
pf
pf
pf
pf
pf
pf
pf
pf
pf
pf
pf
pf
pf
pf
pf
pf
pf
pf
pf
pf
pf
pf
pf
pf
pf
pf
pf
pf
pf
pf
pf
pf
pf
pf
pf
pf
pf
pf
pf
pf
pf
pf
pf
pf
pf
pf
pf
pf
pf
pf
pf
"}
(62,1,1) = {"
pf
pf
pf
pf
pf
pf
pf
pf
pf
pf
pf
pf
pf
pf
pf
pf
pf
pf
pf
pf
pf
pf
pf
pf
pf
pf
pf
pf
pf
pf
pf
pf
pf
pf
pf
pf
pf
pf
pf
pf
pf
pf
pf
pf
pf
pf
pf
pf
pf
pf
pf
pf
pf
pf
pf
pf
pf
pf
pf
pf
pf
pf
pf
pf
"}
(63,1,1) = {"
pf
pf
pf
pf
pf
pf
pf
pf
pf
pf
pf
pf
pf
pf
pf
pf
pf
pf
pf
pf
pf
pf
pf
pf
pf
pf
pf
pf
pf
pf
pf
pf
pf
pf
pf
pf
pf
pf
pf
pf
pf
pf
pf
pf
pf
pf
pf
pf
pf
pf
pf
pf
pf
pf
pf
pf
pf
pf
pf
pf
pf
pf
pf
pf
"}
(64,1,1) = {"
pf
pf
pf
pf
pf
pf
pf
pf
pf
pf
pf
pf
pf
pf
pf
pf
pf
pf
pf
pf
pf
pf
pf
pf
pf
pf
pf
pf
pf
pf
pf
pf
pf
pf
pf
pf
pf
pf
pf
pf
pf
pf
pf
pf
pf
pf
pf
pf
pf
pf
pf
pf
pf
pf
pf
pf
pf
pf
pf
pf
pf
pf
pf
pf
"}
