//MAP CONVERTED BY dmm2tgm.py THIS HEADER COMMENT PREVENTS RECONVERSION, DO NOT REMOVE
"a" = (
/turf/open/space/basic,
/area/space)
"b" = (
/turf/closed/indestructible/riveted,
/area/awaymission/vr/murderdome)
"c" = (
/obj/structure/rack,
/obj/item/gun/energy/beam_rifle,
/obj/item/gun/energy/beam_rifle,
/obj/item/gun/energy/beam_rifle,
/obj/item/gun/energy/beam_rifle,
/obj/item/gun/energy/beam_rifle,
/obj/item/gun/energy/beam_rifle,
/turf/open/indestructible,
/area/awaymission/vr/murderdome)
"d" = (
/obj/structure/rack,
/obj/item/gun/ballistic/automatic/l6_saw/unrestricted,
/obj/item/gun/ballistic/automatic/l6_saw/unrestricted,
/obj/item/gun/ballistic/automatic/l6_saw/unrestricted,
/obj/item/gun/ballistic/automatic/l6_saw/unrestricted,
/obj/item/gun/ballistic/automatic/l6_saw/unrestricted,
/turf/open/indestructible,
/area/awaymission/vr/murderdome)
"e" = (
/obj/structure/rack,
/obj/item/gun/ballistic/automatic/wt550,
/obj/item/gun/ballistic/automatic/wt550,
/obj/item/gun/ballistic/automatic/wt550,
/obj/item/gun/ballistic/automatic/wt550,
/obj/item/gun/ballistic/automatic/wt550,
/obj/item/gun/ballistic/automatic/wt550,
/obj/machinery/light{
	dir = 1
	},
/turf/open/indestructible,
/area/awaymission/vr/murderdome)
"f" = (
/obj/structure/rack,
/obj/item/gun/ballistic/automatic/m90/unrestricted,
/obj/item/gun/ballistic/automatic/m90/unrestricted,
/obj/item/gun/ballistic/automatic/m90/unrestricted,
/obj/item/gun/ballistic/automatic/m90/unrestricted,
/obj/item/gun/ballistic/automatic/m90/unrestricted,
/obj/item/gun/ballistic/automatic/c20r/unrestricted,
/turf/open/indestructible,
/area/awaymission/vr/murderdome)
"g" = (
/obj/structure/rack,
/obj/item/gun/ballistic/automatic/tommygun,
/obj/item/gun/ballistic/automatic/tommygun,
/obj/item/gun/ballistic/automatic/tommygun,
/obj/item/gun/ballistic/automatic/tommygun,
/obj/item/gun/ballistic/automatic/tommygun,
/turf/open/indestructible,
/area/awaymission/vr/murderdome)
"h" = (
/obj/structure/rack,
/obj/item/gun/energy/decloner,
/obj/item/gun/energy/decloner,
/obj/item/gun/energy/decloner,
/obj/item/gun/energy/decloner,
/obj/item/gun/energy/decloner,
/obj/item/gun/energy/decloner,
/turf/open/indestructible,
/area/awaymission/vr/murderdome)
"i" = (
/obj/machinery/recharger,
/turf/open/indestructible,
/area/awaymission/vr/murderdome)
"j" = (
/turf/open/indestructible,
/area/awaymission/vr/murderdome)
"k" = (
/obj/structure/rack,
/obj/item/gun/ballistic/automatic/proto/unrestricted,
/obj/item/gun/ballistic/automatic/proto/unrestricted,
/obj/item/gun/ballistic/automatic/proto/unrestricted,
/obj/item/gun/ballistic/automatic/proto/unrestricted,
/obj/item/gun/ballistic/automatic/proto/unrestricted,
/obj/item/gun/ballistic/automatic/c20r/unrestricted,
/obj/item/gun/ballistic/automatic/c20r/unrestricted,
/obj/item/gun/ballistic/automatic/c20r/unrestricted,
/obj/item/gun/ballistic/automatic/c20r/unrestricted,
/obj/item/gun/ballistic/automatic/c20r/unrestricted,
/obj/item/gun/ballistic/automatic/c20r/unrestricted,
/obj/item/gun/ballistic/automatic/c20r/unrestricted,
/obj/item/gun/ballistic/automatic/c20r/unrestricted,
/obj/item/gun/ballistic/automatic/c20r/unrestricted,
/obj/item/gun/ballistic/automatic/c20r/unrestricted,
/turf/open/indestructible,
/area/awaymission/vr/murderdome)
"l" = (
/obj/structure/rack,
/obj/item/gun/energy/laser/scatter,
/obj/item/gun/energy/laser/scatter,
/obj/item/gun/energy/laser/scatter,
/obj/item/gun/energy/laser/scatter,
/obj/item/gun/energy/laser/scatter,
/turf/open/indestructible,
/area/awaymission/vr/murderdome)
"m" = (
/obj/effect/landmark/vr_spawn,
/turf/open/indestructible,
/area/awaymission/vr/murderdome)
"n" = (
/obj/item/firing_pin,
/turf/open/indestructible,
/area/awaymission/vr/murderdome)
"o" = (
/obj/structure/rack,
/obj/item/gun/ballistic/shotgun/automatic/combat,
/obj/item/gun/ballistic/shotgun/automatic/combat,
/obj/item/gun/ballistic/shotgun/automatic/combat,
/obj/item/gun/ballistic/shotgun/automatic/combat,
/obj/item/gun/ballistic/shotgun/automatic/combat,
/obj/item/gun/ballistic/shotgun/automatic/combat,
/turf/open/indestructible,
/area/awaymission/vr/murderdome)
"p" = (
/obj/structure/rack,
/obj/item/gun/energy/xray,
/obj/item/gun/energy/xray,
/obj/item/gun/energy/xray,
/obj/item/gun/energy/xray,
/obj/item/gun/energy/xray,
/obj/item/gun/energy/xray,
/turf/open/indestructible,
/area/awaymission/vr/murderdome)
"q" = (
/obj/item/melee/baton/loaded,
/obj/item/melee/baton/loaded,
/obj/item/melee/baton/loaded,
/obj/item/melee/baton/loaded,
/obj/item/melee/baton/loaded,
/obj/item/melee/baton/loaded,
/obj/item/melee/transforming/energy/sword/saber,
/obj/item/melee/transforming/energy/sword/saber,
/obj/item/melee/transforming/energy/sword/saber,
/obj/item/melee/transforming/energy/sword/saber,
/turf/open/indestructible,
/area/awaymission/vr/murderdome)
"r" = (
/obj/structure/rack,
/obj/item/gun/ballistic/shotgun/boltaction,
/obj/item/gun/ballistic/shotgun/boltaction,
/obj/item/gun/ballistic/shotgun/boltaction,
/obj/item/gun/ballistic/shotgun/boltaction,
/turf/open/indestructible,
/area/awaymission/vr/murderdome)
"s" = (
/obj/structure/rack,
/obj/item/gun/energy/e_gun/nuclear,
/obj/item/gun/energy/e_gun/nuclear,
/obj/item/gun/energy/e_gun/nuclear,
/obj/item/gun/energy/e_gun/nuclear,
/obj/item/gun/energy/e_gun/nuclear,
/obj/item/gun/energy/e_gun/nuclear,
/obj/item/gun/energy/e_gun/nuclear,
/turf/open/indestructible,
/area/awaymission/vr/murderdome)
"t" = (
/obj/structure/rack,
/obj/item/gun/energy/pulse/carbine,
/obj/item/gun/energy/pulse/carbine,
/obj/item/gun/energy/pulse/carbine,
/obj/item/gun/energy/pulse/carbine,
/obj/item/gun/energy/pulse/carbine,
/obj/item/gun/energy/pulse/carbine,
/obj/item/gun/energy/pulse/carbine,
/obj/item/gun/energy/pulse/carbine,
/obj/item/gun/energy/pulse/carbine,
/obj/item/gun/energy/pulse/carbine,
/turf/open/indestructible,
/area/awaymission/vr/murderdome)
"v" = (
/obj/structure/rack,
/obj/item/gun/ballistic/automatic/shotgun/bulldog/unrestricted,
/obj/item/gun/ballistic/automatic/shotgun/bulldog/unrestricted,
/obj/item/gun/ballistic/automatic/shotgun/bulldog/unrestricted,
/obj/item/gun/ballistic/automatic/shotgun/bulldog/unrestricted,
/obj/item/gun/ballistic/automatic/shotgun/bulldog/unrestricted,
/obj/item/gun/ballistic/automatic/shotgun/bulldog/unrestricted,
/turf/open/indestructible,
/area/awaymission/vr/murderdome)
"w" = (
/obj/machinery/light,
/turf/open/indestructible,
/area/awaymission/vr/murderdome)
"y" = (
/obj/structure/barricade/security/murderdome,
/turf/open/indestructible,
/area/awaymission/vr/murderdome)
"z" = (
/obj/structure/barricade/security/murderdome,
/obj/structure/barricade/security/murderdome,
/turf/open/indestructible,
/area/awaymission/vr/murderdome)
"A" = (
/turf/open/indestructible/sound,
/area/awaymission/vr/murderdome)
"B" = (
/obj/structure/barricade/security/murderdome,
/turf/open/indestructible/sound,
/area/awaymission/vr/murderdome)
"C" = (
/obj/structure/barricade/security/murderdome,
/obj/structure/barricade/security/murderdome,
/turf/open/indestructible/sound,
/area/awaymission/vr/murderdome)
"D" = (
/obj/structure/rack,
/obj/item/gun/ballistic/automatic/wt550,
/obj/item/gun/ballistic/automatic/wt550,
/obj/item/gun/ballistic/automatic/wt550,
/obj/item/gun/ballistic/automatic/wt550,
/obj/item/gun/ballistic/automatic/wt550,
/obj/item/gun/ballistic/automatic/wt550,
/obj/machinery/light,
/turf/open/indestructible,
/area/awaymission/vr/murderdome)
"E" = (
/obj/structure/rack,
/obj/item/gun/ballistic/automatic/ar,
/obj/item/gun/ballistic/automatic/ar,
/obj/item/gun/ballistic/automatic/ar,
/obj/item/gun/ballistic/automatic/ar,
/obj/item/gun/ballistic/automatic/ar,
/turf/open/indestructible,
/area/awaymission/vr/murderdome)
"H" = (
/obj/machinery/telecomms/allinone,
/turf/open/indestructible,
/area/awaymission/vr/murderdome)
"R" = (
/obj/effect/spawner/structure/window/reinforced/indestructable,
/turf/open/indestructible,
/area/awaymission/vr/murderdome)
"W" = (
/obj/effect/vr_clean_master,
/turf/open/indestructible,
/area/awaymission/vr/murderdome)
"Y" = (
/obj/machinery/light{
	dir = 1
	},
/turf/open/indestructible,
/area/awaymission/vr/murderdome)

(1,1,1) = {"
b
b
b
b
b
b
b
b
b
b
b
b
b
b
b
b
b
b
b
b
b
b
b
b
b
b
b
b
b
b
b
b
b
b
b
b
b
b
b
b
b
b
b
b
b
b
b
b
b
b
"}
(2,1,1) = {"
b
c
h
l
p
s
b
j
j
b
j
j
j
j
j
j
j
b
j
j
j
j
j
j
j
b
j
j
j
j
j
j
b
j
j
j
j
j
j
j
b
j
j
b
c
h
l
p
s
b
"}
(3,1,1) = {"
b
d
i
i
j
t
b
j
j
j
j
j
j
R
j
j
j
j
j
j
j
j
j
j
j
A
j
j
j
j
j
j
j
j
j
j
R
j
j
j
j
j
j
b
d
j
i
i
t
b
"}
(4,1,1) = {"
b
e
j
m
j
j
j
j
b
b
Y
j
R
R
R
Y
j
y
y
y
y
y
y
y
y
B
j
j
j
j
j
j
j
j
w
R
R
R
j
w
b
b
j
j
j
j
m
j
D
b
"}
(5,1,1) = {"
b
f
j
n
q
E
b
j
j
j
j
j
j
R
j
j
j
j
j
j
j
j
j
j
j
A
j
j
j
j
j
j
j
j
j
j
R
j
j
j
j
j
j
b
f
q
n
j
E
b
"}
(6,1,1) = {"
b
g
k
o
r
v
b
j
j
b
j
j
j
j
j
j
j
b
j
j
j
j
j
j
j
b
j
j
j
j
j
j
b
j
j
j
j
j
j
j
b
j
j
b
g
k
o
r
v
b
"}
(7,1,1) = {"
b
b
b
b
b
b
b
b
Y
R
j
j
j
j
j
j
j
R
Y
j
j
j
j
j
w
R
Y
j
j
j
j
w
R
j
j
j
j
j
j
j
R
w
b
b
b
b
b
b
b
b
"}
(8,1,1) = {"
b
c
h
l
p
s
b
j
j
b
j
j
j
j
j
j
j
b
j
j
j
j
j
j
j
b
j
j
j
j
j
j
b
j
j
j
j
j
j
j
b
j
j
b
c
h
l
p
s
b
"}
(9,1,1) = {"
b
d
i
i
j
t
b
j
j
j
j
j
j
R
j
j
j
j
j
j
j
j
j
j
j
A
j
j
j
j
j
j
j
j
j
j
R
j
j
j
j
j
j
b
d
j
i
i
t
b
"}
(10,1,1) = {"
b
e
j
m
j
j
j
j
b
b
Y
j
R
R
R
Y
j
j
j
j
j
j
j
j
j
C
y
y
y
y
y
y
y
j
w
R
R
R
j
j
b
b
j
j
j
j
m
j
D
b
"}
(11,1,1) = {"
b
f
j
n
q
E
b
j
j
j
j
j
j
R
j
j
j
j
j
j
j
j
j
j
j
A
j
j
j
j
j
j
j
j
j
j
R
j
j
j
j
j
j
b
f
q
n
j
E
b
"}
(12,1,1) = {"
b
g
k
o
r
v
b
j
j
b
j
j
j
j
j
j
j
b
j
j
j
j
j
j
j
b
j
j
j
j
j
j
b
j
j
j
j
j
j
j
b
j
j
b
g
k
o
r
v
b
"}
(13,1,1) = {"
b
b
b
b
b
b
b
b
Y
R
j
j
j
j
j
j
j
R
Y
j
j
j
j
j
w
R
Y
j
j
j
j
w
R
j
j
j
j
j
j
j
R
w
b
b
b
b
b
b
b
b
"}
(14,1,1) = {"
b
c
h
l
p
s
b
j
j
b
j
j
j
j
j
j
j
b
j
j
j
j
j
j
j
b
j
j
j
j
j
j
b
j
j
j
j
j
j
j
b
j
j
b
c
h
l
p
s
b
"}
(15,1,1) = {"
b
d
i
i
j
t
b
j
j
j
j
j
j
R
j
j
j
j
j
j
j
j
j
j
j
A
j
j
j
j
j
j
j
j
j
j
R
j
j
j
j
j
j
b
d
j
i
i
t
b
"}
(16,1,1) = {"
b
e
j
m
j
j
j
j
b
b
Y
j
R
R
R
Y
j
y
y
z
y
y
y
y
y
B
j
j
j
j
j
j
j
j
w
R
R
R
j
w
b
b
j
j
j
j
m
j
D
b
"}
(17,1,1) = {"
b
f
j
n
q
E
b
j
j
j
j
j
j
R
j
j
j
j
j
j
j
j
j
j
j
A
j
j
j
j
j
j
j
j
j
j
R
j
j
j
j
j
j
b
f
q
n
j
E
b
"}
(18,1,1) = {"
b
g
k
o
r
v
b
j
j
b
j
j
j
j
j
j
j
b
j
j
j
j
j
j
j
b
j
j
j
j
j
j
b
j
j
j
j
j
j
j
b
j
j
b
g
k
o
r
v
b
"}
(19,1,1) = {"
b
b
b
b
b
b
b
b
Y
R
j
j
j
j
j
j
j
R
Y
j
j
j
j
j
w
R
Y
j
j
j
j
w
R
j
j
j
j
j
j
j
R
w
b
b
b
b
b
b
b
b
"}
(20,1,1) = {"
b
c
h
l
p
s
b
j
j
b
j
j
j
j
j
j
j
b
j
j
j
j
j
j
j
b
j
j
j
j
j
j
b
j
j
j
j
j
j
j
b
j
j
b
c
h
l
p
s
b
"}
(21,1,1) = {"
b
d
i
i
j
t
b
j
j
j
j
j
j
R
j
j
j
j
j
j
j
j
j
j
j
A
j
j
j
j
j
j
j
j
j
j
R
j
j
j
j
j
j
b
d
j
i
i
t
b
"}
(22,1,1) = {"
b
e
j
m
j
j
j
j
b
b
Y
j
R
R
R
Y
j
j
j
j
j
W
j
j
j
B
y
y
y
y
y
y
y
j
w
R
R
R
j
w
b
b
j
j
j
j
m
j
D
b
"}
(23,1,1) = {"
b
f
j
n
q
E
b
j
j
j
j
j
j
R
j
j
j
j
j
j
j
j
j
j
j
A
j
j
j
j
j
j
j
j
j
j
R
j
j
j
j
j
j
b
f
q
n
j
E
b
"}
(24,1,1) = {"
b
g
k
o
r
v
b
j
j
b
j
j
j
j
j
j
j
b
j
j
j
j
j
j
j
b
j
j
j
j
j
j
b
j
j
j
j
j
j
j
b
j
j
b
g
k
o
r
v
b
"}
(25,1,1) = {"
b
b
b
b
b
b
b
b
Y
R
j
j
j
j
j
j
j
R
Y
j
j
j
j
j
w
R
Y
j
j
j
j
w
R
j
j
j
j
j
j
j
R
w
b
b
b
b
b
b
b
b
"}
(26,1,1) = {"
b
c
h
l
p
s
b
j
j
b
j
j
j
j
j
j
j
b
j
j
j
j
j
j
j
b
j
j
j
j
j
j
b
j
j
j
j
j
j
j
b
j
j
b
c
h
l
p
s
b
"}
(27,1,1) = {"
b
d
i
i
j
t
b
j
j
j
j
j
j
R
j
j
j
j
j
j
j
j
j
j
j
A
j
j
j
j
j
j
j
j
j
j
R
j
j
j
j
j
j
b
d
j
i
i
t
b
"}
(28,1,1) = {"
b
e
j
m
j
j
j
j
b
b
Y
j
R
R
R
Y
j
y
y
y
y
y
y
y
y
B
j
j
j
j
j
j
j
j
w
R
R
R
j
w
b
b
j
j
j
j
m
j
D
b
"}
(29,1,1) = {"
b
f
j
n
q
E
b
j
j
j
j
j
j
R
j
j
j
j
j
j
j
j
j
j
j
A
j
j
j
j
j
j
j
j
j
j
R
j
j
j
j
j
j
b
f
q
n
j
E
b
"}
(30,1,1) = {"
b
g
k
o
r
v
b
j
j
b
j
j
j
j
j
j
j
b
j
j
j
j
j
j
j
b
j
j
j
j
j
j
b
j
j
j
j
j
j
j
b
j
j
b
g
k
o
r
v
b
"}
(31,1,1) = {"
b
b
b
b
b
b
b
b
Y
R
j
j
j
j
j
j
j
R
Y
j
j
j
j
j
w
R
Y
j
j
j
j
w
R
j
j
j
j
j
j
j
R
w
b
b
b
b
b
b
b
b
"}
(32,1,1) = {"
b
c
h
l
p
s
b
j
j
b
j
j
j
j
j
j
j
b
j
j
j
j
j
j
j
b
j
j
j
j
j
j
b
j
j
j
j
j
j
j
b
j
j
b
c
h
l
p
s
b
"}
(33,1,1) = {"
b
d
i
i
j
t
b
j
j
j
j
j
j
R
j
j
j
j
j
j
j
j
j
j
j
A
j
j
j
j
j
j
j
j
j
j
R
j
j
j
j
j
j
b
d
j
i
i
t
b
"}
(34,1,1) = {"
b
e
j
m
j
j
j
j
b
b
Y
j
R
R
R
Y
j
j
j
j
j
j
j
j
j
B
y
y
y
y
y
y
y
j
w
R
R
R
j
w
b
b
j
j
j
j
m
j
D
b
"}
(35,1,1) = {"
b
f
j
n
q
E
b
j
j
j
j
j
j
R
j
j
j
j
j
j
j
j
j
j
j
A
j
j
j
j
j
j
j
j
j
j
R
j
j
j
j
j
j
b
f
q
n
j
E
b
"}
(36,1,1) = {"
b
g
k
o
r
v
b
j
j
b
j
j
j
j
j
j
j
b
j
j
j
j
j
j
j
b
j
j
j
j
j
j
b
j
j
j
j
j
j
j
b
j
j
b
g
k
o
r
v
b
"}
(37,1,1) = {"
b
b
b
b
b
b
b
b
Y
R
j
j
j
j
j
j
j
R
Y
j
j
j
j
j
w
R
Y
j
j
j
j
w
R
j
j
j
j
j
j
j
R
w
b
b
b
b
b
b
b
b
"}
(38,1,1) = {"
b
c
h
l
p
s
b
j
j
b
j
j
j
j
j
j
j
b
j
j
j
j
j
j
j
b
j
j
j
j
j
j
b
j
j
j
j
j
j
j
b
j
j
b
c
h
l
p
s
b
"}
(39,1,1) = {"
b
d
i
i
j
t
b
j
j
j
j
j
j
R
j
j
j
j
j
j
j
j
j
j
j
A
j
j
j
j
j
j
j
j
j
j
R
j
j
j
j
j
j
b
d
j
i
i
t
b
"}
(40,1,1) = {"
b
e
j
m
j
j
j
j
b
b
Y
j
R
R
R
Y
j
y
y
y
y
y
y
y
y
B
j
j
j
j
j
j
j
j
w
R
R
R
j
w
b
b
j
j
j
j
m
j
D
b
"}
(41,1,1) = {"
b
f
j
j
q
E
b
j
j
j
j
j
j
R
j
j
j
j
j
j
j
j
j
j
j
A
j
j
j
j
j
j
j
j
j
j
R
j
j
j
j
j
j
b
f
q
n
j
E
b
"}
(42,1,1) = {"
b
g
k
o
r
v
b
j
j
b
j
j
j
j
j
j
j
b
j
j
j
j
j
j
j
b
j
j
j
j
j
j
b
j
j
j
j
j
j
j
b
j
j
b
g
k
o
r
v
b
"}
(43,1,1) = {"
b
b
b
b
b
b
b
b
Y
R
j
j
j
j
j
j
j
R
Y
j
j
j
j
j
w
R
Y
j
j
j
j
w
R
j
j
j
j
j
j
j
R
w
b
b
b
b
b
b
b
b
"}
(44,1,1) = {"
b
c
h
l
p
s
b
j
j
b
j
j
j
j
j
j
j
b
j
j
j
j
j
j
j
b
j
j
j
j
j
j
b
j
j
j
j
j
j
j
b
j
j
b
c
h
l
p
s
b
"}
(45,1,1) = {"
b
d
i
i
j
t
b
j
j
j
j
j
j
R
j
j
j
j
j
j
j
j
j
j
j
A
j
j
j
j
j
j
j
j
j
j
R
j
j
j
j
j
j
b
d
j
i
i
t
b
"}
(46,1,1) = {"
b
e
j
m
j
j
j
j
b
b
Y
j
R
R
R
Y
j
j
j
j
j
j
j
j
j
B
y
y
y
y
y
y
y
j
w
R
R
R
j
w
b
b
j
j
j
j
m
j
D
b
"}
(47,1,1) = {"
b
f
j
n
q
E
b
j
j
j
j
j
j
R
j
j
j
j
j
j
j
j
j
j
j
A
j
j
j
j
j
j
j
j
j
j
R
j
j
j
j
j
j
b
f
q
n
j
E
b
"}
(48,1,1) = {"
b
g
k
o
r
v
b
j
j
b
j
j
j
j
j
j
j
b
j
j
j
j
j
j
j
b
j
j
j
j
j
j
b
j
j
j
j
j
j
j
b
j
j
b
g
k
o
r
v
b
"}
(49,1,1) = {"
b
b
b
b
b
b
b
b
b
b
b
b
b
b
b
b
b
b
b
b
b
b
b
b
b
b
b
b
b
b
b
b
b
b
b
b
b
b
b
b
b
b
b
b
b
b
b
b
b
b
"}
(50,1,1) = {"
H
a
a
a
a
a
a
a
a
a
a
a
a
a
a
a
a
a
a
a
a
a
a
a
a
a
a
a
a
a
a
a
a
a
a
a
a
a
a
a
a
a
a
a
a
a
a
a
a
a
"}
