//MAP CONVERTED BY dmm2tgm.py THIS HEADER COMMENT PREVENTS RECONVERSION, DO NOT REMOVE
"a" = (
/turf/open/space/basic,
/area/space)
"t" = (
/obj/docking_port/stationary{
	area_type = /area/sapper_hideout;
	roundstart_template = /datum/map_template/shuttle/sapper/default;
	shuttle_id = "sapper";
	height = 11;
	width = 11;
	dheight = 10;
	dwidth = 5;
	dir = 4
	},
/turf/open/indestructible,
/area/sapper_hideout)
"x" = (
/turf/open/indestructible,
/area/sapper_hideout)
"H" = (
/turf/closed/indestructible/reinforced,
/area/sapper_hideout)

(1,1,1) = {"
a
a
a
a
a
a
a
a
a
a
a
a
a
a
a
a
a
a
a
a
a
a
a
a
a
a
a
a
a
a
"}
(2,1,1) = {"
a
a
a
a
a
a
a
a
a
a
a
a
a
a
a
a
a
a
a
a
a
a
a
a
a
a
a
a
a
a
"}
(3,1,1) = {"
a
a
a
a
a
a
a
a
a
a
a
a
a
a
a
a
a
a
a
a
a
a
a
a
a
a
a
a
a
a
"}
(4,1,1) = {"
a
a
a
a
a
a
a
a
a
a
a
a
a
a
a
a
a
a
a
a
a
a
a
a
a
a
a
a
a
a
"}
(5,1,1) = {"
a
a
a
a
a
a
a
a
a
a
a
a
a
a
a
a
a
a
a
a
a
a
a
a
a
a
a
a
a
a
"}
(6,1,1) = {"
a
a
a
a
a
a
a
a
a
a
a
a
a
a
a
a
a
a
a
a
a
a
a
a
a
a
a
a
a
a
"}
(7,1,1) = {"
a
a
a
a
a
a
a
a
a
a
a
a
a
a
a
a
a
a
a
a
a
a
a
a
a
a
a
a
a
a
"}
(8,1,1) = {"
a
a
a
a
a
a
H
H
H
H
H
H
H
H
H
H
H
H
H
H
H
H
H
H
H
H
H
a
a
a
"}
(9,1,1) = {"
a
a
a
a
a
a
H
x
x
x
x
x
x
x
x
x
x
x
x
x
x
x
x
x
x
x
H
a
a
a
"}
(10,1,1) = {"
a
a
a
a
a
a
H
x
x
x
x
x
x
x
x
x
x
x
x
x
x
x
x
x
x
x
H
a
a
a
"}
(11,1,1) = {"
a
a
a
a
a
a
H
x
x
x
x
x
x
x
x
x
x
x
x
x
x
x
x
x
x
x
H
a
a
a
"}
(12,1,1) = {"
a
a
a
a
a
a
H
x
x
x
x
x
x
x
x
x
x
x
x
x
x
x
x
x
x
x
H
a
a
a
"}
(13,1,1) = {"
a
a
a
a
a
a
H
x
x
x
x
x
x
x
x
x
x
x
x
x
x
x
x
x
x
x
H
a
a
a
"}
(14,1,1) = {"
a
a
a
a
a
a
H
x
x
x
x
x
x
x
x
x
x
x
x
x
x
x
x
x
x
x
H
a
a
a
"}
(15,1,1) = {"
a
a
a
a
a
a
H
x
x
x
x
x
x
x
x
x
x
x
x
x
x
x
x
x
x
x
H
a
a
a
"}
(16,1,1) = {"
a
a
a
a
a
a
H
x
x
x
x
x
x
x
x
x
x
x
x
x
x
x
x
x
x
x
H
a
a
a
"}
(17,1,1) = {"
a
a
a
a
a
a
H
x
x
x
x
x
x
x
x
x
x
x
x
x
x
x
x
x
x
x
H
a
a
a
"}
(18,1,1) = {"
a
a
a
a
a
a
H
x
x
x
x
x
x
x
x
x
x
x
x
x
x
x
x
x
x
x
H
a
a
a
"}
(19,1,1) = {"
a
a
a
a
a
a
H
x
x
x
x
x
x
x
x
x
x
x
x
x
x
x
x
x
x
x
H
a
a
a
"}
(20,1,1) = {"
a
a
a
a
a
a
H
x
x
x
x
x
x
x
x
x
x
x
x
x
x
x
x
x
x
x
H
a
a
a
"}
(21,1,1) = {"
a
a
a
a
a
a
H
x
x
x
x
x
x
x
x
x
t
x
x
x
x
x
x
x
x
x
H
a
a
a
"}
(22,1,1) = {"
a
a
a
a
a
a
H
x
x
x
x
x
x
x
x
x
x
x
x
x
x
x
x
x
x
x
H
a
a
a
"}
(23,1,1) = {"
a
a
a
a
a
a
H
x
x
x
x
x
x
x
x
x
x
x
x
x
x
x
x
x
x
x
H
a
a
a
"}
(24,1,1) = {"
a
a
a
a
a
a
H
x
x
x
x
x
x
x
x
x
x
x
x
x
x
x
x
x
x
x
H
a
a
a
"}
(25,1,1) = {"
a
a
a
a
a
a
H
x
x
x
x
x
x
x
x
x
x
x
x
x
x
x
x
x
x
x
H
a
a
a
"}
(26,1,1) = {"
a
a
a
a
a
a
H
x
x
x
x
x
x
x
x
x
x
x
x
x
x
x
x
x
x
x
H
a
a
a
"}
(27,1,1) = {"
a
a
a
a
a
a
H
x
x
x
x
x
x
x
x
x
x
x
x
x
x
x
x
x
x
x
H
a
a
a
"}
(28,1,1) = {"
a
a
a
a
a
a
H
x
x
x
x
x
x
x
x
x
x
x
x
x
x
x
x
x
x
x
H
a
a
a
"}
(29,1,1) = {"
a
a
a
a
a
a
H
x
x
x
x
x
x
x
x
x
x
x
x
x
x
x
x
x
x
x
H
a
a
a
"}
(30,1,1) = {"
a
a
a
a
a
a
H
x
x
x
x
x
x
x
x
x
x
x
x
x
x
x
x
x
x
x
H
a
a
a
"}
(31,1,1) = {"
a
a
a
a
a
a
H
x
x
x
x
x
x
x
x
x
x
x
x
x
x
x
x
x
x
x
H
a
a
a
"}
(32,1,1) = {"
a
a
a
a
a
a
H
x
x
x
x
x
x
x
x
x
x
x
x
x
x
x
x
x
x
x
H
a
a
a
"}
(33,1,1) = {"
a
a
a
a
a
a
H
x
x
x
x
x
x
x
x
x
x
x
x
x
x
x
x
x
x
x
H
a
a
a
"}
(34,1,1) = {"
a
a
a
a
a
a
H
x
x
x
x
x
x
x
x
x
x
x
x
x
x
x
x
x
x
x
H
a
a
a
"}
(35,1,1) = {"
a
a
a
a
a
a
H
x
x
x
x
x
x
x
x
x
x
x
x
x
x
x
x
x
x
x
H
a
a
a
"}
(36,1,1) = {"
a
a
a
a
a
a
H
H
H
H
H
H
H
H
H
H
H
H
H
H
H
H
H
H
H
H
H
a
a
a
"}
(37,1,1) = {"
a
a
a
a
a
a
a
a
a
a
a
a
a
a
a
a
a
a
a
a
a
a
a
a
a
a
a
a
a
a
"}
(38,1,1) = {"
a
a
a
a
a
a
a
a
a
a
a
a
a
a
a
a
a
a
a
a
a
a
a
a
a
a
a
a
a
a
"}
(39,1,1) = {"
a
a
a
a
a
a
a
a
a
a
a
a
a
a
a
a
a
a
a
a
a
a
a
a
a
a
a
a
a
a
"}
(40,1,1) = {"
a
a
a
a
a
a
a
a
a
a
a
a
a
a
a
a
a
a
a
a
a
a
a
a
a
a
a
a
a
a
"}
