//MAP CONVERTED BY dmm2tgm.py THIS HEADER COMMENT PREVENTS RECONVERSION, DO NOT REMOVE
"a" = (
/turf/template_noop,
/area/template_noop)
"b" = (
/turf/closed/mineral/random/high_chance/wasteland,
/area/overmap_encounter/planetoid/wasteland)
"c" = (
/turf/open/misc/wasteland/lit,
/area/overmap_encounter/planetoid/wasteland)
"d" = (
/obj/structure/stone_tile/block{
	dir = 8
	},
/obj/structure/stone_tile/block{
	dir = 4
	},
/turf/open/misc/dust/lit,
/area/overmap_encounter/planetoid/wasteland)
"e" = (
/obj/structure/stone_tile/block{
	dir = 8
	},
/obj/structure/stone_tile/block/cracked{
	dir = 4
	},
/turf/open/misc/dust/lit,
/area/overmap_encounter/planetoid/wasteland)
"f" = (
/obj/structure/stone_tile/block{
	dir = 4
	},
/obj/structure/stone_tile/block/cracked{
	dir = 8
	},
/turf/open/misc/dust/lit,
/area/overmap_encounter/planetoid/wasteland)
"g" = (
/obj/structure/stone_tile{
	dir = 4
	},
/turf/open/misc/dust/lit,
/area/overmap_encounter/planetoid/wasteland)
"h" = (
/obj/structure/stone_tile{
	dir = 1
	},
/turf/open/misc/dust/lit,
/area/overmap_encounter/planetoid/wasteland)
"i" = (
/obj/structure/stone_tile{
	dir = 8
	},
/obj/structure/stone_tile{
	dir = 1
	},
/obj/structure/stone_tile/cracked,
/turf/open/misc/dust/lit,
/area/overmap_encounter/planetoid/wasteland)
"j" = (
/obj/structure/stone_tile,
/obj/structure/stone_tile{
	dir = 4
	},
/obj/structure/stone_tile/cracked{
	dir = 8
	},
/turf/open/misc/dust/lit,
/area/overmap_encounter/planetoid/wasteland)
"k" = (
/obj/structure/stone_tile/cracked,
/obj/structure/stone_tile{
	dir = 8
	},
/obj/structure/stone_tile{
	dir = 1
	},
/turf/open/misc/dust/lit,
/area/overmap_encounter/planetoid/wasteland)
"l" = (
/obj/structure/stone_tile{
	dir = 8
	},
/obj/structure/stone_tile,
/obj/structure/stone_tile/cracked{
	dir = 4
	},
/turf/open/misc/dust/lit,
/area/overmap_encounter/planetoid/wasteland)
"m" = (
/obj/structure/stone_tile{
	dir = 4
	},
/obj/structure/stone_tile{
	dir = 8
	},
/obj/structure/stone_tile/cracked,
/turf/open/misc/dust/lit,
/area/overmap_encounter/planetoid/wasteland)
"n" = (
/obj/structure/stone_tile/block{
	dir = 8
	},
/obj/structure/stone_tile/block{
	dir = 4
	},
/mob/living/simple_animal/hostile/megafauna/blood_drunk_miner/hunter,
/turf/open/misc/dust/lit,
/area/overmap_encounter/planetoid/wasteland)
"o" = (
/obj/structure/stone_tile/cracked{
	dir = 4
	},
/turf/open/misc/dust/lit,
/area/overmap_encounter/planetoid/wasteland)
"p" = (
/obj/structure/stone_tile{
	dir = 1
	},
/obj/structure/stone_tile/cracked{
	dir = 8
	},
/obj/structure/stone_tile,
/turf/open/misc/dust/lit,
/area/overmap_encounter/planetoid/wasteland)
"q" = (
/obj/structure/stone_tile{
	dir = 4
	},
/obj/structure/stone_tile/cracked,
/obj/structure/stone_tile{
	dir = 8
	},
/turf/open/misc/dust/lit,
/area/overmap_encounter/planetoid/wasteland)
"r" = (
/obj/structure/stone_tile{
	dir = 1
	},
/obj/structure/stone_tile{
	dir = 8
	},
/obj/structure/stone_tile,
/turf/open/misc/dust/lit,
/area/overmap_encounter/planetoid/wasteland)
"s" = (
/obj/structure/stone_tile/surrounding_tile/cracked,
/turf/open/misc/dust/lit,
/area/overmap_encounter/planetoid/wasteland)
"t" = (
/obj/structure/stone_tile/block/cracked,
/turf/open/misc/dust/lit,
/area/overmap_encounter/planetoid/wasteland)
"u" = (
/obj/structure/stone_tile/surrounding_tile{
	dir = 8
	},
/turf/open/misc/dust/lit,
/area/overmap_encounter/planetoid/wasteland)
"v" = (
/obj/structure/stone_tile/surrounding/cracked{
	dir = 6
	},
/obj/structure/stone_tile/center,
/turf/open/misc/dust/lit,
/area/overmap_encounter/planetoid/wasteland)

(1,1,1) = {"
a
a
a
a
a
a
a
a
b
b
b
b
b
a
a
a
"}
(2,1,1) = {"
a
b
b
b
a
a
b
b
b
c
c
b
b
b
a
a
"}
(3,1,1) = {"
b
b
b
b
b
b
b
b
c
g
m
c
c
b
b
a
"}
(4,1,1) = {"
b
c
c
b
b
b
c
c
g
k
h
q
c
c
b
b
"}
(5,1,1) = {"
b
c
c
c
c
c
c
g
i
c
c
h
s
c
c
b
"}
(6,1,1) = {"
b
d
e
e
d
f
d
f
e
d
n
f
t
v
c
b
"}
(7,1,1) = {"
b
c
c
c
c
c
c
h
j
c
c
o
u
c
b
b
"}
(8,1,1) = {"
b
b
b
c
c
c
c
c
h
l
o
r
c
b
b
b
"}
(9,1,1) = {"
a
b
b
b
b
c
c
c
c
h
p
c
c
b
b
a
"}
(10,1,1) = {"
a
a
a
b
b
b
b
b
c
c
c
c
b
b
a
a
"}
(11,1,1) = {"
a
a
a
a
a
b
b
b
b
b
b
b
b
b
a
a
"}
