//MAP CONVERTED BY dmm2tgm.py THIS HEADER COMMENT PREVENTS RECONVERSION, DO NOT REMOVE
"a" = (
/turf/template_noop,
/area/template_noop)
"k" = (
/turf/open/misc/dirt/jungle/wasteland,
/area/overmap_encounter/planetoid/wasteland)
"B" = (
/obj/structure/girder/displaced,
/turf/open/misc/dirt/jungle/wasteland,
/area/overmap_encounter/planetoid/wasteland)
"D" = (
/mob/living/simple_animal/hostile/asteroid/elite/herald{
	desc = "Director?";
	name = "the research director"
	},
/obj/item/gun/energy/e_gun/rdgun,
/obj/item/clothing/suit/toggle/labcoat,
/obj/item/clothing/under/rank/rnd/research_director/skirt,
/obj/item/clothing/shoes/sneakers/brown,
/obj/item/clothing/neck/cloak/rd,
/turf/open/misc/dirt/jungle/wasteland,
/area/overmap_encounter/planetoid/wasteland)
"O" = (
/obj/structure/girder,
/turf/open/misc/dirt/jungle/wasteland,
/area/overmap_encounter/planetoid/wasteland)

(1,1,1) = {"
a
a
a
a
a
a
a
a
a
a
a
a
k
k
a
a
a
a
a
a
a
a
"}
(2,1,1) = {"
a
a
a
a
a
a
a
a
a
a
a
a
k
k
a
a
a
a
k
k
a
a
"}
(3,1,1) = {"
a
a
a
k
a
a
a
a
k
a
a
k
k
k
a
k
k
k
k
k
a
a
"}
(4,1,1) = {"
a
a
a
k
k
k
k
a
k
k
k
k
k
k
a
k
k
k
k
k
a
a
"}
(5,1,1) = {"
a
k
k
k
k
k
k
k
k
k
k
k
k
k
k
k
k
k
a
a
a
a
"}
(6,1,1) = {"
a
a
k
k
k
k
k
k
O
k
k
k
k
B
k
k
k
k
k
a
a
a
"}
(7,1,1) = {"
a
k
k
k
B
k
k
k
k
k
k
k
k
k
k
k
k
k
a
a
a
a
"}
(8,1,1) = {"
k
k
k
k
k
k
k
k
k
k
k
k
k
k
k
k
k
k
a
a
a
a
"}
(9,1,1) = {"
k
k
k
k
k
k
k
k
k
k
k
k
k
k
k
k
k
k
k
k
k
a
"}
(10,1,1) = {"
a
k
k
k
k
k
k
k
k
k
k
k
k
k
k
k
k
k
k
k
a
a
"}
(11,1,1) = {"
a
k
B
k
k
k
k
k
k
k
k
k
k
k
k
k
k
k
k
a
a
a
"}
(12,1,1) = {"
a
a
k
k
k
k
k
k
k
k
k
k
k
k
k
k
k
O
k
a
a
a
"}
(13,1,1) = {"
a
a
k
k
k
k
k
k
k
D
k
k
k
k
k
k
k
k
k
k
a
a
"}
(14,1,1) = {"
a
a
a
k
k
k
k
k
k
k
k
k
k
k
k
k
k
k
k
k
a
a
"}
(15,1,1) = {"
a
a
a
k
k
k
k
k
k
k
k
k
k
k
k
k
k
k
k
k
k
a
"}
(16,1,1) = {"
a
a
k
k
k
k
k
k
k
k
k
k
k
k
k
k
k
k
k
k
k
k
"}
(17,1,1) = {"
a
a
k
k
k
k
k
k
k
k
k
k
k
k
k
k
k
k
k
k
k
k
"}
(18,1,1) = {"
a
a
k
O
k
k
k
k
k
k
k
k
k
k
k
k
k
k
k
k
a
a
"}
(19,1,1) = {"
a
a
k
k
k
k
B
k
k
k
k
k
k
k
k
k
k
k
k
k
k
a
"}
(20,1,1) = {"
a
a
a
a
k
k
k
k
k
k
k
k
k
k
k
k
k
k
O
k
k
a
"}
(21,1,1) = {"
a
a
a
a
k
k
k
k
k
k
k
k
k
k
k
k
k
k
k
k
k
a
"}
(22,1,1) = {"
a
a
a
a
a
a
a
a
k
k
k
k
O
k
k
k
k
k
B
k
k
a
"}
(23,1,1) = {"
a
a
a
a
a
a
a
a
a
k
k
k
k
O
k
k
k
k
k
k
k
a
"}
(24,1,1) = {"
a
a
a
a
a
a
a
a
a
a
k
a
a
k
k
k
a
k
k
k
a
a
"}
(25,1,1) = {"
a
a
a
a
a
a
a
a
a
a
a
a
k
k
k
a
a
k
k
k
a
a
"}
