//MAP CONVERTED BY dmm2tgm.py THIS HEADER COMMENT PREVENTS RECONVERSION, DO NOT REMOVE
"a" = (
/turf/template_noop,
/area/template_noop)
"b" = (
/obj/effect/decal/remains/human,
/turf/open/misc/wasteland/lit,
/area/overmap_encounter/planetoid/wasteland)
"f" = (
/obj/effect/decal/cleanable/blood/tracks{
	dir = 10
	},
/turf/open/misc/wasteland/lit,
/area/overmap_encounter/planetoid/wasteland)
"k" = (
/obj/item/pizzabox,
/turf/open/misc/wasteland/lit,
/area/overmap_encounter/planetoid/wasteland)
"l" = (
/obj/effect/decal/cleanable/blood/tracks{
	dir = 4
	},
/turf/open/misc/wasteland/lit,
/area/overmap_encounter/planetoid/wasteland)
"t" = (
/obj/structure/flora/rock,
/turf/open/misc/wasteland/lit,
/area/overmap_encounter/planetoid/wasteland)
"I" = (
/obj/effect/decal/cleanable/blood/tracks{
	dir = 8
	},
/turf/open/misc/wasteland/lit,
/area/overmap_encounter/planetoid/wasteland)
"M" = (
/obj/item/clothing/neck/tie/red,
/obj/item/clothing/shoes/laceup,
/obj/item/clothing/under/rank/civilian/lawyer/galaxy/red,
/turf/open/misc/wasteland/lit,
/area/overmap_encounter/planetoid/wasteland)
"R" = (
/obj/effect/decal/cleanable/blood/tracks{
	dir = 5
	},
/turf/open/misc/wasteland/lit,
/area/overmap_encounter/planetoid/wasteland)

(1,1,1) = {"
b
a
a
"}
(2,1,1) = {"
M
t
a
"}
(3,1,1) = {"
k
I
a
"}
(4,1,1) = {"
a
l
a
"}
(5,1,1) = {"
a
I
a
"}
(6,1,1) = {"
a
I
a
"}
(7,1,1) = {"
a
l
a
"}
(8,1,1) = {"
a
I
a
"}
(9,1,1) = {"
a
R
f
"}
(10,1,1) = {"
a
a
l
"}
