//MAP CONVERTED BY dmm2tgm.py THIS HEADER COMMENT PREVENTS RECONVERSION, DO NOT REMOVE
"a" = (
/obj/structure/table/wood,
/obj/structure/displaycase/forsale/kitchen{
	pixel_y = 9
	},
/obj/effect/decal/cleanable/dirt,
/obj/machinery/airalarm{
	dir = 1;
	pixel_y = -22
	},
/turf/open/floor/wood,
/area/crew_quarters/bar)
"b" = (
/obj/structure/chair/wood{
	dir = 1;
	pixel_y = 4
	},
/obj/effect/landmark/start/assistant,
/obj/effect/decal/cleanable/dirt,
/turf/open/floor/wood,
/area/crew_quarters/bar)
"c" = (
/obj/structure/cable/yellow{
	icon_state = "4-8"
	},
/obj/machinery/door/airlock/public/glass{
	name = "Bar"
	},
/obj/machinery/atmospherics/pipe/simple/supply/hidden/layer2{
	dir = 4
	},
/obj/machinery/door/firedoor,
/obj/machinery/atmospherics/pipe/simple/scrubbers/hidden/layer4{
	dir = 4
	},
/turf/open/floor/wood,
/area/crew_quarters/bar)
"d" = (
/obj/structure/table/wood,
/obj/machinery/chem_dispenser/drinks{
	dir = 4;
	pixel_y = 4;
	pixel_x = -4
	},
/obj/item/reagent_containers/glass/rag{
	pixel_y = 7;
	pixel_x = 11
	},
/obj/effect/decal/cleanable/dirt,
/turf/open/floor/wood,
/area/crew_quarters/bar)
"e" = (
/obj/machinery/door/firedoor,
/obj/machinery/door/airlock/wood,
/turf/open/floor/wood,
/area/crew_quarters/bar)
"g" = (
/obj/structure/chair/wood{
	dir = 1;
	pixel_x = 2
	},
/obj/effect/decal/cleanable/dirt,
/obj/effect/decal/cleanable/vomit/old{
	pixel_y = 6;
	pixel_x = -8
	},
/obj/effect/decal/cleanable/blood/xtracks{
	pixel_x = -6;
	pixel_y = -12
	},
/turf/open/floor/wood,
/area/crew_quarters/bar)
"i" = (
/obj/machinery/computer/security/telescreen/entertainment{
	pixel_y = 31
	},
/obj/effect/decal/cleanable/dirt,
/obj/effect/decal/cleanable/dirt/dust,
/turf/open/floor/wood,
/area/crew_quarters/bar)
"j" = (
/obj/structure/chair/wood{
	dir = 1;
	pixel_y = 1
	},
/obj/effect/decal/cleanable/ash{
	pixel_y = 4;
	pixel_x = 5
	},
/obj/effect/decal/cleanable/dirt,
/turf/open/floor/wood,
/area/crew_quarters/bar)
"k" = (
/obj/structure/chair/wood{
	dir = 1;
	pixel_x = 3;
	pixel_y = 7
	},
/obj/machinery/newscaster{
	pixel_x = 32;
	pixel_y = 2
	},
/obj/effect/decal/cleanable/ash{
	pixel_y = 10;
	pixel_x = -7
	},
/obj/effect/decal/cleanable/dirt,
/turf/open/floor/wood,
/area/crew_quarters/bar)
"l" = (
/turf/closed/wall,
/area/crew_quarters/bar)
"m" = (
/obj/structure/disposalpipe/trunk{
	dir = 8
	},
/obj/machinery/disposal/bin,
/obj/machinery/light_switch{
	pixel_x = 25
	},
/obj/effect/turf_decal/bot{
	dir = 1
	},
/obj/effect/decal/cleanable/dirt,
/turf/open/floor/wood,
/area/crew_quarters/bar)
"n" = (
/obj/structure/disposalpipe/segment{
	dir = 5
	},
/obj/effect/decal/cleanable/dirt,
/turf/open/floor/wood,
/area/crew_quarters/bar)
"o" = (
/obj/structure/cable/yellow{
	icon_state = "4-8"
	},
/obj/machinery/atmospherics/pipe/simple/scrubbers/hidden/layer4{
	dir = 4
	},
/obj/machinery/atmospherics/pipe/manifold/supply/hidden/layer2,
/obj/effect/decal/cleanable/dirt,
/turf/open/floor/wood,
/area/crew_quarters/bar)
"p" = (
/obj/structure/table/wood,
/obj/machinery/light/small{
	dir = 4
	},
/obj/effect/decal/cleanable/dirt,
/turf/open/floor/wood,
/area/crew_quarters/bar)
"q" = (
/obj/structure/table/wood,
/obj/machinery/light/small/broken{
	dir = 8
	},
/obj/effect/decal/cleanable/dirt,
/turf/open/floor/wood,
/area/crew_quarters/bar)
"t" = (
/obj/structure/chair/wood{
	dir = 1;
	pixel_y = 3
	},
/obj/effect/decal/cleanable/dirt,
/turf/open/floor/wood,
/area/crew_quarters/bar)
"u" = (
/obj/effect/spawner/structure/window/reinforced/tinted,
/turf/open/floor/plating,
/area/crew_quarters/bar)
"v" = (
/obj/effect/decal/cleanable/dirt,
/turf/closed/wall/mineral/wood,
/area/crew_quarters/bar)
"w" = (
/obj/structure/chair/wood{
	pixel_y = 3
	},
/obj/effect/decal/cleanable/dirt,
/turf/open/floor/wood,
/area/crew_quarters/bar)
"x" = (
/obj/machinery/atmospherics/components/unary/vent_scrubber/on/layer4,
/obj/effect/decal/cleanable/dirt,
/turf/open/floor/wood,
/area/crew_quarters/bar)
"y" = (
/obj/structure/chair/wood{
	pixel_x = 4;
	pixel_y = 7
	},
/obj/effect/decal/cleanable/dirt,
/turf/open/floor/wood,
/area/crew_quarters/bar)
"z" = (
/obj/machinery/computer/security/telescreen/entertainment{
	pixel_y = 31
	},
/obj/effect/decal/cleanable/dirt,
/turf/open/floor/wood,
/area/crew_quarters/bar)
"A" = (
/obj/item/chair/wood{
	dir = 1;
	pixel_x = 3;
	pixel_y = 3
	},
/obj/item/clothing/head/hardhat/cakehat{
	pixel_x = -4;
	pixel_y = 6
	},
/obj/effect/decal/cleanable/dirt,
/turf/open/floor/wood,
/area/crew_quarters/bar)
"C" = (
/obj/effect/landmark/event_spawn,
/obj/effect/decal/cleanable/dirt,
/turf/open/floor/wood,
/area/crew_quarters/bar)
"D" = (
/obj/effect/decal/cleanable/dirt,
/obj/effect/decal/cleanable/dirt/dust,
/turf/open/floor/wood,
/area/crew_quarters/bar)
"E" = (
/obj/structure/cable/yellow{
	icon_state = "4-8"
	},
/obj/machinery/door/firedoor,
/obj/machinery/atmospherics/pipe/simple/scrubbers/hidden/layer4{
	dir = 4
	},
/obj/machinery/atmospherics/pipe/simple/supply/hidden/layer2{
	dir = 4
	},
/obj/machinery/door/airlock/wood,
/turf/open/floor/wood,
/area/crew_quarters/bar)
"G" = (
/obj/structure/table/wood,
/obj/item/reagent_containers/food/condiment/saltshaker{
	pixel_x = -2;
	pixel_y = 3
	},
/obj/item/reagent_containers/food/condiment/peppermill{
	pixel_x = -9;
	pixel_y = 10
	},
/obj/effect/decal/cleanable/dirt,
/turf/open/floor/wood,
/area/crew_quarters/bar)
"H" = (
/obj/machinery/smartfridge/drinks{
	icon_state = "boozeomat"
	},
/turf/closed/wall,
/area/crew_quarters/bar)
"I" = (
/obj/structure/table/wood,
/obj/item/book/manual/wiki/barman_recipes{
	pixel_x = 9
	},
/obj/item/flashlight/lamp{
	pixel_x = -2;
	pixel_y = 9
	},
/obj/effect/decal/cleanable/dirt,
/turf/open/floor/wood,
/area/crew_quarters/bar)
"J" = (
/obj/effect/decal/cleanable/dirt,
/turf/open/floor/wood,
/area/crew_quarters/bar)
"K" = (
/mob/living/carbon/monkey/punpun,
/obj/effect/decal/cleanable/dirt,
/turf/open/floor/wood,
/area/crew_quarters/bar)
"L" = (
/obj/effect/landmark/start/bartender,
/obj/effect/decal/cleanable/dirt,
/turf/open/floor/wood,
/area/crew_quarters/bar)
"M" = (
/obj/structure/table/wood,
/obj/machinery/chem_dispenser/drinks/beer{
	dir = 4;
	pixel_x = -5
	},
/obj/item/lighter{
	pixel_x = 8
	},
/obj/effect/decal/cleanable/dirt,
/turf/open/floor/wood,
/area/crew_quarters/bar)
"N" = (
/obj/machinery/door/airlock{
	name = "Bar Access";
	req_access_txt = "25"
	},
/obj/effect/turf_decal/stripes/line{
	dir = 8
	},
/obj/effect/turf_decal/stripes/line{
	dir = 4
	},
/obj/machinery/door/firedoor,
/turf/open/floor/wood,
/area/crew_quarters/bar)
"O" = (
/obj/machinery/door/airlock/public/glass{
	name = "Bar"
	},
/obj/machinery/door/firedoor,
/turf/open/floor/wood,
/area/crew_quarters/bar)
"P" = (
/obj/structure/table/wood,
/obj/effect/decal/cleanable/dirt,
/turf/open/floor/wood,
/area/crew_quarters/bar)
"S" = (
/obj/machinery/atmospherics/components/unary/vent_pump/on/layer2,
/obj/effect/decal/cleanable/dirt,
/turf/open/floor/wood,
/area/crew_quarters/bar)
"T" = (
/obj/structure/cable/yellow{
	icon_state = "4-8"
	},
/obj/machinery/atmospherics/pipe/simple/scrubbers/hidden/layer4{
	dir = 4
	},
/obj/machinery/atmospherics/pipe/simple/supply/hidden/layer2{
	dir = 4
	},
/obj/effect/decal/cleanable/dirt,
/turf/open/floor/wood,
/area/crew_quarters/bar)
"V" = (
/obj/machinery/firealarm{
	dir = 4;
	pixel_x = -26
	},
/obj/machinery/vending/boozeomat,
/turf/closed/wall/mineral/wood,
/area/crew_quarters/bar)
"W" = (
/obj/machinery/door/airlock{
	name = "Bar Storage";
	req_access_txt = "25"
	},
/obj/structure/disposalpipe/segment,
/obj/effect/turf_decal/stripes/line,
/obj/effect/turf_decal/stripes/line{
	dir = 1
	},
/obj/machinery/door/firedoor,
/turf/open/floor/wood,
/area/crew_quarters/bar)
"Y" = (
/obj/item/chair/wood,
/obj/effect/decal/cleanable/dirt,
/obj/effect/decal/cleanable/blood/old,
/turf/open/floor/wood,
/area/crew_quarters/bar)
"Z" = (
/obj/structure/cable/yellow{
	icon_state = "4-8"
	},
/obj/effect/landmark/event_spawn,
/obj/machinery/atmospherics/pipe/simple/supply/hidden/layer2{
	dir = 4
	},
/obj/machinery/atmospherics/pipe/manifold/scrubbers/hidden/layer4,
/obj/effect/decal/cleanable/dirt,
/turf/open/floor/wood,
/area/crew_quarters/bar)

(1,1,1) = {"
l
u
u
l
u
O
c
u
l
"}
(2,1,1) = {"
V
M
d
q
t
J
T
J
a
"}
(3,1,1) = {"
K
C
L
P
g
J
T
D
G
"}
(4,1,1) = {"
I
J
J
P
j
J
T
J
y
"}
(5,1,1) = {"
l
J
J
v
i
x
Z
J
J
"}
(6,1,1) = {"
l
z
D
P
Y
S
o
J
A
"}
(7,1,1) = {"
W
n
L
P
b
J
T
J
J
"}
(8,1,1) = {"
l
m
J
p
k
J
T
J
w
"}
(9,1,1) = {"
l
l
N
H
l
e
E
l
l
"}
