//MAP CONVERTED BY dmm2tgm.py THIS HEADER COMMENT PREVENTS RECONVERSION, DO NOT REMOVE
"a" = (
/turf/open/misc/asteroid/basalt/lava_land_surface/no_ruins,
/area/lavaland/surface/outdoors/virtual_domain)
"c" = (
/turf/template_noop,
/area/virtual_domain/safehouse)
"e" = (
/obj/structure/marker_beacon/cerulean,
/turf/open/misc/asteroid/basalt/lava_land_surface/no_ruins,
/area/lavaland/surface/outdoors/virtual_domain)
"f" = (
/obj/effect/baseturf_helper/virtual_domain,
/turf/template_noop,
/area/virtual_domain/safehouse)
"g" = (
/obj/structure/marker_beacon/lime,
/turf/open/misc/asteroid/basalt/lava_land_surface/no_ruins,
/area/lavaland/surface/outdoors/virtual_domain)
"h" = (
/obj/machinery/light/small/blacklight/directional/south,
/obj/effect/baseturf_helper/virtual_domain,
/turf/open/misc/asteroid/basalt/lava_land_surface/no_ruins,
/area/virtual_domain)
"i" = (
/obj/structure/marker_beacon/jade,
/turf/open/misc/asteroid/basalt/lava_land_surface/no_ruins,
/area/lavaland/surface/outdoors/virtual_domain)
"j" = (
/obj/structure/marker_beacon/teal,
/turf/open/misc/asteroid/basalt/lava_land_surface/no_ruins,
/area/lavaland/surface/outdoors/virtual_domain)
"l" = (
/obj/structure/marker_beacon/bronze,
/turf/open/misc/asteroid/basalt/lava_land_surface/no_ruins,
/area/lavaland/surface/outdoors/virtual_domain)
"p" = (
/obj/effect/baseturf_helper/virtual_domain,
/turf/closed/mineral/volcanic/lava_land_surface,
/area/lavaland/surface/outdoors/virtual_domain)
"q" = (
/mob/living/simple_animal/hostile/megafauna/dragon,
/turf/open/misc/asteroid/basalt/lava_land_surface/no_ruins,
/area/lavaland/surface/outdoors/virtual_domain)
"s" = (
/turf/closed/mineral/volcanic/lava_land_surface,
/area/lavaland/surface/outdoors/virtual_domain)
"u" = (
/turf/closed/indestructible/binary,
/area/virtual_domain/fullbright)
"G" = (
/obj/structure/marker_beacon/purple,
/turf/open/misc/asteroid/basalt/lava_land_surface/no_ruins,
/area/lavaland/surface/outdoors/virtual_domain)
"J" = (
/turf/open/lava/smooth/lava_land_surface,
/area/lavaland/surface/outdoors/virtual_domain)
"L" = (
/obj/modular_map_root/safehouse{
	key = "lavaland_boss"
	},
/turf/template_noop,
/area/virtual_domain/safehouse)
"P" = (
/obj/structure/marker_beacon/fuchsia,
/turf/open/misc/asteroid/basalt/lava_land_surface/no_ruins,
/area/lavaland/surface/outdoors/virtual_domain)
"Z" = (
/obj/effect/mob_spawn/corpse/human/miner,
/turf/open/misc/asteroid/basalt/lava_land_surface/no_ruins,
/area/lavaland/surface/outdoors/virtual_domain)

(1,1,1) = {"
u
u
u
u
u
u
u
u
u
u
u
u
u
u
u
u
u
u
u
u
u
u
u
u
u
u
u
u
u
u
u
u
u
u
u
u
u
u
u
u
u
u
u
u
u
u
"}
(2,1,1) = {"
u
s
s
s
s
s
s
s
s
s
s
s
s
s
s
s
s
s
s
s
s
s
s
s
s
s
s
s
s
s
s
s
s
s
s
s
s
s
s
s
s
s
s
s
p
u
"}
(3,1,1) = {"
u
s
s
s
s
J
J
s
s
J
J
s
s
J
J
J
J
s
s
s
J
J
J
s
s
s
s
s
s
s
s
s
s
J
J
s
s
s
J
J
s
s
J
J
s
u
"}
(4,1,1) = {"
u
s
s
J
J
J
J
J
J
J
J
J
J
J
J
J
J
J
J
J
J
J
J
J
J
J
a
J
J
J
J
J
J
J
J
J
J
J
J
J
J
J
J
J
s
u
"}
(5,1,1) = {"
u
s
s
J
a
J
J
J
J
a
J
J
J
J
a
a
J
J
J
J
J
a
a
J
J
J
J
J
J
J
J
J
J
J
J
J
J
J
J
J
J
J
J
s
s
u
"}
(6,1,1) = {"
u
s
s
J
a
J
J
a
a
a
a
a
a
a
a
a
a
a
a
J
a
a
a
a
a
J
J
J
a
a
J
J
J
a
a
J
a
J
a
a
J
J
J
s
s
u
"}
(7,1,1) = {"
u
s
s
J
J
J
a
a
a
a
a
a
a
a
a
a
a
a
a
a
a
a
a
a
a
a
a
a
a
a
a
a
a
a
a
a
a
a
a
a
a
J
J
J
s
u
"}
(8,1,1) = {"
u
s
s
J
J
J
a
a
a
a
a
a
a
a
a
a
a
a
a
a
a
a
a
a
a
a
a
a
a
a
a
a
a
a
a
a
a
a
a
a
a
J
J
s
s
u
"}
(9,1,1) = {"
u
s
J
J
J
a
a
a
a
a
a
a
a
a
a
a
a
a
a
a
a
a
a
a
a
i
a
a
a
a
a
Z
a
a
a
a
a
a
a
a
a
a
J
J
s
u
"}
(10,1,1) = {"
u
s
J
J
J
a
a
a
a
a
a
G
a
a
a
a
a
a
a
a
a
a
a
a
a
a
a
a
a
a
a
a
a
a
a
a
a
a
a
a
a
a
J
J
s
u
"}
(11,1,1) = {"
u
s
s
J
J
J
a
a
a
a
a
a
a
a
a
a
a
a
a
a
a
a
a
a
a
a
a
a
a
a
a
a
a
a
a
a
a
a
a
a
a
a
J
J
s
u
"}
(12,1,1) = {"
u
s
s
J
J
J
a
a
a
a
a
a
a
a
a
a
a
a
a
a
a
a
a
a
a
a
a
a
a
a
a
a
a
a
a
a
a
a
a
a
a
J
J
J
s
u
"}
(13,1,1) = {"
u
s
s
J
J
a
a
a
a
a
a
a
a
a
a
a
a
g
a
a
a
a
a
a
a
a
a
a
a
a
a
a
a
a
a
a
a
a
a
a
a
a
J
J
s
u
"}
(14,1,1) = {"
u
s
s
J
J
a
a
a
a
a
a
a
a
a
a
a
a
a
a
a
a
a
a
a
a
a
a
a
a
a
a
a
a
a
a
a
a
a
a
a
a
a
J
J
s
u
"}
(15,1,1) = {"
u
s
J
J
J
a
a
a
a
a
a
a
a
a
a
a
a
a
a
a
a
a
a
a
a
a
a
a
a
a
a
a
a
h
c
c
c
c
c
L
a
a
J
J
s
u
"}
(16,1,1) = {"
u
s
J
J
J
J
a
a
a
a
a
a
a
a
a
a
a
a
a
a
a
a
a
a
a
a
a
a
a
a
a
a
a
a
c
c
c
c
c
c
a
a
J
J
s
u
"}
(17,1,1) = {"
u
s
s
J
J
J
a
a
a
a
a
a
a
a
a
a
a
a
a
a
a
a
a
a
a
a
a
a
a
a
a
l
a
a
c
c
c
c
c
c
a
a
J
J
s
u
"}
(18,1,1) = {"
u
s
s
J
J
a
a
a
a
a
a
a
a
q
a
a
a
a
a
a
a
a
a
a
a
a
a
a
a
a
a
a
a
a
c
c
c
c
c
c
a
J
J
s
s
u
"}
(19,1,1) = {"
u
s
J
J
J
a
a
a
a
a
a
a
a
a
a
a
a
a
a
a
a
a
a
a
a
a
a
a
a
a
a
a
a
a
c
c
c
c
c
c
a
a
J
J
s
u
"}
(20,1,1) = {"
u
s
J
J
J
J
a
a
a
a
a
a
a
a
a
a
a
a
a
a
a
a
a
a
a
a
a
a
a
a
a
a
a
a
c
c
c
c
c
c
a
a
J
J
s
u
"}
(21,1,1) = {"
u
s
s
J
J
a
a
a
a
a
a
a
a
a
a
a
a
a
a
a
e
a
a
a
a
a
a
a
a
a
a
a
a
h
c
c
c
c
c
f
a
a
J
s
s
u
"}
(22,1,1) = {"
u
s
s
J
J
a
a
a
a
a
a
a
a
a
a
a
a
a
a
a
a
a
a
a
a
a
a
a
a
a
a
a
a
a
a
a
a
a
a
a
a
a
J
s
s
u
"}
(23,1,1) = {"
u
s
J
J
a
a
a
a
a
a
a
a
a
a
a
a
a
a
a
a
a
a
a
a
a
a
a
a
a
a
a
a
a
a
a
a
a
a
a
a
a
a
J
s
s
u
"}
(24,1,1) = {"
u
s
J
J
a
a
a
a
j
a
a
a
a
a
P
a
a
a
a
a
a
a
a
a
a
a
a
a
a
a
a
a
a
a
a
a
a
a
a
a
a
a
J
J
s
u
"}
(25,1,1) = {"
u
s
s
J
J
a
a
a
a
a
a
a
a
a
a
a
a
a
a
a
a
a
a
a
a
a
a
a
a
a
a
a
a
a
a
a
a
a
a
a
a
J
J
J
s
u
"}
(26,1,1) = {"
u
s
s
J
J
a
a
a
a
a
a
a
a
a
a
a
a
a
a
a
a
a
a
a
a
a
a
a
a
a
a
a
a
a
a
a
a
a
a
a
a
a
J
J
s
u
"}
(27,1,1) = {"
u
s
s
J
J
J
a
a
a
Z
a
a
a
a
a
a
a
a
a
a
a
a
a
a
a
a
a
a
a
a
a
a
a
a
j
a
a
a
a
a
a
a
J
J
s
u
"}
(28,1,1) = {"
u
s
J
J
J
J
a
a
a
a
a
a
a
a
a
a
a
a
a
a
a
a
a
a
a
a
a
a
a
a
a
a
a
a
a
a
a
a
a
a
a
J
J
J
s
u
"}
(29,1,1) = {"
u
s
J
J
J
J
a
a
a
a
a
a
a
a
a
a
a
a
a
a
a
a
a
a
a
a
a
a
a
a
a
a
a
a
a
a
a
a
a
a
a
J
J
s
s
u
"}
(30,1,1) = {"
u
s
s
J
J
J
J
a
a
J
J
J
a
a
a
a
J
J
J
a
a
a
J
J
J
a
a
a
J
J
a
a
a
a
a
a
J
J
a
a
a
J
J
s
s
u
"}
(31,1,1) = {"
u
s
s
a
J
J
J
J
J
J
J
J
J
a
a
J
J
J
J
J
J
J
J
J
J
J
J
J
J
J
J
J
a
a
a
J
J
J
J
J
J
J
J
J
s
u
"}
(32,1,1) = {"
u
s
s
a
J
J
J
J
J
J
J
J
J
J
J
J
J
a
J
J
J
J
J
J
J
J
J
J
J
J
J
J
J
J
J
J
J
J
J
J
J
J
J
J
s
u
"}
(33,1,1) = {"
u
s
s
s
s
s
J
J
s
s
s
s
J
J
s
s
s
s
s
s
J
J
s
s
s
s
J
J
s
s
s
s
J
J
J
s
s
s
s
s
s
J
J
J
s
u
"}
(34,1,1) = {"
u
s
s
s
s
s
s
s
s
s
s
s
s
s
s
s
s
s
s
s
s
s
s
s
s
s
s
s
s
s
s
s
s
s
s
s
s
s
s
s
s
s
s
s
s
u
"}
(35,1,1) = {"
u
u
u
u
u
u
u
u
u
u
u
u
u
u
u
u
u
u
u
u
u
u
u
u
u
u
u
u
u
u
u
u
u
u
u
u
u
u
u
u
u
u
u
u
u
u
"}
