//MAP CONVERTED BY dmm2tgm.py THIS HEADER COMMENT PREVENTS RECONVERSION, DO NOT REMOVE
"a" = (
/turf/open/misc/asteroid/basalt/lava_land_surface/no_ruins,
/area/lavaland/surface/outdoors/virtual_domain)
"b" = (
/obj/structure/stone_tile,
/obj/structure/stone_tile{
	dir = 4
	},
/turf/open/misc/asteroid/basalt/lava_land_surface/no_ruins,
/area/lavaland/surface/outdoors/virtual_domain)
"c" = (
/turf/template_noop,
/area/virtual_domain/safehouse)
"d" = (
/turf/closed/indestructible/binary,
/area/virtual_domain/fullbright)
"f" = (
/obj/structure/stone_tile{
	dir = 1
	},
/obj/structure/stone_tile/block/cracked,
/turf/open/lava/smooth/lava_land_surface,
/area/lavaland/surface/outdoors/virtual_domain)
"h" = (
/obj/machinery/light/small/blacklight/directional/south,
/obj/effect/baseturf_helper/virtual_domain,
/turf/open/misc/asteroid/basalt/lava_land_surface/no_ruins,
/area/virtual_domain)
"i" = (
/obj/structure/stone_tile{
	dir = 4
	},
/obj/structure/stone_tile/cracked,
/turf/open/misc/asteroid/basalt/lava_land_surface/no_ruins,
/area/lavaland/surface/outdoors/virtual_domain)
"j" = (
/obj/structure/marker_beacon/jade,
/turf/open/misc/asteroid/basalt/lava_land_surface/no_ruins,
/area/lavaland/surface/outdoors/virtual_domain)
"k" = (
/obj/structure/stone_tile{
	dir = 8
	},
/turf/open/misc/asteroid/basalt/lava_land_surface/no_ruins,
/area/lavaland/surface/outdoors/virtual_domain)
"l" = (
/obj/structure/stone_tile/block,
/obj/structure/stone_tile/cracked{
	dir = 4
	},
/turf/open/lava/smooth/lava_land_surface,
/area/lavaland/surface/outdoors/virtual_domain)
"m" = (
/obj/structure/marker_beacon/olive,
/turf/open/misc/asteroid/basalt/lava_land_surface/no_ruins,
/area/lavaland/surface/outdoors/virtual_domain)
"n" = (
/obj/structure/marker_beacon/cerulean,
/turf/open/misc/asteroid/basalt/lava_land_surface/no_ruins,
/area/lavaland/surface/outdoors/virtual_domain)
"o" = (
/obj/structure/marker_beacon/yellow,
/turf/open/misc/asteroid/basalt/lava_land_surface/no_ruins,
/area/lavaland/surface/outdoors/virtual_domain)
"q" = (
/obj/effect/baseturf_helper/virtual_domain,
/turf/template_noop,
/area/virtual_domain/safehouse)
"r" = (
/obj/structure/stone_tile/block/cracked{
	dir = 1
	},
/turf/open/misc/asteroid/basalt/lava_land_surface/no_ruins,
/area/lavaland/surface/outdoors/virtual_domain)
"s" = (
/turf/closed/mineral/volcanic/lava_land_surface,
/area/lavaland/surface/outdoors/virtual_domain)
"t" = (
/obj/structure/marker_beacon/indigo,
/turf/open/misc/asteroid/basalt/lava_land_surface/no_ruins,
/area/lavaland/surface/outdoors/virtual_domain)
"u" = (
/obj/structure/stone_tile/cracked,
/turf/open/misc/asteroid/basalt/lava_land_surface/no_ruins,
/area/lavaland/surface/outdoors/virtual_domain)
"w" = (
/obj/structure/stone_tile/block/cracked{
	dir = 4
	},
/turf/open/misc/asteroid/basalt/lava_land_surface/no_ruins,
/area/lavaland/surface/outdoors/virtual_domain)
"x" = (
/obj/structure/stone_tile,
/turf/open/misc/asteroid/basalt/lava_land_surface/no_ruins,
/area/lavaland/surface/outdoors/virtual_domain)
"y" = (
/obj/structure/marker_beacon/violet,
/turf/open/misc/asteroid/basalt/lava_land_surface/no_ruins,
/area/lavaland/surface/outdoors/virtual_domain)
"z" = (
/obj/structure/stone_tile/block,
/turf/open/misc/asteroid/basalt/lava_land_surface/no_ruins,
/area/lavaland/surface/outdoors/virtual_domain)
"A" = (
/obj/structure/stone_tile,
/obj/structure/stone_tile/block/cracked{
	dir = 8
	},
/turf/open/lava/smooth/lava_land_surface,
/area/lavaland/surface/outdoors/virtual_domain)
"C" = (
/obj/effect/mob_spawn/corpse/human/miner,
/turf/open/misc/asteroid/basalt/lava_land_surface/no_ruins,
/area/lavaland/surface/outdoors/virtual_domain)
"D" = (
/obj/effect/baseturf_helper/virtual_domain,
/turf/closed/mineral/volcanic/lava_land_surface,
/area/lavaland/surface/outdoors/virtual_domain)
"G" = (
/obj/structure/stone_tile{
	dir = 4
	},
/turf/open/misc/asteroid/basalt/lava_land_surface/no_ruins,
/area/lavaland/surface/outdoors/virtual_domain)
"H" = (
/obj/structure/stone_tile/cracked{
	dir = 8
	},
/obj/structure/stone_tile{
	dir = 1
	},
/turf/open/misc/asteroid/basalt/lava_land_surface/no_ruins,
/area/lavaland/surface/outdoors/virtual_domain)
"I" = (
/obj/structure/stone_tile/block{
	dir = 4
	},
/turf/open/misc/asteroid/basalt/lava_land_surface/no_ruins,
/area/lavaland/surface/outdoors/virtual_domain)
"J" = (
/turf/open/lava/smooth/lava_land_surface,
/area/lavaland/surface/outdoors/virtual_domain)
"K" = (
/obj/structure/marker_beacon/teal,
/turf/open/misc/asteroid/basalt/lava_land_surface/no_ruins,
/area/lavaland/surface/outdoors/virtual_domain)
"L" = (
/obj/modular_map_root/safehouse{
	key = "lavaland_boss"
	},
/turf/template_noop,
/area/virtual_domain/safehouse)
"O" = (
/obj/structure/stone_tile{
	dir = 8
	},
/obj/structure/stone_tile/block{
	dir = 1
	},
/turf/open/misc/asteroid/basalt/lava_land_surface/no_ruins,
/area/lavaland/surface/outdoors/virtual_domain)
"P" = (
/obj/structure/stone_tile{
	dir = 4
	},
/obj/structure/stone_tile{
	dir = 1
	},
/turf/open/lava/smooth/lava_land_surface,
/area/lavaland/surface/outdoors/virtual_domain)
"S" = (
/obj/structure/stone_tile/surrounding/cracked{
	dir = 6
	},
/mob/living/simple_animal/hostile/megafauna/blood_drunk_miner,
/turf/open/lava/smooth/lava_land_surface,
/area/lavaland/surface/outdoors/virtual_domain)
"T" = (
/obj/structure/stone_tile/block{
	dir = 8
	},
/turf/open/misc/asteroid/basalt/lava_land_surface/no_ruins,
/area/lavaland/surface/outdoors/virtual_domain)
"W" = (
/obj/structure/stone_tile/cracked{
	dir = 8
	},
/turf/open/misc/asteroid/basalt/lava_land_surface/no_ruins,
/area/lavaland/surface/outdoors/virtual_domain)
"X" = (
/obj/structure/stone_tile/cracked{
	dir = 4
	},
/turf/open/misc/asteroid/basalt/lava_land_surface/no_ruins,
/area/lavaland/surface/outdoors/virtual_domain)
"Y" = (
/obj/structure/stone_tile/cracked{
	dir = 1
	},
/turf/open/misc/asteroid/basalt/lava_land_surface/no_ruins,
/area/lavaland/surface/outdoors/virtual_domain)
"Z" = (
/obj/structure/stone_tile/block{
	dir = 1
	},
/turf/open/misc/asteroid/basalt/lava_land_surface/no_ruins,
/area/lavaland/surface/outdoors/virtual_domain)

(1,1,1) = {"
d
d
d
d
d
d
d
d
d
d
d
d
d
d
d
d
d
d
d
d
d
d
d
d
d
d
d
d
d
d
d
d
d
d
d
d
d
d
d
d
d
d
d
d
d
d
"}
(2,1,1) = {"
d
s
s
s
s
s
s
s
s
s
s
s
s
s
s
s
s
s
s
s
s
s
s
s
s
s
s
s
s
s
s
s
s
s
s
s
s
s
s
s
s
s
s
s
D
d
"}
(3,1,1) = {"
d
s
s
s
s
J
J
s
s
J
J
s
s
J
J
J
J
s
s
s
J
J
J
s
s
s
s
s
s
s
s
s
s
J
J
s
s
s
J
J
s
s
J
J
s
d
"}
(4,1,1) = {"
d
s
s
J
J
J
J
J
J
J
J
J
J
J
J
J
J
J
J
J
J
J
J
J
J
J
a
J
J
J
J
J
J
J
J
J
J
J
J
J
J
J
J
J
s
d
"}
(5,1,1) = {"
d
s
s
J
a
J
J
J
J
a
J
J
J
J
a
a
J
J
J
J
J
a
a
J
J
J
J
J
J
J
J
J
J
J
J
J
J
J
J
J
J
J
J
s
s
d
"}
(6,1,1) = {"
d
s
s
J
a
J
J
a
a
a
a
a
a
a
a
a
a
a
a
J
a
a
a
a
a
J
J
J
a
a
J
J
J
a
a
J
a
J
a
a
J
J
J
s
s
d
"}
(7,1,1) = {"
d
s
s
J
J
J
a
a
a
a
a
a
a
a
a
a
a
a
a
a
a
a
a
a
a
a
a
a
a
a
a
a
a
a
a
a
a
a
a
a
a
J
J
J
s
d
"}
(8,1,1) = {"
d
s
s
J
J
J
a
a
a
a
a
a
a
a
a
a
a
a
a
a
a
a
a
a
a
a
a
a
a
a
a
a
a
a
a
a
a
a
a
a
a
J
J
s
s
d
"}
(9,1,1) = {"
d
s
J
J
J
a
a
a
a
a
a
a
a
a
a
a
a
a
a
a
a
a
j
a
a
a
a
a
a
a
a
a
a
a
a
a
a
a
a
a
a
a
J
J
s
d
"}
(10,1,1) = {"
d
s
J
J
J
a
a
a
a
a
a
a
a
a
a
a
a
a
a
a
a
a
a
a
a
a
a
a
a
a
a
t
a
a
a
a
a
a
a
a
a
a
J
J
s
d
"}
(11,1,1) = {"
d
s
s
J
J
J
a
a
a
y
a
a
a
a
a
a
a
a
a
a
a
a
a
a
a
a
a
a
a
a
a
a
a
a
a
a
a
a
a
a
a
a
J
J
s
d
"}
(12,1,1) = {"
d
s
s
J
J
J
a
a
a
a
a
a
a
a
a
a
a
a
C
a
a
a
a
a
a
a
a
a
a
a
a
a
a
a
a
a
a
a
a
a
a
J
J
J
s
d
"}
(13,1,1) = {"
d
s
s
J
J
a
a
a
a
a
a
a
a
a
a
a
a
a
a
a
a
a
a
a
a
a
a
a
a
a
a
a
a
a
a
a
a
a
a
a
a
a
J
J
s
d
"}
(14,1,1) = {"
d
s
s
J
J
a
a
a
a
a
a
a
a
a
a
T
a
a
a
a
a
a
a
a
a
a
a
a
a
a
a
a
a
a
a
a
a
a
a
a
a
a
J
J
s
d
"}
(15,1,1) = {"
d
s
J
J
J
a
a
a
a
a
a
a
a
a
a
X
z
a
a
a
a
a
a
a
a
a
a
a
a
a
a
a
a
h
c
c
c
c
c
L
a
a
J
J
s
d
"}
(16,1,1) = {"
d
s
J
J
J
J
a
a
a
a
a
a
a
T
W
a
r
a
i
a
a
a
a
a
a
a
a
a
a
a
a
a
a
a
c
c
c
c
c
c
a
a
J
J
s
d
"}
(17,1,1) = {"
d
s
s
J
J
J
a
a
a
a
a
a
a
a
I
b
k
l
x
a
T
k
a
a
a
m
a
a
a
a
a
o
a
a
c
c
c
c
c
c
a
a
J
J
s
d
"}
(18,1,1) = {"
d
s
s
J
J
a
a
a
a
a
a
a
a
a
a
a
P
S
A
O
u
r
k
a
a
a
a
a
a
a
a
a
a
a
c
c
c
c
c
c
a
J
J
s
s
d
"}
(19,1,1) = {"
d
s
J
J
J
a
a
a
a
a
a
a
a
k
G
H
x
f
k
a
Y
T
u
a
a
a
a
a
a
a
a
a
a
a
c
c
c
c
c
c
a
a
J
J
s
d
"}
(20,1,1) = {"
d
s
J
J
J
J
a
a
a
a
a
a
a
Y
x
a
Z
a
z
a
a
a
a
a
a
a
a
a
a
a
a
a
a
a
c
c
c
c
c
c
a
a
J
J
s
d
"}
(21,1,1) = {"
d
s
s
J
J
a
a
a
a
a
a
a
a
a
a
a
z
a
a
a
a
a
a
a
a
a
a
a
a
a
a
a
a
h
c
c
c
c
c
q
a
a
J
s
s
d
"}
(22,1,1) = {"
d
s
s
J
J
a
a
a
a
a
a
a
a
a
a
w
a
a
a
a
a
a
a
a
a
a
a
a
a
a
a
a
a
a
a
a
a
a
a
a
a
a
J
s
s
d
"}
(23,1,1) = {"
d
s
J
J
a
a
a
a
a
a
n
a
a
a
a
a
a
a
a
a
a
a
a
a
a
a
a
a
a
a
a
a
a
a
a
a
a
a
a
a
a
a
J
s
s
d
"}
(24,1,1) = {"
d
s
J
J
a
a
a
a
a
a
a
a
a
a
a
a
a
a
a
a
a
a
a
a
a
a
a
a
a
a
a
a
a
a
a
a
C
a
a
a
a
a
J
J
s
d
"}
(25,1,1) = {"
d
s
s
J
J
a
a
a
a
a
a
a
a
a
a
a
a
a
a
a
a
a
a
a
a
a
a
a
a
a
a
a
a
a
a
a
a
a
a
a
a
J
J
J
s
d
"}
(26,1,1) = {"
d
s
s
J
J
a
a
a
a
a
a
a
a
a
a
a
a
a
a
a
a
a
K
a
a
a
a
a
a
a
a
a
a
a
a
a
a
a
a
a
a
a
J
J
s
d
"}
(27,1,1) = {"
d
s
s
J
J
J
a
a
a
a
a
a
a
a
a
a
a
a
a
a
a
a
a
a
a
a
a
a
a
a
a
a
j
a
a
a
a
a
a
a
a
a
J
J
s
d
"}
(28,1,1) = {"
d
s
J
J
J
J
a
a
a
a
a
a
a
a
a
a
a
a
a
a
a
a
a
a
a
a
a
a
a
a
a
a
a
a
a
a
a
a
a
a
a
J
J
J
s
d
"}
(29,1,1) = {"
d
s
J
J
J
J
a
a
a
a
a
a
a
a
a
a
a
a
a
a
a
a
a
a
a
a
a
a
a
a
a
a
a
a
a
a
a
a
a
a
a
J
J
s
s
d
"}
(30,1,1) = {"
d
s
s
J
J
J
J
a
a
J
J
J
a
a
a
a
J
J
J
a
a
a
J
J
J
a
a
a
J
J
a
a
a
a
a
a
J
J
a
a
a
J
J
s
s
d
"}
(31,1,1) = {"
d
s
s
a
J
J
J
J
J
J
J
J
J
a
a
J
J
J
J
J
J
J
J
J
J
J
J
J
J
J
J
J
a
a
a
J
J
J
J
J
J
J
J
J
s
d
"}
(32,1,1) = {"
d
s
s
a
J
J
J
J
J
J
J
J
J
J
J
J
J
a
J
J
J
J
J
J
J
J
J
J
J
J
J
J
J
J
J
J
J
J
J
J
J
J
J
J
s
d
"}
(33,1,1) = {"
d
s
s
s
s
s
J
J
s
s
s
s
J
J
s
s
s
s
s
s
J
J
s
s
s
s
J
J
s
s
s
s
J
J
J
s
s
s
s
s
s
J
J
J
s
d
"}
(34,1,1) = {"
d
s
s
s
s
s
s
s
s
s
s
s
s
s
s
s
s
s
s
s
s
s
s
s
s
s
s
s
s
s
s
s
s
s
s
s
s
s
s
s
s
s
s
s
s
d
"}
(35,1,1) = {"
d
d
d
d
d
d
d
d
d
d
d
d
d
d
d
d
d
d
d
d
d
d
d
d
d
d
d
d
d
d
d
d
d
d
d
d
d
d
d
d
d
d
d
d
d
d
"}
