//MAP CONVERTED BY dmm2tgm.py THIS HEADER COMMENT PREVENTS RECONVERSION, DO NOT REMOVE
"a" = (
/turf/open/misc/asteroid/basalt/lava_land_surface/no_ruins,
/area/lavaland/surface/outdoors/virtual_domain)
"c" = (
/turf/template_noop,
/area/template_noop)
"h" = (
/obj/machinery/light/small/blacklight/directional/south,
/turf/open/misc/asteroid/basalt/lava_land_surface/no_ruins,
/area/lavaland/surface/outdoors/virtual_domain)
"m" = (
/obj/structure/marker_beacon/lime,
/turf/open/misc/asteroid/basalt/lava_land_surface/no_ruins,
/area/lavaland/surface/outdoors/virtual_domain)
"s" = (
/turf/closed/mineral/volcanic/lava_land_surface,
/area/lavaland/surface/outdoors/virtual_domain)
"v" = (
/turf/closed/indestructible/binary,
/area/lavaland/surface/outdoors/virtual_domain)
"E" = (
/obj/structure/marker_beacon/burgundy,
/turf/open/misc/asteroid/basalt/lava_land_surface/no_ruins,
/area/lavaland/surface/outdoors/virtual_domain)
"J" = (
/turf/open/lava/smooth/lava_land_surface,
/area/lavaland/surface/outdoors/virtual_domain)
"K" = (
/obj/structure/marker_beacon/bronze,
/turf/open/misc/asteroid/basalt/lava_land_surface/no_ruins,
/area/lavaland/surface/outdoors/virtual_domain)
"L" = (
/turf/template_noop,
/area/virtual_domain/safehouse/bottom_left)
"S" = (
/obj/effect/mob_spawn/corpse/human/miner,
/turf/open/misc/asteroid/basalt/lava_land_surface/no_ruins,
/area/lavaland/surface/outdoors/virtual_domain)
"W" = (
/mob/living/simple_animal/hostile/megafauna/bubblegum/virtual_domain,
/turf/open/misc/asteroid/basalt/lava_land_surface/no_ruins,
/area/lavaland/surface/outdoors/virtual_domain)

(1,1,1) = {"
v
v
v
v
v
v
v
v
v
v
v
v
v
v
v
v
v
v
v
v
v
v
v
v
v
v
v
v
v
v
v
v
v
v
v
v
v
v
v
v
v
v
v
v
v
v
"}
(2,1,1) = {"
v
s
s
s
s
s
s
s
s
s
s
s
s
s
s
s
s
s
s
s
s
s
s
s
s
s
s
s
s
s
s
s
s
s
s
s
s
s
s
s
s
s
s
s
s
v
"}
(3,1,1) = {"
v
s
s
s
s
J
J
s
s
J
J
s
s
J
J
J
J
s
s
s
J
J
J
s
s
s
s
s
s
s
s
s
s
J
J
s
s
s
J
J
s
s
J
J
s
v
"}
(4,1,1) = {"
v
s
s
J
J
J
J
J
J
J
J
J
J
J
J
J
J
J
J
J
J
J
J
J
J
J
a
J
J
J
J
J
J
J
J
J
J
J
J
J
J
J
J
J
s
v
"}
(5,1,1) = {"
v
s
s
J
a
J
J
J
J
a
J
J
J
J
a
a
J
J
J
J
J
a
a
J
J
J
J
J
J
J
J
J
J
J
J
J
J
J
J
J
J
J
J
s
s
v
"}
(6,1,1) = {"
v
s
s
J
a
J
J
a
a
a
a
a
a
a
a
a
a
a
a
J
a
a
a
a
a
J
J
J
a
a
J
J
J
a
a
J
a
J
a
a
J
J
J
s
s
v
"}
(7,1,1) = {"
v
s
s
J
J
J
a
a
a
a
a
a
a
a
a
a
a
a
a
a
a
a
a
a
a
a
a
a
a
a
a
a
a
a
a
a
a
a
a
a
a
J
J
J
s
v
"}
(8,1,1) = {"
v
s
s
J
J
J
a
a
a
a
a
a
a
a
a
a
a
a
a
a
a
a
a
a
a
a
a
a
a
a
a
a
a
a
a
a
a
a
a
a
a
J
J
s
s
v
"}
(9,1,1) = {"
v
s
J
J
J
a
a
a
a
a
a
a
a
a
a
a
a
a
a
a
a
a
a
a
a
a
a
a
a
a
a
a
a
a
a
a
a
a
S
a
a
a
J
J
s
v
"}
(10,1,1) = {"
v
s
J
J
J
a
a
a
a
a
a
a
a
a
a
a
a
a
a
a
K
a
a
a
a
a
a
a
a
a
a
a
a
a
a
a
a
a
a
a
a
a
J
J
s
v
"}
(11,1,1) = {"
v
s
s
J
J
J
a
a
a
a
a
a
a
a
a
a
a
a
a
a
a
a
a
a
a
a
a
a
a
a
a
a
a
a
a
a
a
a
a
a
a
a
J
J
s
v
"}
(12,1,1) = {"
v
s
s
J
J
J
a
a
a
a
a
a
a
a
a
a
a
a
a
a
a
a
a
a
a
a
a
a
a
a
a
a
a
a
a
a
a
a
a
a
a
J
J
J
s
v
"}
(13,1,1) = {"
v
s
s
J
J
a
a
a
a
a
a
a
a
a
a
a
a
a
a
a
a
a
a
a
a
a
a
a
a
a
a
a
a
a
a
a
a
a
a
a
a
a
J
J
s
v
"}
(14,1,1) = {"
v
s
s
J
J
a
a
a
a
a
a
a
a
a
a
a
a
a
a
a
a
a
a
a
a
a
a
a
a
a
a
a
a
a
a
a
a
a
a
a
a
a
J
J
s
v
"}
(15,1,1) = {"
v
s
J
J
J
a
a
a
a
a
a
a
a
a
a
a
a
a
a
a
a
a
a
a
a
a
a
a
a
a
a
a
a
h
c
c
c
c
c
L
a
a
J
J
s
v
"}
(16,1,1) = {"
v
s
J
J
J
J
a
a
a
a
a
a
a
a
a
a
a
a
a
a
a
a
a
a
a
a
a
a
a
a
a
a
a
a
c
c
c
c
c
c
a
a
J
J
s
v
"}
(17,1,1) = {"
v
s
s
J
J
J
a
a
a
a
a
a
a
a
a
a
a
a
W
a
a
a
a
a
a
a
a
a
a
a
a
a
a
a
c
c
c
c
c
c
a
a
J
J
s
v
"}
(18,1,1) = {"
v
s
s
J
J
a
a
a
a
a
a
a
a
a
a
a
a
a
a
a
a
a
a
a
a
a
a
a
a
a
a
m
a
a
c
c
c
c
c
c
a
J
J
s
s
v
"}
(19,1,1) = {"
v
s
J
J
J
a
a
a
a
a
a
a
a
a
a
a
a
a
a
a
a
a
a
a
a
a
a
a
a
a
a
a
a
a
c
c
c
c
c
c
a
a
J
J
s
v
"}
(20,1,1) = {"
v
s
J
J
J
J
a
a
a
a
a
a
a
a
a
a
a
a
a
a
a
a
a
a
a
a
a
a
a
a
a
a
a
a
c
c
c
c
c
c
a
a
J
J
s
v
"}
(21,1,1) = {"
v
s
s
J
J
a
a
a
a
a
a
a
a
a
a
a
a
a
a
a
a
a
a
a
a
a
a
a
a
a
a
a
a
h
c
c
c
c
c
c
a
a
J
s
s
v
"}
(22,1,1) = {"
v
s
s
J
J
a
a
a
a
a
a
E
a
a
a
a
a
a
a
a
a
a
a
a
a
a
a
a
a
a
a
a
a
a
a
a
a
a
a
a
a
a
J
s
s
v
"}
(23,1,1) = {"
v
s
J
J
a
a
a
a
a
a
a
a
a
a
a
a
a
a
a
a
a
a
a
a
a
a
a
a
a
a
a
a
a
a
a
a
a
a
a
a
a
a
J
s
s
v
"}
(24,1,1) = {"
v
s
J
J
a
a
a
a
a
a
a
a
a
a
a
a
a
a
a
a
a
a
a
a
a
a
a
a
a
a
a
a
a
a
a
a
a
a
a
a
a
a
J
J
s
v
"}
(25,1,1) = {"
v
s
s
J
J
a
a
a
a
a
a
a
a
a
a
a
a
a
a
a
a
a
a
a
a
a
a
a
a
a
a
a
a
a
a
a
a
a
a
a
a
J
J
J
s
v
"}
(26,1,1) = {"
v
s
s
J
J
a
a
a
a
a
a
a
a
a
a
a
a
a
a
a
a
a
a
a
a
a
a
a
a
a
a
a
a
a
a
a
a
S
a
a
a
a
J
J
s
v
"}
(27,1,1) = {"
v
s
s
J
J
J
a
a
a
a
a
a
a
a
a
a
a
a
a
a
a
a
a
a
a
a
a
a
a
a
a
a
a
a
a
a
a
a
a
a
a
a
J
J
s
v
"}
(28,1,1) = {"
v
s
J
J
J
J
a
a
a
a
a
a
a
a
a
a
a
a
a
a
a
a
a
a
a
a
a
a
a
a
a
a
a
a
a
a
a
a
a
a
a
J
J
J
s
v
"}
(29,1,1) = {"
v
s
J
J
J
J
a
a
a
a
a
a
a
a
a
a
a
a
a
a
a
a
a
a
a
a
a
a
a
a
a
a
a
a
a
a
a
a
a
a
a
J
J
s
s
v
"}
(30,1,1) = {"
v
s
s
J
J
J
J
a
a
J
J
J
a
a
a
a
J
J
J
a
a
a
J
J
J
a
a
a
J
J
a
a
a
a
a
a
J
J
a
a
a
J
J
s
s
v
"}
(31,1,1) = {"
v
s
s
a
J
J
J
J
J
J
J
J
J
a
a
J
J
J
J
J
J
J
J
J
J
J
J
J
J
J
J
J
a
a
a
J
J
J
J
J
J
J
J
J
s
v
"}
(32,1,1) = {"
v
s
s
a
J
J
J
J
J
J
J
J
J
J
J
J
J
a
J
J
J
J
J
J
J
J
J
J
J
J
J
J
J
J
J
J
J
J
J
J
J
J
J
J
s
v
"}
(33,1,1) = {"
v
s
s
s
s
s
J
J
s
s
s
s
J
J
s
s
s
s
s
s
J
J
s
s
s
s
J
J
s
s
s
s
J
J
J
s
s
s
s
s
s
J
J
J
s
v
"}
(34,1,1) = {"
v
s
s
s
s
s
s
s
s
s
s
s
s
s
s
s
s
s
s
s
s
s
s
s
s
s
s
s
s
s
s
s
s
s
s
s
s
s
s
s
s
s
s
s
s
v
"}
(35,1,1) = {"
v
v
v
v
v
v
v
v
v
v
v
v
v
v
v
v
v
v
v
v
v
v
v
v
v
v
v
v
v
v
v
v
v
v
v
v
v
v
v
v
v
v
v
v
v
v
"}
