//MAP CONVERTED BY dmm2tgm.py THIS HEADER COMMENT PREVENTS RECONVERSION, DO NOT REMOVE
"a" = (
/turf/closed/indestructible/binary,
/area/virtual_domain)
"b" = (
/obj/machinery/light/directional/west,
/turf/open/floor/iron,
/area/virtual_domain)
"c" = (
/turf/open/floor/catwalk_floor/iron,
/area/virtual_domain)
"d" = (
/turf/closed/wall,
/area/virtual_domain)
"f" = (
/obj/modular_map_root/virtual_domain{
	key = "station_medium"
	},
/turf/open/floor/plating,
/area/virtual_domain)
"g" = (
/obj/machinery/light/directional/south,
/turf/open/floor/iron,
/area/virtual_domain)
"i" = (
/obj/effect/landmark/bitrunning/safehouse_spawn,
/turf/template_noop,
/area/virtual_domain/safehouse)
"j" = (
/obj/modular_map_root,
/obj/modular_map_root/virtual_domain{
	key = "station_medium"
	},
/obj/machinery/light/small/directional/west,
/turf/open/floor/catwalk_floor/iron,
/area/virtual_domain)
"l" = (
/obj/effect/landmark/bitrunning/mob_segment,
/turf/open/floor/iron,
/area/virtual_domain)
"o" = (
/obj/effect/spawner/structure/window/reinforced,
/turf/open/floor/plating,
/area/virtual_domain)
"p" = (
/turf/open/space,
/area/virtual_domain)
"r" = (
/turf/template_noop,
/area/virtual_domain/safehouse)
"s" = (
/turf/open/floor/plating,
/area/virtual_domain)
"t" = (
/turf/open/floor/iron,
/area/virtual_domain)
"u" = (
/obj/machinery/light/small/directional/north,
/turf/open/floor/catwalk_floor/iron,
/area/virtual_domain)
"x" = (
/obj/machinery/light/small/directional/east,
/turf/open/floor/plating,
/area/virtual_domain)
"y" = (
/obj/machinery/light/directional/east,
/turf/open/floor/iron,
/area/virtual_domain)
"B" = (
/obj/modular_map_root/virtual_domain{
	key = "station_medium"
	},
/obj/machinery/light/small/directional/west,
/turf/open/floor/catwalk_floor/iron,
/area/virtual_domain)
"C" = (
/obj/effect/baseturf_helper/virtual_domain,
/turf/template_noop,
/area/virtual_domain/safehouse)
"E" = (
/obj/modular_map_root/virtual_domain{
	key = "station_medium"
	},
/turf/open/floor/iron,
/area/virtual_domain)
"F" = (
/obj/machinery/light/small/directional/south,
/turf/open/floor/plating,
/area/virtual_domain)
"G" = (
/obj/structure/lattice,
/turf/open/space,
/area/virtual_domain)
"H" = (
/obj/effect/baseturf_helper/virtual_domain,
/turf/closed/indestructible/binary,
/area/virtual_domain)
"M" = (
/obj/machinery/light/directional/north,
/turf/open/floor/iron,
/area/virtual_domain)
"Q" = (
/obj/effect/landmark/bitrunning/mob_segment,
/obj/effect/landmark/bitrunning/cache_spawn,
/turf/open/floor/plating,
/area/virtual_domain)
"R" = (
/obj/machinery/light/small/directional/east,
/turf/open/floor/catwalk_floor/iron,
/area/virtual_domain)
"U" = (
/obj/machinery/light/small/directional/west,
/turf/open/floor/plating,
/area/virtual_domain)

(1,1,1) = {"
a
a
a
a
a
a
a
a
a
a
a
a
a
a
a
a
a
a
a
a
a
a
a
a
a
a
a
a
a
a
a
H
"}
(2,1,1) = {"
a
d
d
d
d
d
d
d
d
d
d
d
d
d
d
d
d
d
d
d
d
d
d
d
d
d
d
d
d
d
d
a
"}
(3,1,1) = {"
a
d
c
c
c
c
c
c
c
c
B
c
c
c
c
c
c
c
j
c
c
c
c
c
c
c
B
c
c
c
d
a
"}
(4,1,1) = {"
a
d
c
s
s
s
s
s
s
s
s
s
s
s
s
s
s
s
s
s
s
s
s
s
s
s
s
s
s
c
d
a
"}
(5,1,1) = {"
a
d
c
s
s
s
s
s
s
s
s
s
s
s
s
s
s
s
s
s
s
s
s
s
s
s
s
s
s
c
d
a
"}
(6,1,1) = {"
a
d
c
s
s
Q
s
s
s
s
s
s
s
Q
s
s
s
s
s
s
s
s
Q
s
s
s
s
s
s
c
d
a
"}
(7,1,1) = {"
a
d
c
s
s
s
s
s
s
s
s
s
s
s
s
s
s
s
s
s
s
s
s
s
s
s
s
s
s
c
d
a
"}
(8,1,1) = {"
a
d
c
s
s
s
s
s
s
s
s
s
s
s
s
s
s
s
s
s
s
s
s
s
s
s
s
s
s
c
d
a
"}
(9,1,1) = {"
a
d
c
s
s
s
s
s
s
s
s
s
s
s
s
s
s
s
s
s
s
s
s
s
s
s
s
s
s
c
d
a
"}
(10,1,1) = {"
a
d
c
s
s
s
s
s
s
s
s
s
s
s
s
s
s
s
s
s
s
s
s
s
s
s
s
s
s
c
c
a
"}
(11,1,1) = {"
a
d
u
s
s
s
s
s
s
s
s
s
s
s
s
s
s
s
s
s
s
s
s
s
s
s
s
s
s
s
c
a
"}
(12,1,1) = {"
a
d
c
s
s
s
s
s
s
s
E
t
t
t
t
t
t
t
t
t
t
s
s
s
s
s
s
s
s
x
c
a
"}
(13,1,1) = {"
a
d
c
s
s
s
s
s
s
s
t
t
y
t
t
t
t
t
y
t
t
s
s
F
r
r
r
r
r
i
c
a
"}
(14,1,1) = {"
a
d
c
s
s
s
s
s
s
s
t
g
d
o
o
o
o
o
d
M
t
s
s
s
r
r
r
r
r
r
c
a
"}
(15,1,1) = {"
a
d
c
s
s
s
s
s
s
s
t
t
o
G
G
G
G
G
o
t
t
s
s
s
r
r
r
r
r
r
c
a
"}
(16,1,1) = {"
a
d
c
s
s
s
Q
s
s
s
t
l
o
p
p
p
p
p
o
t
t
s
s
s
r
r
r
r
r
r
c
a
"}
(17,1,1) = {"
a
d
c
s
s
s
s
s
s
s
t
t
o
G
G
G
G
G
o
t
t
s
s
s
r
r
r
r
r
r
c
a
"}
(18,1,1) = {"
a
d
c
s
s
s
s
s
s
s
t
g
d
o
o
o
o
o
d
M
t
s
s
s
r
r
r
r
r
r
c
a
"}
(19,1,1) = {"
a
d
c
s
s
s
s
s
s
s
t
t
b
t
t
t
t
t
b
t
t
s
s
F
r
r
r
r
r
C
c
a
"}
(20,1,1) = {"
a
d
c
s
s
s
s
s
s
s
t
t
t
t
t
t
t
t
t
t
t
s
s
s
s
s
s
s
s
U
c
a
"}
(21,1,1) = {"
a
d
u
s
s
s
s
s
s
s
s
s
s
s
s
s
s
s
s
s
s
s
s
s
s
s
s
s
s
s
c
a
"}
(22,1,1) = {"
a
d
c
s
s
s
s
s
s
s
f
s
s
s
s
s
s
s
f
s
s
s
s
s
s
s
f
s
s
c
c
a
"}
(23,1,1) = {"
a
d
c
s
s
s
s
s
s
s
s
s
s
s
s
s
s
s
s
s
s
s
s
s
s
s
s
s
s
c
d
a
"}
(24,1,1) = {"
a
d
c
s
s
s
s
s
s
s
s
s
s
s
s
s
s
s
s
s
s
s
s
s
s
s
s
s
s
c
d
a
"}
(25,1,1) = {"
a
d
c
s
s
s
s
s
s
s
s
s
s
s
s
s
s
s
s
s
s
s
s
s
s
s
s
s
s
c
d
a
"}
(26,1,1) = {"
a
d
c
s
s
s
Q
s
s
s
s
s
s
s
s
Q
s
s
s
s
s
s
Q
s
s
s
s
s
s
c
d
a
"}
(27,1,1) = {"
a
d
c
s
s
s
s
s
s
s
s
s
s
s
s
s
s
s
s
s
s
s
s
s
s
s
s
s
s
c
d
a
"}
(28,1,1) = {"
a
d
c
s
s
s
s
s
s
s
s
s
s
s
s
s
s
s
s
s
s
s
s
s
s
s
s
s
s
c
d
a
"}
(29,1,1) = {"
a
d
c
s
s
s
s
s
s
s
s
s
s
s
s
s
s
s
s
s
s
s
s
s
s
s
s
s
s
c
d
a
"}
(30,1,1) = {"
a
d
c
c
c
c
c
c
c
c
R
c
c
c
c
c
c
c
R
c
c
c
c
c
c
c
R
c
c
c
d
a
"}
(31,1,1) = {"
a
d
d
d
d
d
d
d
d
d
d
d
d
d
d
d
d
d
d
d
d
d
d
d
d
d
d
d
d
d
d
a
"}
(32,1,1) = {"
a
a
a
a
a
a
a
a
a
a
a
a
a
a
a
a
a
a
a
a
a
a
a
a
a
a
a
a
a
a
a
a
"}
