//MAP CONVERTED BY dmm2tgm.py THIS HEADER COMMENT PREVENTS RECONVERSION, DO NOT REMOVE
"da" = (
/obj/structure/table/wood,
/obj/effect/turf_decal/siding/dark,
/obj/effect/turf_decal/siding/dark{
	dir = 1
	},
/obj/item/clothing/head/costume/party/festive,
/turf/open/floor/iron/dark,
/area/virtual_domain/fullbright)
"dj" = (
/turf/open/floor/carpet,
/area/virtual_domain/fullbright)
"dv" = (
/obj/machinery/conveyor/auto/slow{
	dir = 4
	},
/turf/open/floor/carpet,
/area/virtual_domain/fullbright)
"ef" = (
/obj/effect/turf_decal/siding/wood{
	dir = 8
	},
/obj/effect/turf_decal/siding/wood{
	dir = 4
	},
/obj/machinery/conveyor/auto/slow{
	dir = 4
	},
/turf/open/floor/wood/large,
/area/virtual_domain/fullbright)
"ex" = (
/obj/effect/turf_decal/siding/wood{
	dir = 8
	},
/obj/effect/turf_decal/siding/wood{
	dir = 4
	},
/obj/machinery/conveyor/auto{
	dir = 4
	},
/turf/open/floor/wood/large,
/area/virtual_domain/fullbright)
"eB" = (
/obj/effect/turf_decal/siding/wood,
/obj/effect/turf_decal/siding/wood{
	dir = 1
	},
/obj/effect/decal/cleanable/confetti,
/obj/structure/sign/poster/party_game/directional/north,
/turf/open/floor/wood/large,
/area/virtual_domain/fullbright)
"eU" = (
/obj/effect/turf_decal/siding/wood{
	dir = 8
	},
/obj/effect/turf_decal/siding/wood{
	dir = 4
	},
/obj/machinery/conveyor/auto{
	dir = 8
	},
/turf/open/floor/wood/large,
/area/virtual_domain/fullbright)
"gd" = (
/obj/effect/turf_decal/siding/wood{
	dir = 1
	},
/obj/effect/turf_decal/siding/wood,
/obj/effect/decal/cleanable/confetti,
/turf/open/floor/wood/large,
/area/virtual_domain/fullbright)
"if" = (
/obj/effect/turf_decal/siding/wood,
/obj/machinery/conveyor/auto/inverted{
	dir = 5
	},
/obj/structure/table/wood/fancy{
	density = 0
	},
/turf/open/floor/wood/large,
/area/virtual_domain/fullbright)
"iX" = (
/obj/structure/table/wood,
/obj/machinery/chem_dispenser/drinks{
	dir = 4
	},
/obj/effect/turf_decal/siding/wood{
	dir = 9
	},
/turf/open/floor/wood/large,
/area/virtual_domain/fullbright)
"jc" = (
/obj/machinery/conveyor/auto/slow{
	dir = 4
	},
/obj/structure/table/wood/fancy{
	density = 0
	},
/turf/open/floor/wood/large,
/area/virtual_domain/fullbright)
"jr" = (
/obj/effect/turf_decal/siding/dark{
	dir = 4
	},
/obj/effect/turf_decal/siding/dark{
	dir = 8
	},
/obj/machinery/smartfridge/drinks,
/turf/open/floor/iron/dark,
/area/virtual_domain/fullbright)
"jU" = (
/obj/effect/decal/cleanable/confetti,
/turf/open/floor/carpet,
/area/virtual_domain/fullbright)
"jW" = (
/obj/effect/turf_decal/siding/wood{
	dir = 8
	},
/obj/structure/chair/stool/bar/directional/east,
/obj/machinery/conveyor/auto/slow{
	dir = 4
	},
/turf/open/floor/wood/large,
/area/virtual_domain/fullbright)
"jZ" = (
/turf/closed/indestructible/binary,
/area/virtual_domain/fullbright)
"ky" = (
/obj/effect/turf_decal/siding/wood{
	dir = 8
	},
/obj/effect/turf_decal/siding/wood{
	dir = 4
	},
/obj/structure/sign/poster/random/directional/east,
/turf/open/floor/wood/large,
/area/virtual_domain/fullbright)
"mO" = (
/obj/machinery/conveyor/auto{
	dir = 8
	},
/obj/effect/turf_decal/siding/wood,
/obj/structure/table/wood/fancy{
	density = 0
	},
/turf/open/floor/wood/large,
/area/virtual_domain/fullbright)
"mY" = (
/obj/structure/table/reinforced/plastitaniumglass,
/obj/item/reagent_containers/spray/chemsprayer/party,
/turf/open/floor/iron/dark/small,
/area/virtual_domain/fullbright)
"na" = (
/obj/effect/turf_decal/siding/wood{
	dir = 4
	},
/obj/effect/turf_decal/siding/wood{
	dir = 8
	},
/obj/machinery/conveyor/auto/inverted{
	dir = 4
	},
/turf/open/floor/wood/large,
/area/virtual_domain/fullbright)
"nf" = (
/obj/effect/turf_decal/siding/wood{
	dir = 5
	},
/obj/effect/turf_decal/siding/wood/corner{
	dir = 8
	},
/obj/structure/hedge,
/turf/open/floor/wood/large,
/area/virtual_domain/fullbright)
"nr" = (
/obj/effect/turf_decal/siding/wood,
/obj/effect/turf_decal/siding/wood{
	dir = 1
	},
/obj/structure/railing{
	dir = 8
	},
/obj/structure/railing{
	dir = 4
	},
/obj/structure/reagent_dispensers/beerkeg,
/obj/effect/decal/cleanable/vomit,
/obj/machinery/digital_clock/directional/north,
/turf/open/floor/wood/large,
/area/virtual_domain/fullbright)
"nN" = (
/obj/machinery/conveyor/auto{
	dir = 9
	},
/turf/open/floor/carpet,
/area/virtual_domain/fullbright)
"nY" = (
/obj/structure/chair/stool/bar/directional/south,
/obj/effect/decal/cleanable/vomit,
/turf/open/floor/carpet,
/area/virtual_domain/fullbright)
"og" = (
/obj/effect/turf_decal/siding/wood,
/obj/effect/turf_decal/siding/wood{
	dir = 1
	},
/obj/item/reagent_containers/spray/chemsprayer/party,
/obj/structure/sign/poster/party_game/directional/north,
/turf/open/floor/wood/large,
/area/virtual_domain/fullbright)
"om" = (
/obj/machinery/telecomms/relay/preset/auto/bitrunning,
/turf/closed/indestructible/binary,
/area/virtual_domain/fullbright)
"qp" = (
/obj/effect/turf_decal/siding/wood{
	dir = 4
	},
/turf/open/floor/wood/large,
/area/virtual_domain/fullbright)
"qP" = (
/obj/machinery/conveyor/auto{
	dir = 4
	},
/obj/structure/plasticflaps/opaque,
/obj/bitrunning/watcher_hunt_spawner/station_high,
/turf/open/floor/wood/large,
/area/virtual_domain/fullbright)
"qY" = (
/obj/effect/turf_decal/siding/wood,
/obj/effect/turf_decal/siding/wood{
	dir = 1
	},
/obj/item/reagent_containers/cup/glass/bottle/beer,
/turf/open/floor/wood/large,
/area/virtual_domain/fullbright)
"rB" = (
/obj/structure/chair/stool/bar/directional/south,
/turf/open/floor/carpet,
/area/virtual_domain/fullbright)
"sv" = (
/obj/machinery/conveyor/auto{
	dir = 4
	},
/obj/effect/turf_decal/siding/wood{
	dir = 1
	},
/obj/structure/table/wood/fancy{
	density = 0
	},
/turf/open/floor/wood/large,
/area/virtual_domain/fullbright)
"tc" = (
/obj/effect/turf_decal/siding/wood{
	dir = 6
	},
/turf/open/floor/wood/large,
/area/virtual_domain/fullbright)
"tg" = (
/obj/structure/fake_stairs/wood/directional/north,
/turf/open/floor/wood/large,
/area/virtual_domain/fullbright)
"th" = (
/obj/effect/turf_decal/siding/wood,
/obj/effect/turf_decal/siding/wood{
	dir = 1
	},
/obj/structure/railing{
	dir = 8
	},
/turf/open/floor/wood/large,
/area/virtual_domain/fullbright)
"tn" = (
/turf/closed/indestructible/wood,
/area/virtual_domain/fullbright)
"tt" = (
/obj/effect/turf_decal/siding/wood{
	dir = 9
	},
/obj/structure/chair/stool/bar/directional/east,
/turf/open/floor/wood/large,
/area/virtual_domain/fullbright)
"uW" = (
/obj/structure/table/wood,
/obj/item/gun/energy/pulse/destroyer/fake,
/obj/effect/turf_decal/siding/dark,
/obj/effect/turf_decal/siding/dark{
	dir = 1
	},
/turf/open/floor/iron/dark,
/area/virtual_domain/fullbright)
"vB" = (
/obj/structure/table/wood,
/obj/effect/turf_decal/siding/dark,
/obj/effect/turf_decal/siding/dark{
	dir = 1
	},
/obj/item/clothing/mask/party_horn,
/turf/open/floor/iron/dark,
/area/virtual_domain/fullbright)
"wF" = (
/obj/machinery/conveyor/auto{
	dir = 10
	},
/turf/open/floor/carpet,
/area/virtual_domain/fullbright)
"xd" = (
/obj/effect/turf_decal/siding/wood{
	dir = 4
	},
/obj/effect/turf_decal/siding/wood{
	dir = 8
	},
/obj/machinery/conveyor/auto/slow{
	dir = 4
	},
/turf/open/floor/wood/large,
/area/virtual_domain/fullbright)
"xu" = (
/obj/effect/turf_decal/siding/wood{
	dir = 4
	},
/obj/structure/chair/stool/bar/directional/west,
/obj/machinery/conveyor/auto/slow{
	dir = 4
	},
/turf/open/floor/wood/large,
/area/virtual_domain/fullbright)
"xv" = (
/obj/machinery/conveyor/auto{
	dir = 8
	},
/turf/open/floor/carpet,
/area/virtual_domain/fullbright)
"yC" = (
/obj/bitrunning/watcher_hunt_teleporter,
/obj/machinery/conveyor/auto/inverted{
	dir = 4
	},
/obj/structure/plasticflaps/opaque,
/turf/open/floor/wood/large,
/area/virtual_domain/fullbright)
"yE" = (
/obj/effect/turf_decal/siding/wood{
	dir = 4
	},
/obj/effect/turf_decal/siding/wood{
	dir = 8
	},
/obj/structure/sign/poster/random/directional/west,
/obj/effect/decal/cleanable/confetti,
/turf/open/floor/wood/large,
/area/virtual_domain/fullbright)
"yK" = (
/obj/machinery/conveyor/auto/slow{
	dir = 4
	},
/turf/open/floor/wood/large,
/area/virtual_domain/fullbright)
"zg" = (
/obj/effect/turf_decal/siding/wood,
/obj/effect/turf_decal/siding/wood{
	dir = 1
	},
/obj/effect/decal/cleanable/confetti,
/turf/open/floor/wood/large,
/area/virtual_domain/fullbright)
"Bt" = (
/obj/machinery/conveyor/auto/inverted{
	dir = 4
	},
/turf/open/floor/carpet,
/area/virtual_domain/fullbright)
"BI" = (
/obj/effect/turf_decal/siding/wood{
	dir = 4
	},
/obj/effect/turf_decal/siding/wood{
	dir = 8
	},
/obj/machinery/conveyor/auto{
	dir = 4
	},
/turf/open/floor/wood/large,
/area/virtual_domain/fullbright)
"BN" = (
/obj/machinery/conveyor/auto/slow{
	dir = 4
	},
/obj/structure/plasticflaps/opaque,
/obj/bitrunning/watcher_hunt_spawner/station_medium,
/turf/open/floor/wood/large,
/area/virtual_domain/fullbright)
"Cx" = (
/obj/structure/chair/stool/bar/directional/north,
/turf/open/floor/carpet,
/area/virtual_domain/fullbright)
"Do" = (
/turf/open/floor/carpet/black,
/area/virtual_domain/fullbright)
"Dv" = (
/obj/machinery/conveyor/auto/slow{
	dir = 4
	},
/obj/structure/plasticflaps/opaque,
/obj/bitrunning/watcher_hunt_teleporter,
/turf/open/floor/wood/large,
/area/virtual_domain/fullbright)
"DD" = (
/obj/effect/turf_decal/siding/wood,
/obj/machinery/conveyor/auto/inverted{
	dir = 6
	},
/obj/structure/table/wood/fancy{
	density = 0
	},
/turf/open/floor/wood/large,
/area/virtual_domain/fullbright)
"EN" = (
/obj/item/reagent_containers/cup/glass/bottle/beer,
/turf/open/floor/carpet,
/area/virtual_domain/fullbright)
"ET" = (
/obj/machinery/conveyor/auto{
	dir = 6
	},
/turf/open/floor/carpet,
/area/virtual_domain/fullbright)
"Fo" = (
/obj/effect/turf_decal/siding/wood{
	dir = 1
	},
/obj/machinery/conveyor/auto/inverted{
	dir = 9
	},
/obj/structure/table/wood/fancy{
	density = 0
	},
/turf/open/floor/wood/large,
/area/virtual_domain/fullbright)
"Fv" = (
/obj/effect/turf_decal/siding/wood{
	dir = 1
	},
/obj/effect/turf_decal/siding/wood,
/obj/item/reagent_containers/cup/glass/bottle/beer,
/turf/open/floor/wood/large,
/area/virtual_domain/fullbright)
"Gi" = (
/obj/effect/turf_decal/tile/bar/opposingcorners,
/obj/effect/landmark/bitrunning/bitrunner_spawn,
/turf/open/floor/iron/dark,
/area/virtual_domain/fullbright)
"Gq" = (
/obj/machinery/digital_clock/score_card,
/turf/closed/indestructible/wood,
/area/virtual_domain/fullbright)
"HA" = (
/obj/effect/turf_decal/siding/wood{
	dir = 8
	},
/obj/effect/turf_decal/siding/wood{
	dir = 4
	},
/obj/structure/sign/poster/random/directional/east,
/obj/effect/decal/cleanable/confetti,
/turf/open/floor/wood/large,
/area/virtual_domain/fullbright)
"JF" = (
/obj/structure/table/wood,
/obj/effect/turf_decal/siding/dark{
	dir = 4
	},
/obj/effect/turf_decal/siding/dark{
	dir = 8
	},
/obj/item/clothing/mask/party_horn,
/turf/open/floor/iron/dark,
/area/virtual_domain/fullbright)
"JK" = (
/obj/machinery/conveyor/auto{
	dir = 8
	},
/obj/structure/plasticflaps/opaque,
/obj/bitrunning/watcher_hunt_spawner/station_low,
/turf/open/floor/wood/large,
/area/virtual_domain/fullbright)
"Kh" = (
/obj/effect/turf_decal/siding/wood{
	dir = 5
	},
/turf/open/floor/wood/large,
/area/virtual_domain/fullbright)
"Kr" = (
/obj/effect/turf_decal/siding/wood,
/obj/effect/turf_decal/siding/wood{
	dir = 1
	},
/turf/open/floor/wood/large,
/area/virtual_domain/fullbright)
"LE" = (
/obj/effect/turf_decal/siding/wood{
	dir = 10
	},
/obj/effect/turf_decal/siding/wood/corner{
	dir = 4
	},
/turf/open/floor/wood/large,
/area/virtual_domain/fullbright)
"LF" = (
/obj/machinery/conveyor/auto{
	dir = 4
	},
/obj/effect/turf_decal/siding/wood{
	dir = 1
	},
/obj/effect/decal/cleanable/confetti,
/obj/structure/table/wood/fancy{
	density = 0
	},
/turf/open/floor/wood/large,
/area/virtual_domain/fullbright)
"Mx" = (
/obj/machinery/door/airlock/wood,
/obj/effect/mapping_helpers/airlock/locked,
/turf/open/floor/wood/large,
/area/virtual_domain/fullbright)
"MB" = (
/obj/machinery/vending/boozeomat,
/obj/effect/turf_decal/siding/wood{
	dir = 8
	},
/turf/open/floor/wood/large,
/area/virtual_domain/fullbright)
"MY" = (
/obj/effect/landmark/bitrunning/cache_goal_turf,
/obj/effect/turf_decal/loading_area{
	dir = 4
	},
/turf/open/indestructible/bitrunning_transport,
/area/virtual_domain/fullbright)
"Nu" = (
/obj/effect/turf_decal/siding/wood{
	dir = 6
	},
/obj/effect/turf_decal/siding/wood/corner{
	dir = 1
	},
/turf/open/floor/wood/large,
/area/virtual_domain/fullbright)
"OV" = (
/obj/structure/table/wood,
/obj/effect/turf_decal/siding/dark,
/obj/effect/turf_decal/siding/dark{
	dir = 1
	},
/obj/item/clothing/head/costume/party,
/turf/open/floor/iron/dark,
/area/virtual_domain/fullbright)
"Pn" = (
/obj/effect/turf_decal/siding/wood{
	dir = 1
	},
/obj/effect/turf_decal/siding/wood,
/obj/item/reagent_containers/spray/chemsprayer/party,
/turf/open/floor/wood/large,
/area/virtual_domain/fullbright)
"PP" = (
/obj/effect/turf_decal/siding/wood{
	dir = 1
	},
/obj/effect/turf_decal/siding/wood,
/turf/open/floor/wood/large,
/area/virtual_domain/fullbright)
"Qg" = (
/obj/structure/table/wood,
/obj/effect/turf_decal/siding/dark{
	dir = 4
	},
/obj/effect/turf_decal/siding/dark{
	dir = 8
	},
/obj/item/reagent_containers/cup/glass/bottle/beer,
/turf/open/floor/iron/dark,
/area/virtual_domain/fullbright)
"QR" = (
/obj/machinery/conveyor/auto{
	dir = 4
	},
/turf/open/floor/carpet,
/area/virtual_domain/fullbright)
"QZ" = (
/obj/effect/turf_decal/siding/wood{
	dir = 5
	},
/obj/structure/chair/stool/bar/directional/west,
/turf/open/floor/wood/large,
/area/virtual_domain/fullbright)
"Rd" = (
/obj/effect/turf_decal/siding/wood,
/obj/effect/turf_decal/siding/wood{
	dir = 1
	},
/obj/structure/railing{
	dir = 4
	},
/turf/open/floor/wood/large,
/area/virtual_domain/fullbright)
"Rl" = (
/obj/effect/turf_decal/siding/wood{
	dir = 9
	},
/obj/effect/turf_decal/siding/wood/corner,
/obj/structure/hedge,
/turf/open/floor/wood/large,
/area/virtual_domain/fullbright)
"RG" = (
/obj/structure/chair/stool/bar/directional/north,
/obj/effect/decal/cleanable/vomit,
/turf/open/floor/carpet,
/area/virtual_domain/fullbright)
"RN" = (
/obj/effect/turf_decal/siding/wood{
	dir = 1
	},
/turf/open/floor/wood/large,
/area/virtual_domain/fullbright)
"Sb" = (
/obj/machinery/conveyor/auto{
	dir = 4
	},
/obj/bitrunning/watcher_hunt_teleporter,
/obj/structure/plasticflaps/opaque,
/turf/open/floor/wood/large,
/area/virtual_domain/fullbright)
"Ut" = (
/obj/machinery/conveyor/auto{
	dir = 5
	},
/turf/open/floor/carpet,
/area/virtual_domain/fullbright)
"Uv" = (
/obj/effect/turf_decal/siding/wood{
	dir = 4
	},
/obj/effect/turf_decal/siding/wood{
	dir = 8
	},
/obj/structure/sign/poster/random/directional/west,
/obj/effect/decal/cleanable/vomit,
/turf/open/floor/wood/large,
/area/virtual_domain/fullbright)
"Uz" = (
/obj/effect/turf_decal/tile/bar/opposingcorners,
/obj/effect/turf_decal/arrows{
	dir = 4
	},
/turf/open/floor/iron/dark,
/area/virtual_domain/fullbright)
"UZ" = (
/obj/structure/table/wood,
/obj/machinery/chem_dispenser/drinks/beer{
	dir = 4
	},
/obj/effect/turf_decal/siding/wood{
	dir = 10
	},
/turf/open/floor/wood/large,
/area/virtual_domain/fullbright)
"Xi" = (
/obj/effect/turf_decal/siding/wood{
	dir = 6
	},
/obj/structure/chair/stool/bar/directional/west,
/turf/open/floor/wood/large,
/area/virtual_domain/fullbright)
"Xo" = (
/obj/effect/turf_decal/siding/wood{
	dir = 10
	},
/obj/structure/chair/stool/bar/directional/east,
/turf/open/floor/wood/large,
/area/virtual_domain/fullbright)
"Yy" = (
/obj/effect/turf_decal/siding/wood,
/turf/open/floor/wood/large,
/area/virtual_domain/fullbright)
"Zi" = (
/obj/machinery/conveyor/auto/slow{
	dir = 4
	},
/obj/effect/decal/cleanable/confetti,
/turf/open/floor/wood/large,
/area/virtual_domain/fullbright)
"Zt" = (
/obj/effect/turf_decal/siding/wood{
	dir = 1
	},
/obj/machinery/conveyor/auto/inverted{
	dir = 10
	},
/obj/structure/table/wood/fancy{
	density = 0
	},
/turf/open/floor/wood/large,
/area/virtual_domain/fullbright)
"ZM" = (
/obj/effect/turf_decal/tile/bar/opposingcorners,
/turf/open/floor/iron/dark,
/area/virtual_domain/fullbright)

(1,1,1) = {"
jZ
jZ
jZ
jZ
jZ
jZ
jZ
jZ
jZ
jZ
jZ
jZ
jZ
jZ
jZ
"}
(2,1,1) = {"
jZ
jZ
jZ
jZ
jZ
jZ
jZ
jZ
jZ
tn
tn
tn
tn
tn
jZ
"}
(3,1,1) = {"
jZ
tn
tn
qP
tn
BN
tn
yC
tn
tn
iX
MB
UZ
tn
jZ
"}
(4,1,1) = {"
jZ
tn
Rl
BI
yE
xd
Uv
na
LE
Mx
RN
Do
Yy
tn
jZ
"}
(5,1,1) = {"
jZ
tn
qY
QR
dj
dv
jU
Bt
PP
tn
Kh
qp
tc
tn
jZ
"}
(6,1,1) = {"
jZ
tn
og
QR
tt
jW
Xo
Bt
Fv
tn
jr
Qg
JF
tn
jZ
"}
(7,1,1) = {"
jZ
tn
zg
ET
Fo
jc
if
wF
gd
OV
ZM
ZM
ZM
tn
jZ
"}
(8,1,1) = {"
jZ
tn
Rd
rB
LF
yK
mO
RG
PP
uW
ZM
Do
ZM
tn
jZ
"}
(9,1,1) = {"
jZ
Mx
tg
EN
sv
yK
mO
jU
PP
vB
ZM
Do
Gi
tn
jZ
"}
(10,1,1) = {"
jZ
tn
nr
rB
sv
yK
mO
Cx
PP
uW
ZM
Do
Gi
tn
om
"}
(11,1,1) = {"
jZ
Mx
tg
jU
sv
yK
mO
EN
PP
da
ZM
Do
Gi
tn
jZ
"}
(12,1,1) = {"
jZ
tn
th
nY
sv
Zi
mO
Cx
Pn
uW
ZM
Do
ZM
tn
jZ
"}
(13,1,1) = {"
jZ
tn
Kr
Ut
Zt
jc
DD
nN
PP
vB
Uz
ZM
Uz
tn
jZ
"}
(14,1,1) = {"
jZ
tn
eB
QR
QZ
xu
Xi
xv
Fv
Gq
MY
mY
MY
tn
jZ
"}
(15,1,1) = {"
jZ
tn
qY
QR
dj
dv
dj
xv
gd
tn
tn
tn
tn
tn
jZ
"}
(16,1,1) = {"
jZ
tn
nf
ex
ky
ef
HA
eU
Nu
tn
jZ
jZ
jZ
jZ
jZ
"}
(17,1,1) = {"
jZ
tn
tn
Sb
tn
Dv
tn
JK
tn
tn
jZ
jZ
jZ
jZ
jZ
"}
(18,1,1) = {"
jZ
jZ
jZ
jZ
jZ
jZ
jZ
jZ
jZ
jZ
jZ
jZ
jZ
jZ
jZ
"}
