//MAP CONVERTED BY dmm2tgm.py THIS HEADER COMMENT PREVENTS RECONVERSION, DO NOT REMOVE
"a" = (
/obj/structure/railing/corner{
	dir = 4
	},
/turf/open/floor/wood,
/area/icemoon/underground/explored/virtual_domain)
"b" = (
/turf/closed/indestructible/rock/snow/ice,
/area/icemoon/underground/explored/virtual_domain)
"d" = (
/obj/structure/railing/corner/end{
	dir = 4
	},
/obj/structure/railing/corner/end/flip{
	dir = 4
	},
/turf/open/misc/asteroid/snow,
/area/icemoon/underground/explored/virtual_domain)
"e" = (
/obj/structure/flora/rock/icy/style_random,
/obj/structure/flora/rock/pile/icy/style_random,
/turf/open/misc/asteroid/snow,
/area/icemoon/underground/explored/virtual_domain)
"f" = (
/obj/structure/railing/corner{
	dir = 8
	},
/turf/open/floor/wood,
/area/icemoon/underground/explored/virtual_domain)
"g" = (
/obj/structure/flora/rock/icy/style_random,
/obj/effect/decal/cleanable/blood/old,
/turf/open/misc/asteroid/snow,
/area/icemoon/underground/explored/virtual_domain)
"h" = (
/obj/structure/flora/rock/pile/icy/style_random,
/obj/effect/decal/cleanable/blood/old,
/turf/open/misc/asteroid/snow,
/area/icemoon/underground/explored/virtual_domain)
"i" = (
/obj/effect/decal/cleanable/blood/old,
/turf/open/misc/asteroid/snow,
/area/icemoon/underground/explored/virtual_domain)
"k" = (
/obj/item/pickaxe/mini,
/turf/open/misc/asteroid/snow,
/area/icemoon/underground/explored/virtual_domain)
"l" = (
/obj/structure/flora/grass/green/style_random,
/turf/open/misc/asteroid/snow,
/area/icemoon/underground/explored/virtual_domain)
"m" = (
/obj/structure/railing,
/obj/structure/railing{
	dir = 1
	},
/turf/open/floor/wood,
/area/icemoon/underground/explored/virtual_domain)
"n" = (
/turf/open/floor/plating/snowed/smoothed,
/area/icemoon/underground/explored/virtual_domain)
"o" = (
/obj/structure/railing/corner{
	dir = 8
	},
/turf/open/cliff/snowrock/virtual_domain,
/area/icemoon/underground/explored/virtual_domain)
"p" = (
/obj/structure/railing/corner/end/flip{
	dir = 8
	},
/obj/structure/railing/corner/end{
	dir = 8
	},
/turf/open/misc/asteroid/snow,
/area/icemoon/underground/explored/virtual_domain)
"q" = (
/obj/structure/flora/rock/pile/icy/style_random,
/obj/structure/flora/grass/green/style_random,
/turf/open/misc/asteroid/snow,
/area/icemoon/underground/explored/virtual_domain)
"r" = (
/obj/item/clothing/under/color/grey,
/turf/open/misc/asteroid/snow,
/area/icemoon/underground/explored/virtual_domain)
"s" = (
/obj/structure/railing/corner/end{
	dir = 8
	},
/obj/structure/railing/corner/end/flip{
	dir = 8
	},
/turf/open/misc/asteroid/snow,
/area/icemoon/underground/explored/virtual_domain)
"t" = (
/obj/effect/turf_decal/weather/snow/corner{
	dir = 4
	},
/turf/open/floor/wood,
/area/icemoon/underground/explored/virtual_domain)
"u" = (
/obj/structure/railing/corner{
	dir = 1
	},
/turf/open/cliff/snowrock/virtual_domain,
/area/icemoon/underground/explored/virtual_domain)
"v" = (
/turf/open/cliff/snowrock/virtual_domain,
/area/icemoon/underground/explored/virtual_domain)
"w" = (
/obj/structure/railing/corner/end/flip{
	dir = 4
	},
/obj/structure/railing/corner/end{
	dir = 4
	},
/turf/open/misc/asteroid/snow,
/area/icemoon/underground/explored/virtual_domain)
"x" = (
/obj/structure/chair/sofa/bench/right,
/turf/open/floor/plating/snowed/smoothed,
/area/icemoon/underground/explored/virtual_domain)
"y" = (
/obj/structure/flora/tree/pine/style_random,
/obj/structure/flora/grass/green/style_random,
/turf/open/misc/asteroid/snow,
/area/icemoon/underground/explored/virtual_domain)
"z" = (
/obj/structure/statue/snow/snowman{
	name = "Norm";
	desc = "Norm has seen many a man roll down these cliffs, some more stubborn than others. Its usually the stubborn ones who stop getting back up."
	},
/obj/item/pickaxe/mini,
/turf/open/misc/asteroid/snow,
/area/icemoon/underground/explored/virtual_domain)
"A" = (
/obj/structure/bonfire/prelit,
/turf/open/misc/asteroid/snow,
/area/icemoon/underground/explored/virtual_domain)
"B" = (
/obj/effect/turf_decal/weather/snow/corner{
	dir = 4
	},
/obj/structure/railing{
	dir = 1
	},
/obj/structure/railing/corner,
/turf/open/floor/wood,
/area/icemoon/underground/explored/virtual_domain)
"C" = (
/obj/effect/turf_decal/weather/snow/corner{
	dir = 8
	},
/obj/structure/railing,
/obj/structure/railing{
	dir = 1
	},
/turf/open/floor/wood,
/area/icemoon/underground/explored/virtual_domain)
"D" = (
/obj/structure/flora/rock/icy/style_random,
/obj/structure/flora/grass/green/style_random,
/turf/open/misc/asteroid/snow,
/area/icemoon/underground/explored/virtual_domain)
"E" = (
/obj/structure/chair/sofa/bench/left,
/turf/open/floor/plating/snowed/smoothed,
/area/icemoon/underground/explored/virtual_domain)
"F" = (
/turf/open/misc/asteroid/snow,
/area/icemoon/underground/explored/virtual_domain)
"G" = (
/turf/open/lava/plasma/virtual_domain,
/area/icemoon/underground/explored/virtual_domain)
"H" = (
/obj/structure/chair/sofa/bench,
/turf/open/floor/plating/snowed/smoothed,
/area/icemoon/underground/explored/virtual_domain)
"I" = (
/obj/effect/decal/cleanable/ash/large,
/turf/open/misc/asteroid/snow,
/area/icemoon/underground/explored/virtual_domain)
"J" = (
/turf/template_noop,
/area/template_noop)
"K" = (
/turf/open/floor/wood,
/area/icemoon/underground/explored/virtual_domain)
"L" = (
/turf/open/floor/iron/stairs,
/area/icemoon/underground/explored/virtual_domain)
"M" = (
/obj/structure/railing/corner,
/turf/open/cliff/snowrock/virtual_domain,
/area/icemoon/underground/explored/virtual_domain)
"N" = (
/obj/structure/closet/crate/secure/bitminer_loot/encrypted,
/turf/open/floor/plating/snowed/smoothed,
/area/icemoon/underground/explored/virtual_domain)
"O" = (
/obj/structure/flora/rock/icy/style_random,
/turf/open/misc/asteroid/snow,
/area/icemoon/underground/explored/virtual_domain)
"P" = (
/obj/effect/decal/cleanable/blood/old,
/obj/effect/decal/cleanable/ash/large,
/turf/open/misc/asteroid/snow,
/area/icemoon/underground/explored/virtual_domain)
"Q" = (
/obj/structure/flora/tree/pine/style_random,
/turf/open/misc/asteroid/snow,
/area/icemoon/underground/explored/virtual_domain)
"R" = (
/obj/effect/turf_decal/weather/snow/corner{
	dir = 8
	},
/obj/structure/railing,
/obj/structure/railing/corner{
	dir = 1
	},
/turf/open/floor/wood,
/area/icemoon/underground/explored/virtual_domain)
"S" = (
/obj/structure/flora/rock/pile/icy/style_random,
/turf/open/misc/asteroid/snow,
/area/icemoon/underground/explored/virtual_domain)
"T" = (
/obj/structure/flora/grass/green/style_random,
/turf/open/floor/plating/snowed/smoothed,
/area/icemoon/underground/explored/virtual_domain)
"U" = (
/obj/effect/decal/remains/plasma,
/obj/effect/decal/cleanable/ash/large,
/turf/open/misc/asteroid/snow,
/area/icemoon/underground/explored/virtual_domain)
"V" = (
/obj/effect/turf_decal/weather/snow/corner{
	dir = 4
	},
/obj/structure/railing,
/obj/structure/railing{
	dir = 1
	},
/turf/open/floor/wood,
/area/icemoon/underground/explored/virtual_domain)
"W" = (
/turf/open/misc/ice,
/area/icemoon/underground/explored/virtual_domain)
"X" = (
/obj/effect/decal/remains/plasma,
/turf/open/misc/asteroid/snow,
/area/icemoon/underground/explored/virtual_domain)
"Y" = (
/obj/structure/railing/corner{
	dir = 4
	},
/turf/open/cliff/snowrock/virtual_domain,
/area/icemoon/underground/explored/virtual_domain)
"Z" = (
/obj/effect/turf_decal/weather/snow/corner{
	dir = 8
	},
/turf/open/floor/wood,
/area/icemoon/underground/explored/virtual_domain)

(1,1,1) = {"
J
J
J
J
J
J
J
J
J
J
J
J
J
J
J
J
J
J
J
J
J
J
J
J
J
J
J
J
J
J
J
J
J
J
J
J
J
J
J
J
J
J
J
J
J
J
J
J
J
J
J
J
J
J
J
J
J
J
J
J
J
J
J
J
J
J
J
J
J
J
J
J
J
J
J
"}
(2,1,1) = {"
J
b
b
b
b
b
b
b
b
b
b
b
b
b
b
b
b
b
b
b
b
b
b
b
b
b
b
b
b
b
b
b
b
b
b
b
b
b
b
b
b
b
b
b
b
b
b
b
b
b
b
b
b
b
b
b
b
b
b
b
b
b
b
b
b
b
b
b
b
b
b
b
b
b
J
"}
(3,1,1) = {"
J
b
b
b
b
F
F
v
v
v
v
v
v
v
v
v
v
v
v
v
v
v
v
v
v
v
v
v
v
v
v
v
v
v
v
v
v
v
v
v
v
v
v
v
v
v
v
v
v
v
v
v
v
v
G
G
b
b
b
b
b
b
b
b
b
b
b
b
b
b
b
b
b
b
J
"}
(4,1,1) = {"
J
b
b
b
F
F
F
v
v
v
v
v
v
v
v
v
v
v
v
v
v
v
v
v
v
v
v
v
v
v
v
v
v
v
v
v
v
v
v
v
v
v
v
v
v
v
v
v
v
v
v
v
v
v
G
G
b
b
b
b
b
b
b
b
b
b
b
b
b
b
b
b
b
b
J
"}
(5,1,1) = {"
J
b
b
F
F
F
F
v
v
v
v
v
v
v
v
v
v
v
v
v
v
v
v
v
v
v
v
v
v
v
v
v
v
v
v
v
v
v
v
v
v
v
v
v
v
v
v
v
v
v
v
v
v
v
G
G
G
G
b
b
b
b
b
b
b
b
b
b
b
b
b
b
b
b
J
"}
(6,1,1) = {"
J
b
b
Q
S
F
F
v
v
v
v
v
v
v
v
v
v
v
v
v
v
v
v
v
v
v
v
v
v
v
v
v
v
v
v
v
v
v
v
v
v
v
v
v
v
v
v
v
v
v
v
v
v
v
G
G
G
b
b
b
b
b
b
b
b
b
b
b
b
b
b
b
b
b
J
"}
(7,1,1) = {"
J
b
b
F
F
l
F
v
v
v
v
v
v
v
v
v
v
v
v
v
v
v
v
v
v
v
v
v
v
v
v
v
v
v
v
v
v
v
v
v
v
v
v
v
v
v
v
v
v
v
v
v
v
v
G
G
G
b
b
b
b
b
b
b
b
b
b
b
b
b
b
b
b
b
J
"}
(8,1,1) = {"
J
b
b
O
S
F
F
v
v
v
v
v
v
v
v
v
v
v
v
v
v
v
v
v
v
v
v
v
v
v
v
v
v
v
v
v
v
v
v
v
v
v
v
v
v
v
v
v
v
v
v
v
v
v
G
G
G
b
b
b
G
b
b
b
b
b
b
b
b
b
b
b
b
b
J
"}
(9,1,1) = {"
J
b
b
F
O
F
S
F
v
v
v
v
v
v
v
v
v
v
v
v
v
v
v
v
v
v
v
v
v
v
v
v
v
v
v
v
v
v
v
v
v
v
v
v
v
v
v
v
v
v
v
v
v
v
G
G
G
G
G
G
G
b
b
b
b
b
b
b
b
b
b
b
b
b
J
"}
(10,1,1) = {"
J
b
F
S
O
O
F
F
v
v
v
v
v
v
v
v
v
v
v
v
v
v
v
v
v
v
v
v
v
v
v
v
v
v
v
v
v
v
v
v
v
v
v
v
v
v
v
v
v
v
v
v
v
v
G
G
G
G
G
G
G
b
b
b
b
b
b
b
b
b
b
b
b
b
J
"}
(11,1,1) = {"
J
b
F
O
S
l
F
F
v
v
v
v
v
v
v
v
v
v
v
v
v
v
v
A
F
S
v
v
v
v
v
v
v
v
v
v
v
v
v
v
v
v
v
v
v
v
v
v
v
v
v
v
v
v
G
G
G
G
G
G
G
G
b
b
b
b
b
b
b
b
b
b
b
b
J
"}
(12,1,1) = {"
J
b
F
F
S
l
F
v
v
v
v
v
v
v
v
v
v
v
v
v
v
v
v
S
F
L
L
L
v
v
L
L
L
L
L
L
v
v
v
v
L
L
L
L
F
W
v
v
v
v
v
v
v
v
G
G
G
G
G
G
G
G
b
b
b
b
b
b
b
b
b
b
b
b
J
"}
(13,1,1) = {"
J
b
F
l
S
F
F
v
v
v
v
v
v
v
v
v
v
v
v
v
v
v
v
S
F
F
v
L
L
L
L
v
v
v
v
L
L
L
L
L
L
L
L
L
F
F
v
v
v
v
v
v
v
v
v
G
G
G
G
G
G
G
G
b
b
b
b
b
b
b
b
b
b
b
J
"}
(14,1,1) = {"
J
b
F
F
F
F
Q
v
v
v
v
v
v
v
v
v
v
v
v
v
v
v
v
S
F
v
v
v
v
v
v
v
v
v
v
v
v
v
v
v
v
v
v
v
F
l
v
v
v
v
v
v
v
v
v
G
G
G
G
G
G
G
b
b
b
G
b
b
b
b
b
b
b
b
J
"}
(15,1,1) = {"
J
b
S
l
F
F
F
v
v
v
v
v
v
v
v
v
v
v
v
v
v
v
v
F
W
v
v
v
v
v
v
v
v
v
v
v
v
v
v
v
v
v
v
v
v
F
v
v
v
v
v
v
v
v
v
G
G
G
G
G
G
G
b
b
b
G
b
b
b
b
b
b
b
b
J
"}
(16,1,1) = {"
J
b
F
l
l
l
F
v
v
v
v
v
v
v
v
v
v
v
v
v
v
v
v
F
W
v
v
v
v
v
v
v
v
v
G
F
v
v
v
v
v
v
v
v
v
F
A
v
v
v
v
v
v
v
v
G
G
I
G
G
G
G
b
b
b
G
b
b
b
b
b
b
b
b
J
"}
(17,1,1) = {"
J
b
F
l
l
F
n
L
L
L
L
v
v
L
L
L
F
F
v
v
v
v
v
F
W
v
v
v
v
v
v
v
v
G
G
S
F
v
v
v
v
v
v
v
v
F
F
v
v
v
v
v
v
v
v
G
G
F
F
G
G
G
b
b
b
G
G
b
b
b
b
b
b
b
J
"}
(18,1,1) = {"
J
b
b
F
F
n
n
v
v
v
L
L
L
L
v
v
l
W
v
v
v
v
v
F
F
F
v
v
v
v
v
v
v
v
G
F
l
G
G
v
v
v
v
v
v
S
F
v
v
v
v
v
v
v
v
G
F
r
F
F
G
G
b
b
b
G
G
b
b
b
b
b
b
b
J
"}
(19,1,1) = {"
J
b
b
Q
l
n
F
v
v
v
v
v
v
v
v
v
v
F
S
v
v
v
v
v
F
F
v
v
v
v
v
v
v
v
F
F
S
X
G
v
v
v
v
v
v
O
F
v
v
v
v
v
v
v
v
G
I
S
F
F
G
G
G
G
b
G
G
b
b
b
b
b
b
b
J
"}
(20,1,1) = {"
J
b
b
F
F
n
F
v
v
v
v
v
v
v
v
v
v
F
F
v
v
v
v
v
W
F
v
v
v
v
v
v
v
v
v
Q
I
G
G
v
v
v
v
v
v
v
F
W
F
v
v
v
v
v
v
G
F
F
G
G
G
G
G
G
G
G
G
G
b
b
b
b
b
b
J
"}
(21,1,1) = {"
J
b
b
F
v
v
v
v
v
v
v
v
v
v
v
v
v
v
F
v
v
v
v
v
v
F
v
v
v
v
v
v
v
v
v
F
G
G
v
v
v
v
v
v
v
v
v
F
F
v
v
v
v
v
v
F
F
F
G
G
G
G
G
G
G
G
G
G
b
b
b
b
b
b
J
"}
(22,1,1) = {"
J
b
b
F
l
v
v
v
v
v
v
v
v
v
v
v
v
v
F
v
v
v
v
v
v
W
v
v
v
v
v
v
v
v
v
v
v
v
v
v
v
v
v
v
v
v
v
F
v
v
v
v
v
v
v
S
F
F
G
G
G
G
G
G
G
G
G
G
G
b
b
b
b
b
J
"}
(23,1,1) = {"
J
b
b
b
l
W
W
v
v
v
v
v
v
v
v
v
v
v
W
v
v
v
v
v
v
W
v
v
v
v
v
v
v
v
v
v
v
v
v
v
v
v
v
v
v
v
v
F
W
v
v
v
v
v
v
e
i
F
F
G
G
G
G
G
G
G
G
G
G
b
b
b
b
b
J
"}
(24,1,1) = {"
J
b
b
S
O
W
W
v
v
v
v
v
v
v
v
v
v
v
W
v
v
v
v
v
v
W
v
v
v
v
v
F
v
v
v
v
v
v
v
v
v
v
v
v
v
v
v
l
F
v
v
v
v
v
v
g
O
F
F
F
G
G
G
G
G
G
G
G
G
b
b
b
b
b
J
"}
(25,1,1) = {"
J
b
b
F
F
l
W
v
v
v
v
v
v
v
v
v
v
v
W
v
v
v
v
v
v
F
v
v
v
v
v
F
L
L
L
L
L
L
L
L
L
L
L
L
v
L
L
F
F
v
v
v
v
v
v
g
S
F
F
F
F
F
G
G
G
G
G
G
G
b
b
b
b
b
J
"}
(26,1,1) = {"
J
b
b
F
n
F
W
v
v
v
v
v
v
v
v
v
v
v
F
v
v
v
v
v
W
F
v
v
v
v
v
F
L
L
L
L
L
v
v
v
v
L
L
L
L
L
L
W
W
v
v
v
v
v
v
g
S
F
F
F
l
F
F
F
G
G
G
G
G
G
G
b
b
b
J
"}
(27,1,1) = {"
J
b
b
F
n
l
F
v
v
v
v
v
v
v
v
v
v
v
l
F
v
v
v
v
F
v
v
v
v
O
F
F
v
v
v
v
v
v
v
v
v
v
v
v
v
v
v
v
v
v
v
v
v
v
v
F
F
F
F
Q
F
F
F
S
F
F
G
G
G
G
G
b
b
b
J
"}
(28,1,1) = {"
J
b
b
l
n
F
F
v
v
v
v
v
v
v
v
v
v
v
l
F
v
v
v
v
F
v
v
v
v
F
W
v
v
v
v
v
v
v
v
v
v
v
v
v
v
v
v
v
v
v
v
v
v
v
v
F
Q
l
F
W
W
l
l
F
Q
F
G
G
G
G
G
G
b
b
J
"}
(29,1,1) = {"
J
b
b
l
n
n
W
v
v
v
v
v
v
v
v
v
v
v
F
F
v
v
v
v
F
v
v
v
v
w
v
v
v
v
v
v
v
v
v
v
v
v
v
v
v
v
v
v
v
v
v
v
v
v
v
F
F
F
W
W
W
l
l
F
F
F
G
G
G
G
G
b
b
b
J
"}
(30,1,1) = {"
J
b
b
W
F
W
v
v
v
v
v
v
v
v
v
v
v
v
v
F
v
v
v
v
F
v
v
v
v
C
v
v
v
v
v
v
v
v
v
v
v
v
v
v
v
v
v
v
v
v
v
v
v
v
v
x
F
F
F
Q
F
F
F
F
F
F
F
F
G
G
G
b
b
b
J
"}
(31,1,1) = {"
J
b
A
W
F
n
v
v
v
v
v
v
v
F
F
L
L
L
L
W
v
v
v
v
F
F
v
v
v
m
v
v
v
v
v
v
v
v
v
v
v
v
v
v
v
v
v
v
v
v
v
v
v
v
v
H
n
F
F
F
F
F
Q
l
l
F
F
F
F
F
F
F
F
b
J
"}
(32,1,1) = {"
J
b
v
v
Z
v
v
v
v
v
v
v
v
F
F
F
v
v
v
v
v
v
v
v
S
F
v
v
v
V
v
v
v
v
v
v
v
v
v
v
v
v
v
v
v
F
v
v
v
v
v
v
v
v
v
E
n
F
Q
F
F
F
Q
l
l
F
F
F
F
Q
F
F
b
b
J
"}
(33,1,1) = {"
J
b
v
v
K
v
v
v
v
v
v
v
v
v
F
F
F
v
v
v
v
v
v
v
v
F
v
v
v
p
v
v
v
v
v
v
v
W
F
L
L
L
L
L
F
F
S
v
v
v
v
v
v
v
v
n
n
F
F
l
F
S
F
F
F
F
l
l
F
F
F
F
b
b
J
"}
(34,1,1) = {"
J
b
v
v
K
v
v
v
v
v
v
v
v
v
F
l
F
v
v
v
v
v
v
v
v
W
v
v
v
F
W
v
v
v
v
v
v
W
n
L
L
L
L
L
n
F
v
v
v
v
v
v
v
v
v
F
n
F
F
l
F
F
F
F
Q
W
F
F
F
F
F
F
F
b
J
"}
(35,1,1) = {"
J
b
v
v
K
v
v
v
v
v
v
v
v
v
v
v
F
v
v
v
v
v
v
v
v
W
v
v
v
W
l
v
v
v
v
v
v
W
F
v
v
v
v
v
O
F
F
v
v
v
v
v
v
v
v
F
n
n
F
F
F
W
W
W
W
W
F
J
J
J
J
J
J
b
J
"}
(36,1,1) = {"
J
b
F
v
t
v
F
v
v
v
v
v
v
v
v
v
W
v
v
v
v
v
v
v
v
F
W
v
v
S
F
v
v
v
v
v
v
W
F
v
v
v
v
v
Q
F
W
v
v
v
v
v
v
v
v
A
F
n
F
F
F
F
F
W
W
W
F
J
J
J
J
J
J
b
J
"}
(37,1,1) = {"
J
b
b
F
F
F
F
F
v
v
v
v
v
v
v
v
F
F
v
v
v
v
v
v
v
v
F
v
v
v
F
F
v
v
v
v
O
F
l
v
v
v
v
v
v
l
n
F
v
v
v
v
v
v
v
n
F
n
F
F
F
F
S
W
W
F
F
J
J
J
J
J
J
b
J
"}
(38,1,1) = {"
J
b
b
F
n
F
F
v
v
v
v
v
v
v
v
v
v
W
v
v
v
v
v
v
v
v
F
v
v
v
F
F
v
v
v
v
F
F
W
v
v
v
v
v
v
v
n
T
L
L
L
L
L
L
L
n
n
n
n
n
n
F
F
n
F
n
n
J
J
J
J
J
J
b
J
"}
(39,1,1) = {"
J
b
b
F
F
F
Q
v
v
v
v
v
v
v
v
v
v
W
v
v
v
v
v
v
v
F
W
v
v
v
A
F
F
v
v
v
F
F
v
v
v
v
v
v
v
v
n
T
L
L
L
L
L
L
L
n
n
n
n
F
n
n
n
n
n
n
n
J
J
J
J
J
J
b
J
"}
(40,1,1) = {"
J
b
b
F
n
F
F
v
v
v
v
v
v
v
v
v
v
W
v
v
v
v
v
v
v
F
F
v
v
v
v
F
F
L
L
L
F
Q
v
v
v
v
v
v
v
v
S
F
L
L
L
L
L
L
L
n
n
F
F
F
n
F
n
n
n
F
n
J
J
J
J
J
J
b
J
"}
(41,1,1) = {"
J
b
F
l
n
F
l
v
v
v
v
v
v
v
v
v
v
F
v
v
v
v
v
v
v
v
F
W
v
v
v
W
k
L
L
L
W
F
v
v
v
v
v
v
v
v
v
v
v
v
v
v
v
v
v
F
F
F
S
F
F
F
F
F
F
F
F
J
J
J
J
J
J
b
J
"}
(42,1,1) = {"
J
b
F
T
n
n
F
v
v
v
v
v
v
v
v
v
v
F
v
v
v
v
v
v
v
v
v
F
v
v
v
v
v
v
v
v
v
v
v
v
v
v
v
v
v
v
v
v
v
v
v
v
v
v
v
A
z
F
F
F
l
l
F
W
W
W
F
F
F
F
F
F
F
b
J
"}
(43,1,1) = {"
J
b
n
n
N
n
n
v
v
v
v
v
v
v
v
v
v
F
v
v
v
v
v
v
v
v
v
F
v
v
v
v
v
v
v
v
v
v
v
v
v
v
v
v
v
v
v
v
v
v
v
v
v
v
v
F
l
F
F
Q
l
l
F
F
W
W
W
F
l
l
F
F
F
b
J
"}
(44,1,1) = {"
J
b
F
n
n
n
F
v
v
v
v
v
v
v
v
v
v
F
W
v
v
v
v
v
v
v
F
F
v
v
v
v
v
v
v
v
v
v
v
v
v
v
v
v
v
v
v
v
v
v
v
v
v
v
v
F
l
F
l
F
F
F
F
Q
W
W
W
F
l
l
F
F
F
b
J
"}
(45,1,1) = {"
J
b
F
F
n
F
F
v
v
v
v
v
v
v
v
v
v
F
F
v
v
v
v
v
v
v
F
F
v
v
v
v
v
v
v
v
v
v
v
v
v
v
v
v
v
v
v
v
v
v
v
v
v
v
v
F
F
F
F
F
F
Q
F
F
F
F
b
F
b
F
Q
F
b
b
J
"}
(46,1,1) = {"
J
b
b
l
F
F
l
v
v
v
v
v
v
v
v
v
v
W
F
v
v
v
v
v
v
v
v
F
v
v
v
v
v
v
v
v
v
v
v
v
v
v
v
v
v
v
v
v
v
v
v
v
v
v
v
Q
F
F
F
F
F
F
F
F
F
F
b
b
b
F
F
F
b
b
J
"}
(47,1,1) = {"
J
b
b
F
F
y
l
v
v
v
v
v
v
v
v
v
v
v
F
v
v
v
v
v
v
F
F
W
L
L
L
v
v
v
v
L
L
L
L
v
v
v
L
L
L
v
v
v
v
v
v
v
v
v
v
G
F
G
F
F
F
F
F
F
b
b
b
b
b
F
F
F
b
b
J
"}
(48,1,1) = {"
J
b
b
F
Q
l
y
v
v
v
v
v
v
v
v
v
v
v
F
v
v
v
v
v
v
F
F
F
S
v
L
L
L
L
L
L
v
v
L
L
L
L
L
v
L
L
L
W
v
v
v
v
v
v
v
G
G
G
G
G
F
F
F
F
b
b
b
b
F
S
F
F
F
b
J
"}
(49,1,1) = {"
J
b
b
F
F
y
l
v
v
v
v
v
v
v
v
v
v
v
F
W
v
v
v
v
v
O
F
F
v
v
v
v
v
v
v
v
v
v
v
v
v
v
v
v
v
v
v
F
v
v
v
v
v
v
v
G
G
G
F
F
F
F
F
G
G
b
b
b
b
F
S
F
F
b
J
"}
(50,1,1) = {"
J
b
b
l
F
F
F
v
v
v
v
v
v
v
v
v
v
v
l
W
v
v
v
v
v
v
v
v
v
v
v
v
v
v
v
v
v
v
v
v
v
v
v
v
v
v
v
F
A
v
v
v
v
v
v
F
G
G
F
F
l
F
G
G
G
G
b
b
b
S
O
F
F
b
J
"}
(51,1,1) = {"
J
b
b
b
F
l
Q
v
v
v
v
v
v
v
v
v
v
v
l
W
v
v
v
v
v
v
v
v
v
v
v
v
v
v
v
v
v
v
v
v
v
v
v
v
v
v
v
v
l
v
v
v
v
v
v
F
G
F
F
Q
F
F
G
G
G
G
b
b
b
b
F
F
l
b
J
"}
(52,1,1) = {"
J
b
b
b
F
l
F
v
v
v
v
v
v
v
v
v
v
v
F
F
v
v
v
v
v
G
v
v
v
v
v
v
v
v
v
v
v
v
v
v
v
v
v
v
v
v
v
v
l
v
v
v
v
v
v
F
G
F
F
F
G
G
G
G
G
G
G
b
b
b
F
F
F
b
J
"}
(53,1,1) = {"
J
b
b
b
F
y
F
v
v
v
v
v
v
v
v
v
v
v
S
d
v
v
v
v
v
G
G
G
v
v
v
v
v
F
v
v
v
v
v
v
v
v
v
v
v
v
v
v
F
F
v
v
v
v
v
F
F
F
l
F
G
G
G
G
G
G
G
b
b
b
b
F
F
b
J
"}
(54,1,1) = {"
J
b
b
b
F
F
F
v
v
v
v
v
v
v
v
v
v
v
o
R
v
v
v
v
v
v
G
G
G
G
v
v
I
F
F
G
v
F
v
v
v
v
v
v
v
v
v
v
v
F
v
v
v
v
v
l
F
S
l
F
G
G
G
G
G
G
G
G
b
b
b
F
b
b
J
"}
(55,1,1) = {"
J
b
b
F
F
F
F
v
v
v
v
v
v
v
v
v
v
v
v
f
u
v
v
v
v
v
v
v
G
G
G
G
G
G
G
G
G
F
Q
v
v
v
v
v
v
v
v
v
F
W
v
v
v
v
v
F
S
O
F
F
G
G
G
G
G
G
G
G
b
b
F
F
F
b
J
"}
(56,1,1) = {"
J
b
b
F
O
S
F
F
v
v
v
v
v
v
v
v
v
v
M
a
v
v
v
v
v
v
v
v
v
v
v
G
G
G
G
G
G
F
F
v
v
v
v
v
v
v
v
v
F
W
v
v
v
v
v
P
S
O
O
S
G
G
G
G
G
G
G
G
b
b
F
F
F
b
J
"}
(57,1,1) = {"
J
b
b
F
q
l
l
Q
v
v
v
v
v
v
v
v
v
v
v
B
Y
v
v
v
v
v
v
v
v
v
v
v
v
v
v
G
G
F
S
F
v
v
v
v
v
v
v
v
l
O
v
v
v
v
v
G
F
O
O
F
F
G
G
G
G
G
G
b
b
b
F
F
F
b
J
"}
(58,1,1) = {"
J
b
b
F
l
l
y
F
v
v
v
v
v
v
v
v
v
v
F
s
v
v
v
v
v
v
v
v
v
v
v
v
v
v
v
F
h
O
F
F
v
v
v
v
v
v
v
v
F
S
v
v
v
v
v
G
I
F
G
F
F
G
G
G
G
b
b
b
b
F
l
F
F
b
J
"}
(59,1,1) = {"
J
b
b
l
y
l
l
F
v
v
v
v
v
v
v
v
v
F
F
W
v
v
v
F
v
v
L
L
L
F
v
v
v
v
v
Q
F
v
v
v
v
v
v
v
v
v
v
v
F
F
v
v
v
v
v
G
F
F
G
F
G
G
G
G
G
G
b
b
F
F
F
b
b
b
J
"}
(60,1,1) = {"
J
b
b
F
F
S
Q
F
v
v
v
v
v
v
v
v
v
F
F
v
v
v
F
F
L
L
L
v
v
F
v
v
v
v
v
v
v
v
v
v
v
v
v
v
v
v
v
Q
F
W
v
v
v
v
v
G
I
G
G
G
G
G
G
G
G
b
b
b
F
F
F
b
b
b
J
"}
(61,1,1) = {"
J
b
F
Q
S
O
O
F
v
v
v
v
v
v
v
v
v
F
F
v
v
v
F
v
v
v
v
v
F
l
v
v
v
v
v
v
v
v
v
v
v
v
v
v
v
v
v
F
F
v
v
v
v
v
v
G
G
G
G
G
G
G
G
G
G
b
b
F
F
F
b
b
b
b
J
"}
(62,1,1) = {"
J
b
F
l
D
O
O
F
v
v
v
v
v
v
v
v
F
F
v
v
v
v
l
F
v
v
v
v
F
v
v
v
v
v
v
v
v
v
v
v
v
v
v
v
v
v
v
l
F
v
v
v
v
v
v
G
G
G
G
G
G
G
G
b
b
b
b
F
F
b
b
b
b
b
J
"}
(63,1,1) = {"
J
b
F
q
q
F
l
F
v
v
v
v
v
v
v
v
O
F
v
v
v
v
v
F
v
v
v
v
F
v
v
v
v
v
v
v
v
v
v
v
v
v
v
v
v
v
v
l
F
v
v
v
G
G
G
G
G
G
G
G
G
G
G
F
b
b
F
F
F
F
b
b
b
b
J
"}
(64,1,1) = {"
J
b
F
l
l
S
Q
F
v
v
v
v
v
v
v
v
S
F
v
v
v
v
v
W
v
v
v
v
F
v
v
v
v
v
v
v
v
v
v
v
v
v
v
v
v
v
v
F
v
v
v
v
G
G
G
G
G
G
G
G
G
G
O
F
F
F
l
F
S
b
b
b
b
b
J
"}
(65,1,1) = {"
J
b
F
F
Q
F
F
F
v
v
v
v
v
v
v
v
F
F
v
v
v
v
v
W
v
v
v
v
W
v
v
v
v
v
v
v
F
v
v
v
v
L
L
L
L
L
L
F
v
v
v
v
G
G
G
G
G
G
G
G
G
G
S
l
l
F
S
S
O
b
b
b
b
b
J
"}
(66,1,1) = {"
J
b
F
Q
l
l
F
v
v
v
v
v
v
v
v
v
F
l
F
v
v
v
v
W
v
v
v
v
l
F
v
v
v
v
v
S
F
L
L
L
L
L
v
v
v
L
L
F
v
v
v
v
G
G
G
G
G
G
G
G
G
G
F
l
l
F
F
F
b
b
b
b
b
b
J
"}
(67,1,1) = {"
J
b
F
F
y
D
F
v
v
v
v
v
v
v
v
v
v
l
F
v
v
v
F
F
v
v
v
v
v
F
v
v
v
v
v
F
W
v
v
v
v
v
v
v
v
v
v
v
v
v
v
G
G
G
G
G
G
G
G
G
G
G
G
G
G
l
F
F
F
b
b
b
b
b
J
"}
(68,1,1) = {"
J
b
F
F
q
l
F
v
v
v
v
v
v
v
v
v
v
F
F
v
v
v
F
F
v
v
v
v
v
F
v
v
v
v
v
l
W
v
v
v
v
v
v
v
v
v
v
v
v
G
G
G
G
G
G
G
G
G
G
G
G
G
G
G
G
F
F
b
b
b
b
b
b
b
J
"}
(69,1,1) = {"
J
b
b
F
O
S
F
v
v
v
v
v
v
v
v
v
v
F
F
L
L
L
F
F
v
v
v
v
v
F
v
v
v
v
v
F
W
v
v
v
v
v
v
v
v
v
v
v
v
G
G
G
G
G
G
G
G
G
G
G
G
G
G
G
G
b
b
b
b
b
b
b
b
b
J
"}
(70,1,1) = {"
J
b
b
b
F
O
S
v
v
v
v
v
v
v
v
v
v
Q
v
v
v
v
v
v
v
v
v
v
v
F
L
F
F
F
F
F
v
v
v
v
v
v
v
v
v
v
v
v
v
G
G
G
G
G
G
G
G
G
G
G
G
G
G
G
G
G
b
b
b
b
b
b
b
b
J
"}
(71,1,1) = {"
J
b
b
F
l
l
F
v
v
v
v
v
v
v
v
v
v
v
v
v
v
v
v
v
v
v
v
v
v
v
v
v
F
W
F
A
v
v
v
v
v
v
v
v
v
v
U
G
G
G
G
G
G
G
G
G
G
G
G
G
G
G
G
G
G
G
b
b
b
b
b
b
b
b
J
"}
(72,1,1) = {"
J
b
b
l
l
q
F
v
v
v
v
v
v
v
v
v
v
v
v
v
v
v
v
v
v
v
v
v
v
v
v
v
v
v
v
v
v
v
v
v
v
v
v
v
v
v
v
v
G
G
G
G
G
G
G
G
G
G
G
G
G
G
G
G
G
G
b
b
b
b
b
b
b
b
J
"}
(73,1,1) = {"
J
b
b
b
F
S
F
v
v
v
v
v
v
v
v
v
v
v
v
v
v
v
v
v
v
v
v
v
v
v
v
v
v
v
v
v
v
v
v
v
v
v
v
v
v
v
v
v
G
G
G
G
G
G
G
G
G
G
G
G
G
G
G
G
G
G
b
b
b
b
b
b
b
b
J
"}
(74,1,1) = {"
J
b
b
b
b
b
b
b
b
b
b
b
b
b
b
b
b
b
b
b
b
b
b
b
b
b
b
b
b
b
b
b
b
b
b
b
b
b
b
b
b
b
b
b
b
b
b
b
b
b
b
b
b
b
b
b
b
b
b
b
b
b
b
b
b
b
b
b
b
b
b
b
b
b
J
"}
(75,1,1) = {"
J
J
J
J
J
J
J
J
J
J
J
J
J
J
J
J
J
J
J
J
J
J
J
J
J
J
J
J
J
J
J
J
J
J
J
J
J
J
J
J
J
J
J
J
J
J
J
J
J
J
J
J
J
J
J
J
J
J
J
J
J
J
J
J
J
J
J
J
J
J
J
J
J
J
J
"}
