"aa" = (/turf/space,/area)
"ab" = (/obj/item/stack/sheet/metal,/turf/space,/area)
"ac" = (/turf/simulated/wall,/area/vault/asteroid)
"ad" = (/turf/space,/area/vault/asteroid)
"ae" = (/obj/item/stack/sheet/metal,/turf/space,/area/vault/asteroid)
"af" = (/obj/item/stack/tile/plasteel,/turf/simulated/floor/plating/airless,/area/vault/asteroid)
"ag" = (/turf/simulated/floor/plating/airless{broken = 1; icon_state = "platingdmg1"},/area/vault/asteroid)
"ah" = (/turf/simulated/floor/plating/airless,/area/vault/asteroid)
"ai" = (/obj/structure/lattice,/turf/space,/area/vault/asteroid)
"aj" = (/turf/simulated/floor/plating/airless{broken = 1; icon_state = "panelscorched"},/area/vault/asteroid)
"ak" = (/obj/structure/catwalk,/turf/space,/area/vault/asteroid)
"al" = (/obj/item/stack/tile/plasteel,/turf/simulated/floor/plating/airless{broken = 1; icon_state = "platingdmg1"},/area/vault/asteroid)
"am" = (/obj/machinery/door/mineral/wood,/turf/simulated/floor/plating,/area/vault/asteroid)
"an" = (/obj/structure/lattice,/turf/space,/area)
"ao" = (/turf/simulated/wall/r_wall,/area/vault/asteroid)
"ap" = (/obj/structure/reagent_dispensers/bloodkeg,/obj/structure/table/woodentable,/turf/simulated/floor/wood,/area/vault/asteroid)
"aq" = (/obj/structure/table/woodentable,/obj/item/weapon/reagent_containers/food/drinks/drinkingglass,/obj/item/weapon/reagent_containers/food/drinks/drinkingglass,/obj/item/weapon/reagent_containers/food/drinks/drinkingglass,/obj/item/weapon/reagent_containers/food/drinks/ice{pixel_x = 12; pixel_y = 2},/turf/simulated/floor/wood,/area/vault/asteroid)
"ar" = (/obj/structure/table/woodentable,/turf/simulated/floor/wood,/area/vault/asteroid)
"as" = (/obj/item/weapon/stool,/turf/simulated/floor/wood,/area/vault/asteroid)
"at" = (/turf/simulated/floor/wood,/area/vault/asteroid)
"au" = (/obj/structure/bookcase,/turf/simulated/floor/wood,/area/vault/asteroid)
"av" = (/obj/structure/bookcase,/mob/living/simple_animal/hostile/scarybat/book/woody,/turf/simulated/floor/wood,/area/vault/asteroid)
"aw" = (/obj/effect/decal/cleanable/cockroach_remains,/obj/structure/cult/pylon,/obj/effect/decal/cleanable/cobweb,/turf/simulated/floor/plating,/area/vault/asteroid)
"ax" = (/obj/item/weapon/cigbutt,/obj/effect/decal/cleanable/blood/drip,/turf/simulated/floor/plating,/area/vault/asteroid)
"ay" = (/obj/structure/window/reinforced{dir = 8},/obj/effect/decal/cleanable/cockroach_remains,/turf/simulated/floor/plating,/area/vault/asteroid)
"az" = (/obj/structure/window/reinforced/plasma{dir = 4},/turf/simulated/floor/plating,/area/vault/asteroid)
"aA" = (/obj/item/weapon/shard{icon_state = "small"},/obj/effect/decal/cleanable/blood/drip,/obj/effect/decal/cleanable/blood,/turf/simulated/floor/wood,/area/vault/asteroid)
"aB" = (/obj/item/weapon/stool,/turf/simulated/floor/carpet,/area/vault/asteroid)
"aC" = (/turf/simulated/floor/carpet,/area/vault/asteroid)
"aD" = (/turf/simulated/floor/wood{broken = 1; icon_state = "wood-broken6"},/area/vault/asteroid)
"aE" = (/obj/effect/decal/cleanable/spiderling_remains,/obj/structure/table/woodentable,/obj/item/candle,/turf/simulated/floor/plating,/area/vault/asteroid)
"aF" = (/obj/effect/decal/cleanable/blood,/turf/simulated/floor/plating,/area/vault/asteroid)
"aG" = (/obj/machinery/door/window/brigdoor{dir = 8; id_tag = ""; name = "Cell 1"; req_access_txt = "2"},/turf/simulated/floor/plating,/area/vault/asteroid)
"aH" = (/obj/structure/window/reinforced/plasma{dir = 4},/obj/item/weapon/reagent_containers/food/snacks/meat/spiderleg,/turf/simulated/floor/plating,/area/vault/asteroid)
"aI" = (/obj/effect/decal/cleanable/blood/drip,/turf/simulated/floor/wood,/area/vault/asteroid)
"aJ" = (/obj/item/weapon/reagent_containers/food/snacks/meat/roach,/obj/item/weapon/stool,/obj/effect/decal/remains/xeno{desc = "They look like the remains of something... unholy. They have a strange aura about them."},/turf/simulated/floor/plating,/area/vault/asteroid)
"aK" = (/obj/item/weapon/storage/fancy/cigarettes,/turf/simulated/floor/plating,/area/vault/asteroid)
"aL" = (/obj/structure/window/reinforced{dir = 8},/turf/simulated/floor/plating,/area/vault/asteroid)
"aM" = (/obj/item/weapon/shard/plasma,/turf/simulated/floor/plating,/area/vault/asteroid)
"aN" = (/obj/item/stack/rods,/turf/space,/area)
"aO" = (/obj/structure/catwalk,/turf/space,/area)
"aP" = (/turf/simulated/floor/plating,/area/vault/asteroid)
"aQ" = (/obj/effect/decal/cleanable/spiderling_remains,/obj/item/weapon/storage/fancy/matchbox/empty,/obj/effect/decal/cleanable/blood/drip,/turf/simulated/floor/plating,/area/vault/asteroid)
"aR" = (/obj/effect/decal/cleanable/blood/drip,/obj/effect/decal/cleanable/vomit,/turf/simulated/floor/wood,/area/vault/asteroid)
"aS" = (/obj/structure/cult/pylon,/turf/simulated/floor/wood{broken = 1; icon_state = "wood-broken"},/area/vault/asteroid)
"aT" = (/obj/structure/cult/pylon,/turf/simulated/floor/wood,/area/vault/asteroid)
"aU" = (/obj/effect/decal/cleanable/spiderling_remains,/obj/effect/decal/cleanable/blood/drip,/turf/simulated/floor/plating,/area/vault/asteroid)
"aV" = (/obj/structure/window/reinforced{dir = 8},/obj/effect/decal/remains/human,/obj/item/weapon/handcuffs,/obj/effect/decal/cleanable/cobweb,/turf/simulated/floor/plating,/area/vault/asteroid)
"aW" = (/obj/structure/window/reinforced/plasma{dir = 4},/obj/effect/decal/cleanable/blood/writing{desc = "It looks like a writing in blood. The blood seems to have dried a long time ago."; message = "veniam petimus"; pixel_y = 32},/obj/effect/spider/stickyweb,/turf/simulated/floor/plating,/area/vault/asteroid)
"aX" = (/obj/item/stack/medical/bruise_pack/tajaran,/obj/item/stack/medical/ointment/tajaran,/turf/simulated/floor/wood,/area/vault/asteroid)
"aY" = (/obj/structure/cage/autoclose,/obj/item/weapon/cigbutt,/mob/living/simple_animal/hostile/giant_spider/hunter,/turf/simulated/floor/plating,/area/vault/asteroid)
"aZ" = (/obj/machinery/door/window/brigdoor{dir = 8; id_tag = ""; name = "Cell 2"; req_access_txt = "2"},/obj/effect/spider/stickyweb,/turf/simulated/floor/plating,/area/vault/asteroid)
"ba" = (/obj/structure/window/reinforced/plasma{dir = 4},/obj/effect/decal/cleanable/spiderling_remains,/obj/effect/spider/stickyweb,/turf/simulated/floor/plating,/area/vault/asteroid)
"bb" = (/obj/structure/window/reinforced/plasma{dir = 4},/turf/simulated/wall,/area/vault/asteroid)
"bc" = (/obj/structure/window/reinforced/plasma{dir = 8},/turf/simulated/wall,/area/vault/asteroid)
"bd" = (/obj/effect/landmark/corpse/mime,/obj/effect/decal/cleanable/cockroach_remains,/mob/living/simple_animal/cockroach,/mob/living/simple_animal/cockroach,/mob/living/simple_animal/cockroach,/mob/living/simple_animal/cockroach,/turf/simulated/floor/plating,/area/vault/asteroid)
"be" = (/obj/structure/window/barricade{dir = 8},/turf/simulated/floor/plating,/area/vault/asteroid)
"bf" = (/obj/effect/decal/cleanable/spiderling_remains,/obj/item/weapon/cigbutt,/turf/simulated/floor/plating,/area/vault/asteroid)
"bg" = (/obj/structure/window/reinforced{dir = 8},/obj/effect/decal/cleanable/spiderling_remains,/obj/effect/spider/stickyweb,/turf/simulated/floor/plating,/area/vault/asteroid)
"bh" = (/obj/structure/window/reinforced/plasma{dir = 4},/obj/effect/spider/stickyweb,/obj/item/weapon/reagent_containers/food/snacks/meat/spiderleg,/obj/effect/decal/cleanable/cockroach_remains,/turf/simulated/floor/plating,/area/vault/asteroid)
"bi" = (/obj/structure/lattice,/obj/structure/window/reinforced/plasma{dir = 4},/turf/space,/area)
"bj" = (/turf/simulated/floor{dir = 5; icon_state = "stage_stairs"; tag = "icon-whitegreen (NORTHEAST)"},/area/vault/asteroid)
"bk" = (/obj/structure/lattice,/obj/structure/window/reinforced/plasma{dir = 8},/turf/space,/area)
"bl" = (/obj/structure/window/reinforced/plasma,/obj/structure/cage,/turf/simulated/floor/plating,/area/vault/asteroid)
"bm" = (/obj/structure/window/reinforced/plasma{dir = 4},/turf/simulated/wall/r_wall,/area/vault/asteroid)
"bn" = (/obj/structure/window/reinforced/plasma{dir = 8},/turf/simulated/wall/r_wall,/area/vault/asteroid)
"bo" = (/obj/structure/cult/pylon,/obj/structure/window/reinforced/plasma,/turf/simulated/floor/plating,/area/vault/asteroid)
"bp" = (/obj/structure/window/reinforced/plasma,/obj/item/weapon/paper/crumpled/bloody{info = "Only one artifact is real, all the others are fake. Don't make the same mistake that I did..."},/obj/effect/decal/remains/human,/turf/simulated/floor/plating,/area/vault/asteroid)
"bq" = (/turf/simulated/floor{icon_state = "dark"},/area/vault/asteroid)
"br" = (/obj/structure/cult/talisman,/obj/effect/landmark/catechizer_spawn,/turf/simulated/floor{icon_state = "dark"},/area/vault/asteroid)
"bs" = (/obj/effect/decal/remains/human,/turf/simulated/floor/carpet,/area/vault/asteroid)
"bt" = (/obj/structure/constructshell/cult,/turf/simulated/floor/carpet,/area/vault/asteroid)
"bu" = (/mob/living/simple_animal/hostile/faithless{faction = "mimic"; name = "The Guardian"},/turf/simulated/floor/carpet,/area/vault/asteroid)

(1,1,1) = {"
aaaaaaaaaaaaabaaaaaaaaaaaaaaaaaaaaaaaa
aaaaaaacacacacacadadaeadacacacacacacaa
aaaaaaacafagahahaiaeadaiahafajafagacaa
aaaaaaacahajahahakaiaiakalahagajahacaa
aaaaaaacacamacacadadadadacacacamacacaa
aaaaaaaaanakanaaaaaaaaaaaaaaanakanaaaa
acacacacacamacacacacacaaaaaoaoamaoaoaa
acapaqarasatatauavauacaaaaaoawaxayazaa
acataAaBaCaCaCaCaDatacaaaaaoaEaFaGaHaa
acaIataCaCaCaCaCatatacaaanaoaJaKaLaMaN
acaIataCaCaCaCaCataIamaOaOamaPaQaoaoaa
acaRaSaCaCaCaCaCaTatacaaanaoaUaPaVaWaa
acaXatatatatatatatatacaoaoaoaYaPaZbaaa
acacacacbbambcacacacacaobdambebfbgbhaa
aaaaaaaabibjbkaaaaaaaaaoaoaoblblaoaoaa
aaaaaaaabibjbkaaaaaaaaaaaaaaaaaaaaaaaa
aaaaaaaabibjbkaaaaaaaaaaaaaaaaaaaaaaaa
aoaoaoaobmbjbnaoaoaoaoaaaaaaaaaaaaaaaa
aoboaoboaoamaoboaobpaoaaaaaaaaaaaaaaaa
aobqbqbqbqbqbqbqbqbqaoaaaaaaaaaaaaaaaa
aobrbqaCaCbsaCaCbqbraoaaaaaaaaaaaaaaaa
aobqbqbtbsbubsbtbqbqaoaaaaaaaaaaaaaaaa
aobrbqaCaCbsaCaCbqbraoaaaaaaaaaaaaaaaa
aoaoaoaoaoaoaoaoaoaoaoaaaaaaaaaaaaaaaa
"}
