//MAP CONVERTED BY dmm2tgm.py THIS HEADER COMMENT PREVENTS RECONVERSION, DO NOT REMOVE
"a" = (
/turf/template_noop,
/area/template_noop)
"b" = (
/obj/structure/filingcabinet/security,
/obj/structure/noticeboard/directional/south,
/turf/open/floor/iron/dark,
/area/ruin/syndicate_lava_base/telecomms)
"c" = (
/obj/structure/filingcabinet/security,
/turf/open/floor/iron/dark,
/area/ruin/syndicate_lava_base/telecomms)
"e" = (
/obj/effect/spawner/structure/window/reinforced/plasma/plastitanium,
/obj/machinery/door/firedoor,
/obj/machinery/door/poddoor/preopen{
	id = "lavalandsyndi_telecomms"
	},
/turf/open/floor/plating,
/area/ruin/syndicate_lava_base/telecomms)
"f" = (
/turf/closed/wall/mineral/plastitanium/nodiagonal,
/area/ruin/syndicate_lava_base/telecomms)
"j" = (
/turf/open/floor/circuit/green,
/area/ruin/syndicate_lava_base/telecomms)
"m" = (
/obj/effect/turf_decal/tile/neutral/fourcorners,
/obj/machinery/atmospherics/pipe/smart/manifold4w/scrubbers/hidden/layer2,
/turf/open/floor/iron/dark,
/area/ruin/syndicate_lava_base/telecomms)
"n" = (
/obj/machinery/telecomms/relay/preset/ruskie{
	use_power = 0
	},
/obj/effect/turf_decal/tile/neutral/fourcorners,
/turf/open/floor/iron/dark,
/area/ruin/syndicate_lava_base/telecomms)
"o" = (
/obj/effect/turf_decal/tile/neutral/fourcorners,
/turf/open/floor/iron/dark,
/area/ruin/syndicate_lava_base/telecomms)
"p" = (
/obj/structure/table/reinforced,
/obj/item/storage/toolbox/syndicate{
	pixel_y = 8
	},
/obj/item/multitool{
	pixel_y = 8
	},
/obj/machinery/button/door/directional/east{
	id = "lavalandsyndi_telecomms";
	req_access = list("syndicate");
	name = "Telecomms Blast Door Control"
	},
/turf/open/floor/iron/dark,
/area/ruin/syndicate_lava_base/telecomms)
"q" = (
/obj/structure/chair{
	dir = 8
	},
/obj/machinery/power/apc/auto_name/directional/south,
/obj/effect/mapping_helpers/apc/syndicate_access,
/obj/structure/cable,
/obj/effect/turf_decal/tile/neutral/fourcorners,
/turf/open/floor/iron/dark,
/area/ruin/syndicate_lava_base/telecomms)
"v" = (
/obj/effect/mapping_helpers/airalarm/syndicate_access,
/obj/machinery/airalarm/directional/east,
/turf/open/floor/circuit/green,
/area/ruin/syndicate_lava_base/telecomms)
"x" = (
/obj/machinery/atmospherics/pipe/smart/manifold4w/supply/hidden/layer4,
/obj/machinery/atmospherics/pipe/smart/manifold4w/scrubbers/hidden/layer2,
/obj/structure/cable,
/obj/effect/turf_decal/tile/neutral/fourcorners,
/turf/open/floor/iron/dark,
/area/ruin/syndicate_lava_base/telecomms)
"B" = (
/obj/effect/turf_decal/tile/neutral/fourcorners,
/obj/machinery/atmospherics/components/unary/vent_pump/on/layer4,
/turf/open/floor/iron/dark,
/area/ruin/syndicate_lava_base/telecomms)
"C" = (
/obj/effect/turf_decal/tile/neutral/fourcorners,
/obj/machinery/atmospherics/components/unary/vent_scrubber/on/layer2{
	dir = 1
	},
/turf/open/floor/iron/dark,
/area/ruin/syndicate_lava_base/telecomms)
"E" = (
/obj/machinery/atmospherics/pipe/smart/manifold4w/supply/hidden/layer4,
/obj/machinery/atmospherics/pipe/smart/manifold4w/scrubbers/hidden/layer2,
/obj/structure/cable,
/obj/machinery/door/airlock/hatch{
	name = "Telecommunications"
	},
/obj/effect/mapping_helpers/airlock/access/all/syndicate/general,
/obj/modular_map_connector,
/turf/template_noop,
/area/ruin/syndicate_lava_base/telecomms)
"G" = (
/obj/item/radio/intercom/directional/north{
	freerange = 1;
	name = "Syndicate Radio Intercom"
	},
/obj/machinery/computer/camera_advanced,
/turf/open/floor/iron/dark,
/area/ruin/syndicate_lava_base/telecomms)
"K" = (
/obj/effect/turf_decal/tile/neutral/fourcorners,
/obj/machinery/atmospherics/pipe/smart/manifold4w/scrubbers/hidden/layer2,
/obj/machinery/atmospherics/pipe/smart/manifold4w/supply/hidden/layer4,
/turf/open/floor/iron/dark,
/area/ruin/syndicate_lava_base/telecomms)
"N" = (
/obj/machinery/firealarm/directional/west,
/obj/effect/turf_decal/tile/neutral/fourcorners,
/obj/effect/mapping_helpers/airalarm/syndicate_access,
/obj/machinery/airalarm/directional/south,
/turf/open/floor/iron/dark,
/area/ruin/syndicate_lava_base/telecomms)
"O" = (
/obj/machinery/door/airlock/hatch{
	name = "Telecommunications Control"
	},
/obj/effect/mapping_helpers/airlock/access/all/syndicate/general,
/obj/effect/turf_decal/tile/neutral/fourcorners,
/turf/open/floor/iron/dark,
/area/ruin/syndicate_lava_base/telecomms)
"U" = (
/obj/machinery/light/small/directional/east,
/obj/effect/turf_decal/tile/neutral/fourcorners,
/turf/open/floor/iron/dark,
/area/ruin/syndicate_lava_base/telecomms)
"V" = (
/obj/machinery/computer/message_monitor,
/obj/item/paper/monitorkey,
/turf/open/floor/iron/dark,
/area/ruin/syndicate_lava_base/telecomms)
"W" = (
/obj/structure/table/reinforced,
/obj/item/paper_bin{
	pixel_y = 8
	},
/obj/item/pen,
/turf/open/floor/iron/dark,
/area/ruin/syndicate_lava_base/telecomms)
"Y" = (
/obj/machinery/light/small/directional/west,
/obj/effect/turf_decal/tile/neutral/fourcorners,
/turf/open/floor/iron/dark,
/area/ruin/syndicate_lava_base/telecomms)
"Z" = (
/obj/effect/turf_decal/tile/neutral/fourcorners,
/obj/structure/chair/office{
	dir = 1
	},
/turf/open/floor/iron/dark,
/area/ruin/syndicate_lava_base/telecomms)

(1,1,1) = {"
a
f
f
f
f
f
a
a
"}
(2,1,1) = {"
f
f
j
n
j
f
f
a
"}
(3,1,1) = {"
f
j
j
o
v
j
f
a
"}
(4,1,1) = {"
f
f
f
O
f
f
f
a
"}
(5,1,1) = {"
a
f
G
o
Y
N
f
f
"}
(6,1,1) = {"
a
e
V
Z
m
C
b
f
"}
(7,1,1) = {"
a
e
W
B
K
o
c
f
"}
(8,1,1) = {"
a
e
p
U
x
q
f
f
"}
(9,1,1) = {"
a
a
a
a
E
a
a
a
"}
