//MAP CONVERTED BY dmm2tgm.py THIS HEADER COMMENT PREVENTS RECONVERSION, DO NOT REMOVE
"bY" = (
/obj/machinery/power/energy_accumulator/grounding_rod,
/obj/machinery/atmospherics/pipe/smart/manifold4w/scrubbers/hidden/layer2,
/turf/open/floor/iron/dark,
/area/station/engineering/supermatter/room)
"ch" = (
/obj/effect/turf_decal/stripes/line{
	dir = 9
	},
/turf/open/floor/plating,
/area/station/engineering/supermatter/room)
"ck" = (
/obj/effect/spawner/structure/window/reinforced/plasma,
/obj/structure/cable,
/obj/machinery/atmospherics/pipe/smart/manifold4w/supply/hidden/layer4,
/obj/machinery/atmospherics/pipe/smart/manifold4w/scrubbers/hidden/layer2,
/turf/open/floor/plating,
/area/station/engineering/supermatter/room)
"cT" = (
/obj/structure/cable,
/obj/machinery/atmospherics/components/unary/vent_scrubber/on/layer2{
	dir = 1
	},
/turf/open/floor/iron/dark,
/area/station/engineering/supermatter/room)
"dc" = (
/obj/structure/lattice,
/turf/open/space/basic,
/area/space/nearstation)
"dx" = (
/obj/machinery/light/directional/south,
/turf/open/floor/plating,
/area/station/engineering/supermatter/room)
"eg" = (
/turf/open/floor/carpet/black,
/area/station/engineering/supermatter/room)
"eH" = (
/obj/effect/spawner/structure/window/reinforced/plasma,
/obj/machinery/atmospherics/pipe/smart/manifold4w/supply/hidden/layer4,
/turf/open/floor/plating,
/area/station/engineering/supermatter/room)
"eI" = (
/obj/machinery/door/firedoor,
/obj/structure/cable,
/obj/machinery/atmospherics/pipe/smart/manifold4w/yellow/visible,
/obj/machinery/door/airlock/engineering/glass{
	name = "Supermatter Engine Room"
	},
/obj/machinery/atmospherics/pipe/smart/manifold4w/scrubbers/hidden/layer2,
/obj/effect/mapping_helpers/airlock/access/all/engineering/general,
/turf/open/floor/iron/dark,
/area/station/engineering/supermatter/room)
"eO" = (
/obj/structure/grille,
/turf/open/space/basic,
/area/space/nearstation)
"fL" = (
/obj/structure/chair/sofa/corp,
/turf/open/floor/carpet/black,
/area/station/engineering/supermatter/room)
"gQ" = (
/obj/machinery/the_singularitygen,
/turf/open/floor/iron/dark,
/area/station/engineering/supermatter/room)
"gU" = (
/turf/open/floor/plating,
/area/space/nearstation)
"gY" = (
/obj/structure/cable,
/obj/structure/cable,
/obj/structure/cable,
/obj/machinery/atmospherics/pipe/smart/manifold4w/supply/hidden/layer4,
/obj/machinery/atmospherics/pipe/smart/manifold4w/scrubbers/hidden/layer2,
/turf/open/floor/iron/dark,
/area/station/engineering/supermatter/room)
"hT" = (
/obj/machinery/power/rad_collector,
/obj/machinery/atmospherics/components/unary/vent_pump/on/layer4{
	dir = 8
	},
/turf/open/floor/iron/dark,
/area/station/engineering/supermatter/room)
"iG" = (
/obj/effect/turf_decal/stripes/line{
	dir = 1
	},
/turf/open/floor/iron,
/area/station/engineering/supermatter/room)
"iY" = (
/obj/structure/cable,
/obj/machinery/atmospherics/components/unary/vent_scrubber/on/layer2{
	dir = 4
	},
/turf/open/floor/iron/dark,
/area/station/engineering/supermatter/room)
"je" = (
/turf/template_noop,
/area/template_noop)
"kf" = (
/obj/machinery/door/firedoor,
/obj/machinery/door/airlock/engineering/glass{
	name = "Supermatter Engine Room"
	},
/obj/effect/mapping_helpers/airlock/access/all/engineering/general,
/obj/structure/cable,
/turf/open/floor/plating,
/area/station/engineering/supermatter/room)
"kJ" = (
/obj/structure/cable,
/obj/structure/lattice/catwalk,
/turf/open/space/basic,
/area/space/nearstation)
"kO" = (
/obj/effect/spawner/structure/window/reinforced/plasma,
/turf/open/floor/plating,
/area/station/engineering/supermatter/room)
"lj" = (
/obj/machinery/atmospherics/pipe/heat_exchanging/junction,
/obj/effect/spawner/structure/window/reinforced/plasma,
/turf/open/floor/plating,
/area/station/engineering/supermatter/room)
"mO" = (
/obj/structure/lattice/catwalk,
/turf/open/space/basic,
/area/space/nearstation)
"nd" = (
/obj/machinery/door/firedoor,
/obj/machinery/atmospherics/pipe/smart/manifold4w/yellow/visible,
/obj/machinery/door/airlock/engineering/glass{
	name = "Supermatter Engine Room"
	},
/obj/effect/mapping_helpers/airlock/access/all/engineering/general,
/obj/machinery/atmospherics/pipe/smart/manifold4w/supply/hidden/layer4,
/obj/machinery/atmospherics/pipe/smart/manifold4w/scrubbers/hidden/layer2,
/turf/open/floor/iron/dark,
/area/station/engineering/supermatter/room)
"np" = (
/obj/machinery/the_singularitygen/tesla,
/turf/open/floor/iron/dark,
/area/station/engineering/supermatter/room)
"qx" = (
/obj/machinery/light/directional/west,
/obj/machinery/airalarm/directional/south,
/turf/open/floor/carpet/black,
/area/station/engineering/supermatter/room)
"qz" = (
/obj/machinery/door/firedoor,
/obj/structure/cable,
/obj/machinery/door/airlock/engineering/glass{
	name = "Supermatter Engine Room"
	},
/obj/machinery/atmospherics/pipe/smart/manifold4w/supply/hidden/layer4,
/obj/machinery/atmospherics/pipe/smart/manifold4w/scrubbers/hidden/layer2,
/obj/effect/mapping_helpers/airlock/access/all/engineering/general,
/turf/open/floor/iron/dark,
/area/station/engineering/supermatter/room)
"rn" = (
/obj/machinery/power/energy_accumulator/tesla_coil,
/turf/open/floor/iron/dark,
/area/station/engineering/supermatter/room)
"sB" = (
/obj/structure/sign/warning/secure_area,
/turf/closed/wall/r_wall,
/area/station/engineering/supermatter/room)
"sR" = (
/obj/structure/cable,
/obj/machinery/door/airlock/engineering/glass{
	name = "Supermatter Engine Room"
	},
/obj/effect/mapping_helpers/airlock/access/all/engineering/general,
/obj/machinery/atmospherics/pipe/smart/manifold4w/supply/hidden/layer4,
/obj/machinery/atmospherics/pipe/smart/manifold4w/scrubbers/hidden/layer2,
/turf/open/floor/iron/dark,
/area/station/engineering/supermatter/room)
"tg" = (
/obj/structure/particle_accelerator/particle_emitter/center{
	dir = 4
	},
/obj/effect/turf_decal/stripes/line{
	dir = 4
	},
/turf/open/floor/plating,
/area/station/engineering/supermatter/room)
"to" = (
/obj/structure/cable,
/obj/machinery/atmospherics/components/unary/vent_pump/on/layer4{
	dir = 8
	},
/turf/open/floor/iron/dark,
/area/station/engineering/supermatter/room)
"ut" = (
/obj/structure/particle_accelerator/particle_emitter/right{
	dir = 4
	},
/obj/effect/turf_decal/stripes/line{
	dir = 5
	},
/turf/open/floor/plating,
/area/station/engineering/supermatter/room)
"vM" = (
/obj/effect/turf_decal/stripes/line{
	dir = 1
	},
/obj/machinery/light/directional/north,
/turf/open/floor/iron,
/area/station/engineering/supermatter/room)
"vY" = (
/obj/machinery/power/energy_accumulator/grounding_rod,
/turf/open/floor/iron/dark,
/area/station/engineering/supermatter/room)
"wo" = (
/obj/structure/sign/warning/no_smoking,
/turf/closed/wall/r_wall,
/area/station/engineering/supermatter/room)
"wE" = (
/obj/structure/table/reinforced,
/obj/item/flashlight/lamp,
/turf/open/floor/carpet/black,
/area/station/engineering/supermatter/room)
"yn" = (
/obj/structure/particle_accelerator/fuel_chamber{
	dir = 4
	},
/obj/structure/cable,
/obj/machinery/atmospherics/pipe/smart/manifold4w/supply/hidden/layer4,
/obj/machinery/atmospherics/pipe/smart/manifold4w/scrubbers/hidden/layer2,
/turf/open/floor/plating,
/area/station/engineering/supermatter/room)
"yo" = (
/obj/machinery/door/firedoor,
/obj/machinery/door/airlock/engineering/glass{
	name = "Supermatter Engine Room"
	},
/obj/machinery/atmospherics/pipe/smart/simple/orange/hidden,
/obj/effect/mapping_helpers/airlock/access/all/engineering/general,
/turf/open/floor/plating,
/area/station/engineering/supermatter/room)
"yt" = (
/obj/effect/turf_decal/stripes/line{
	dir = 10
	},
/turf/open/floor/plating,
/area/station/engineering/supermatter/room)
"yM" = (
/turf/closed/wall/r_wall,
/area/space/nearstation)
"yR" = (
/obj/structure/cable,
/obj/machinery/atmospherics/pipe/smart/manifold4w/supply/hidden/layer4,
/obj/machinery/atmospherics/pipe/smart/manifold4w/scrubbers/hidden/layer2,
/turf/open/floor/iron/dark,
/area/station/engineering/supermatter/room)
"yT" = (
/obj/structure/chair/comfy/black{
	dir = 4
	},
/obj/machinery/atmospherics/pipe/smart/manifold4w/supply/hidden/layer4,
/obj/machinery/atmospherics/pipe/smart/manifold4w/scrubbers/hidden/layer2,
/obj/item/toy/plush/space_lizard_plushie{
	desc = "He stared into the void and listened. He didn't expect an answer...";
	name = "Chief Weh Officer"
	},
/turf/open/floor/carpet/black,
/area/station/engineering/supermatter/room)
"zq" = (
/obj/machinery/power/rad_collector,
/obj/machinery/atmospherics/pipe/smart/manifold4w/supply/hidden/layer4,
/turf/open/floor/iron/dark,
/area/station/engineering/supermatter/room)
"zC" = (
/turf/open/floor/iron/dark,
/area/station/engineering/supermatter/room)
"AG" = (
/obj/machinery/light/directional/south,
/turf/open/floor/iron/dark,
/area/station/engineering/supermatter/room)
"AZ" = (
/obj/effect/turf_decal/bot{
	dir = 1
	},
/obj/machinery/power/shieldwallgen/unlocked,
/obj/structure/cable,
/turf/open/floor/plating,
/area/space/nearstation)
"Bc" = (
/obj/machinery/atmospherics/pipe/smart/manifold4w/supply/hidden/layer4,
/obj/machinery/atmospherics/pipe/smart/manifold4w/scrubbers/hidden/layer2,
/turf/open/floor/iron/dark,
/area/station/engineering/supermatter/room)
"Bo" = (
/obj/structure/particle_accelerator/particle_emitter/left{
	dir = 4
	},
/obj/effect/turf_decal/stripes/line{
	dir = 6
	},
/turf/open/floor/plating,
/area/station/engineering/supermatter/room)
"Bx" = (
/obj/effect/turf_decal/stripes/line,
/turf/open/floor/iron,
/area/station/engineering/supermatter/room)
"BH" = (
/obj/machinery/door/airlock/external{
	name = "Solar Maintenance"
	},
/obj/effect/mapping_helpers/airlock/access/all/engineering/general,
/obj/effect/mapping_helpers/airlock/cyclelink_helper{
	dir = 4
	},
/obj/structure/cable,
/turf/open/floor/plating,
/area/station/engineering/supermatter/room)
"BQ" = (
/obj/effect/turf_decal/stripes/line{
	dir = 1
	},
/obj/structure/cable,
/obj/machinery/atmospherics/pipe/smart/manifold4w/supply/hidden/layer4,
/obj/machinery/atmospherics/pipe/smart/manifold4w/scrubbers/hidden/layer2,
/turf/open/floor/iron,
/area/station/engineering/supermatter/room)
"CG" = (
/obj/effect/turf_decal/bot_red,
/turf/open/floor/plating,
/area/space/nearstation)
"CJ" = (
/obj/structure/chair/sofa/corp/left,
/turf/open/floor/carpet/black,
/area/station/engineering/supermatter/room)
"CY" = (
/obj/effect/turf_decal/bot{
	dir = 1
	},
/turf/open/floor/plating,
/area/space/nearstation)
"DK" = (
/obj/effect/turf_decal/stripes/line,
/obj/machinery/light/directional/south,
/turf/open/floor/iron,
/area/station/engineering/supermatter/room)
"Fa" = (
/obj/structure/cable,
/obj/effect/turf_decal/stripes/line{
	dir = 1
	},
/obj/machinery/atmospherics/pipe/smart/manifold4w/supply/hidden/layer4,
/obj/machinery/atmospherics/pipe/smart/manifold4w/scrubbers/hidden/layer2,
/turf/open/floor/plating,
/area/station/engineering/supermatter/room)
"Fw" = (
/obj/effect/turf_decal/stripes/line{
	dir = 1
	},
/turf/open/floor/plating,
/area/station/engineering/supermatter/room)
"FN" = (
/obj/structure/particle_accelerator/end_cap{
	dir = 4
	},
/obj/effect/turf_decal/stripes/line{
	dir = 8
	},
/turf/open/floor/plating,
/area/station/engineering/supermatter/room)
"Gs" = (
/obj/machinery/light/directional/north,
/turf/open/floor/iron/dark,
/area/station/engineering/supermatter/room)
"GH" = (
/obj/item/kirbyplants/random,
/turf/open/floor/carpet/black,
/area/station/engineering/supermatter/room)
"GM" = (
/obj/machinery/power/rad_collector,
/turf/open/floor/iron/dark,
/area/station/engineering/supermatter/room)
"Ib" = (
/obj/effect/turf_decal/stripes/line,
/obj/machinery/atmospherics/pipe/smart/manifold4w/supply/hidden/layer4,
/obj/machinery/atmospherics/pipe/smart/manifold4w/scrubbers/hidden/layer2,
/turf/open/floor/iron,
/area/station/engineering/supermatter/room)
"Jc" = (
/obj/structure/cable,
/turf/open/floor/plating,
/area/station/engineering/supermatter/room)
"JY" = (
/obj/machinery/light/directional/west,
/obj/machinery/atmospherics/pipe/smart/manifold4w/supply/hidden/layer4,
/obj/machinery/atmospherics/pipe/smart/manifold4w/scrubbers/hidden/layer2,
/turf/open/floor/iron/dark,
/area/station/engineering/supermatter/room)
"Kt" = (
/obj/machinery/door/airlock/external{
	name = "Solar Maintenance"
	},
/obj/effect/mapping_helpers/airlock/access/all/engineering/general,
/obj/effect/mapping_helpers/airlock/cyclelink_helper{
	dir = 8
	},
/obj/structure/cable,
/turf/open/floor/plating,
/area/station/engineering/supermatter/room)
"KS" = (
/turf/open/space/basic,
/area/space/nearstation)
"Lv" = (
/obj/machinery/power/apc/auto_name/directional/south,
/obj/structure/cable,
/turf/open/floor/carpet/black,
/area/station/engineering/supermatter/room)
"Mt" = (
/obj/machinery/atmospherics/pipe/smart/manifold4w/scrubbers/hidden/layer2,
/turf/open/floor/carpet/black,
/area/station/engineering/supermatter/room)
"MT" = (
/turf/closed/wall/r_wall,
/area/station/engineering/supermatter/room)
"Nv" = (
/obj/machinery/particle_accelerator/control_box,
/obj/structure/cable,
/obj/effect/turf_decal/stripes/line,
/obj/machinery/atmospherics/pipe/smart/manifold4w/supply/hidden/layer4,
/obj/machinery/atmospherics/pipe/smart/manifold4w/scrubbers/hidden/layer2,
/turf/open/floor/plating,
/area/station/engineering/supermatter/room)
"NA" = (
/obj/structure/particle_accelerator/power_box{
	dir = 4
	},
/turf/open/floor/plating,
/area/station/engineering/supermatter/room)
"NN" = (
/obj/machinery/atmospherics/pipe/smart/manifold4w/scrubbers/hidden/layer2,
/turf/open/floor/iron/dark,
/area/station/engineering/supermatter/room)
"NS" = (
/obj/machinery/atmospherics/components/unary/vent_scrubber/on/layer2,
/turf/open/floor/carpet/black,
/area/station/engineering/supermatter/room)
"OC" = (
/obj/effect/turf_decal/stripes/line{
	dir = 1
	},
/obj/machinery/atmospherics/pipe/smart/manifold4w/supply/hidden/layer4,
/obj/machinery/atmospherics/pipe/smart/manifold4w/scrubbers/hidden/layer2,
/turf/open/floor/iron,
/area/station/engineering/supermatter/room)
"PF" = (
/obj/machinery/door/firedoor,
/obj/machinery/door/airlock/engineering/glass{
	name = "Supermatter Engine Room"
	},
/obj/effect/mapping_helpers/airlock/access/all/engineering/general,
/obj/machinery/atmospherics/pipe/smart/manifold4w/scrubbers/hidden/layer2,
/obj/structure/cable,
/turf/open/floor/plating,
/area/station/engineering/supermatter/room)
"PU" = (
/obj/structure/cable,
/turf/open/floor/plating,
/area/space/nearstation)
"Qn" = (
/obj/structure/cable,
/obj/machinery/atmospherics/pipe/smart/manifold4w/supply/hidden/layer4,
/obj/machinery/atmospherics/pipe/smart/manifold4w/scrubbers/hidden/layer2,
/turf/open/floor/carpet/black,
/area/station/engineering/supermatter/room)
"QX" = (
/obj/structure/cable,
/obj/machinery/atmospherics/pipe/smart/manifold4w/scrubbers/hidden/layer2,
/turf/open/floor/iron/dark,
/area/station/engineering/supermatter/room)
"Sh" = (
/obj/effect/turf_decal/stripes/line,
/turf/open/floor/plating,
/area/station/engineering/supermatter/room)
"Sw" = (
/obj/structure/table/reinforced,
/turf/open/floor/carpet/black,
/area/station/engineering/supermatter/room)
"SK" = (
/obj/structure/table/reinforced,
/obj/item/pen/fountain,
/obj/item/paper{
	default_raw_text = "Jim Norton's Quebecois Coffee.         You see, in 2265 the Quebecois had finally had enough of Canada's shit, and went to the one place that wasn't corrupted by Canuckistan.Je vais au seul endroit qui n'a pas ??? corrompu par les Canadiens ... ESPACE.";
	name = "Coffee Shop";
	pixel_x = -4;
	pixel_y = 6
	},
/turf/open/floor/carpet/black,
/area/station/engineering/supermatter/room)
"SS" = (
/turf/open/floor/plating,
/area/station/engineering/supermatter/room)
"UI" = (
/obj/structure/cable,
/turf/open/floor/iron/dark,
/area/station/engineering/supermatter/room)
"Vk" = (
/obj/machinery/door/firedoor,
/obj/structure/cable,
/obj/machinery/door/airlock/engineering/glass{
	name = "Supermatter Engine Room"
	},
/obj/effect/mapping_helpers/airlock/access/all/engineering/general,
/turf/open/floor/plating,
/area/station/engineering/supermatter/room)
"WP" = (
/obj/structure/chair/sofa/corp/right,
/obj/machinery/light/directional/west,
/turf/open/floor/carpet/black,
/area/station/engineering/supermatter/room)
"WQ" = (
/obj/structure/cable,
/obj/machinery/atmospherics/components/unary/vent_pump/on/layer4{
	dir = 1
	},
/turf/open/floor/iron/dark,
/area/station/engineering/supermatter/room)
"WU" = (
/obj/machinery/power/energy_accumulator/tesla_coil,
/obj/machinery/atmospherics/components/unary/vent_scrubber/on/layer2{
	dir = 8
	},
/turf/open/floor/iron/dark,
/area/station/engineering/supermatter/room)
"Zn" = (
/obj/structure/closet/radiation,
/turf/open/floor/carpet/black,
/area/station/engineering/supermatter/room)
"ZC" = (
/obj/machinery/atmospherics/components/unary/vent_pump/on/layer4,
/turf/open/floor/carpet/black,
/area/station/engineering/supermatter/room)

(1,1,1) = {"
je
je
je
je
MT
kO
PF
kO
sB
MT
kO
Vk
kO
wo
sB
kO
kf
eH
MT
je
je
je
je
je
je
"}
(2,1,1) = {"
je
je
je
je
MT
OC
QX
Bx
MT
WP
eg
eg
eg
qx
MT
iG
UI
Ib
MT
je
je
je
je
je
je
"}
(3,1,1) = {"
je
je
je
je
kO
OC
cT
Bx
kO
fL
eg
NS
Mt
Zn
kO
iG
iY
Ib
MT
je
je
je
je
je
je
"}
(4,1,1) = {"
je
je
je
je
kO
OC
UI
Bx
kO
CJ
eg
ZC
yT
Qn
ck
BQ
yR
Ib
MT
je
je
je
je
je
je
"}
(5,1,1) = {"
MT
qz
MT
kO
MT
OC
WQ
Bx
MT
GH
wE
Sw
SK
Lv
MT
iG
to
Ib
MT
je
je
je
je
je
je
"}
(6,1,1) = {"
zC
NN
JY
Bc
nd
Bc
UI
Bx
MT
kO
kO
kO
kO
kO
MT
iG
UI
Ib
MT
je
je
je
je
je
je
"}
(7,1,1) = {"
rn
bY
zq
GM
kO
OC
UI
DK
MT
Gs
zC
zC
zC
AG
MT
vM
UI
Ib
MT
je
je
je
je
je
je
"}
(8,1,1) = {"
rn
WU
hT
GM
kO
OC
iY
Bx
MT
zC
ch
FN
yt
zC
MT
iG
iY
Bc
yo
je
je
je
je
je
je
"}
(9,1,1) = {"
rn
vY
GM
GM
kO
OC
yR
yR
sR
yR
Fa
yn
Nv
yR
sR
yR
gY
Ib
MT
je
je
je
je
je
je
"}
(10,1,1) = {"
zC
np
gQ
zC
eI
Bc
to
Bx
MT
zC
Fw
NA
Sh
zC
MT
iG
to
Ib
lj
je
je
je
je
je
je
"}
(11,1,1) = {"
je
MT
MT
kO
MT
OC
UI
Bx
MT
zC
ut
tg
Bo
zC
MT
iG
UI
Ib
kO
je
je
je
je
je
je
"}
(12,1,1) = {"
je
je
je
je
kO
OC
UI
Bx
MT
Gs
zC
zC
zC
AG
MT
iG
UI
Ib
lj
je
je
je
je
je
je
"}
(13,1,1) = {"
je
je
je
je
MT
kO
BH
kO
MT
kO
kO
kO
kO
kO
MT
kO
BH
kO
MT
je
je
je
je
je
je
"}
(14,1,1) = {"
je
je
je
je
MT
SS
Jc
dx
MT
mO
mO
dc
mO
mO
MT
SS
Jc
dx
MT
je
je
je
je
je
je
"}
(15,1,1) = {"
je
je
je
je
MT
kO
Kt
kO
MT
mO
dc
KS
dc
mO
MT
kO
Kt
kO
MT
je
je
je
je
je
je
"}
(16,1,1) = {"
je
je
je
je
je
mO
kJ
mO
eO
dc
KS
KS
KS
dc
eO
mO
kJ
mO
je
je
je
je
je
je
je
"}
(17,1,1) = {"
je
je
je
je
je
mO
kJ
kJ
kJ
kJ
kJ
kJ
kJ
kJ
kJ
kJ
kJ
mO
je
je
je
je
je
je
je
"}
(18,1,1) = {"
je
je
je
je
je
mO
mO
mO
kJ
mO
mO
mO
mO
mO
kJ
mO
mO
mO
je
je
je
je
je
je
je
"}
(19,1,1) = {"
je
je
je
je
je
eO
mO
mO
AZ
gU
dc
dc
dc
gU
AZ
mO
mO
eO
je
je
je
je
je
je
je
"}
(20,1,1) = {"
je
je
je
je
je
yM
mO
mO
PU
CY
gU
dc
gU
CY
PU
mO
mO
yM
je
je
je
je
je
je
je
"}
(21,1,1) = {"
je
je
je
je
je
yM
mO
PU
PU
gU
dc
dc
dc
gU
PU
PU
mO
yM
je
je
je
je
je
je
je
"}
(22,1,1) = {"
je
je
je
je
je
eO
mO
PU
PU
dc
dc
CG
dc
dc
PU
PU
mO
eO
je
je
je
je
je
je
je
"}
(23,1,1) = {"
je
je
je
je
je
yM
mO
PU
PU
gU
dc
dc
dc
gU
PU
PU
mO
yM
je
je
je
je
je
je
je
"}
(24,1,1) = {"
je
je
je
je
je
yM
mO
mO
PU
CY
gU
dc
gU
CY
PU
mO
mO
yM
je
je
je
je
je
je
je
"}
(25,1,1) = {"
je
je
je
je
je
eO
mO
mO
AZ
gU
dc
dc
dc
gU
AZ
mO
mO
eO
je
je
je
je
je
je
je
"}
(26,1,1) = {"
je
je
je
je
je
mO
mO
mO
mO
mO
mO
mO
mO
mO
mO
mO
mO
mO
je
je
je
je
je
je
je
"}
(27,1,1) = {"
je
je
je
je
je
yM
mO
mO
mO
mO
mO
mO
mO
mO
mO
mO
mO
yM
je
je
je
je
je
je
je
"}
(28,1,1) = {"
je
je
je
je
je
yM
yM
mO
eO
eO
eO
eO
eO
eO
eO
mO
yM
yM
je
je
je
je
je
je
je
"}
(29,1,1) = {"
je
je
je
je
je
je
je
je
je
je
je
je
je
je
je
je
je
je
je
je
je
je
je
je
je
"}
(30,1,1) = {"
je
je
je
je
je
je
je
je
je
je
je
je
je
je
je
je
je
je
je
je
je
je
je
je
je
"}
(31,1,1) = {"
je
je
je
je
je
je
je
je
je
je
je
je
je
je
je
je
je
je
je
je
je
je
je
je
je
"}
(32,1,1) = {"
je
je
je
je
je
je
je
je
je
je
je
je
je
je
je
je
je
je
je
je
je
je
je
je
je
"}
(33,1,1) = {"
je
je
je
je
je
je
je
je
je
je
je
je
je
je
je
je
je
je
je
je
je
je
je
je
je
"}
