"aa" = (/turf/open/space,/area/space)
"ab" = (/turf/closed/wall/shuttle/smooth,/area/shuttle/escape)
"ac" = (/obj/structure/grille,/obj/structure/window/shuttle,/turf/open/floor/plating,/area/shuttle/escape)
"ad" = (/obj/structure/table/wood,/obj/item/device/flashlight/lamp/green,/turf/open/floor/carpet,/area/shuttle/escape)
"ae" = (/obj/structure/chair/comfy/brown{dir = 1},/turf/open/floor/carpet,/area/shuttle/escape)
"af" = (/obj/machinery/computer/emergency_shuttle,/turf/open/floor/carpet,/area/shuttle/escape)
"ag" = (/obj/structure/table/wood,/obj/item/weapon/storage/fancy/cigarettes/cigars/havana,/obj/item/weapon/lighter{step_x = -4; step_y = 6},/turf/open/floor/carpet,/area/shuttle/escape)
"ah" = (/obj/machinery/computer/atmos_alert,/turf/open/floor/carpet,/area/shuttle/escape)
"ai" = (/obj/structure/chair/comfy/brown{dir = 8},/turf/open/floor/carpet,/area/shuttle/escape)
"aj" = (/turf/open/floor/carpet,/area/shuttle/escape)
"ak" = (/obj/structure/chair/comfy/brown{dir = 4},/turf/open/floor/carpet,/area/shuttle/escape)
"al" = (/obj/machinery/computer/security,/turf/open/floor/carpet,/area/shuttle/escape)
"am" = (/obj/machinery/computer/crew,/turf/open/floor/carpet,/area/shuttle/escape)
"an" = (/obj/structure/extinguisher_cabinet{pixel_x = 0; pixel_y = -30},/obj/structure/chair/comfy/brown{dir = 8},/turf/open/floor/carpet,/area/shuttle/escape)
"ao" = (/obj/item/device/radio/intercom{name = "Station Intercom (General)"; pixel_x = 0; pixel_y = -29},/turf/open/floor/carpet,/area/shuttle/escape)
"ap" = (/obj/machinery/button/flasher{id = "cockpit_flasher"; pixel_x = 6; pixel_y = -24},/obj/structure/statue/diamond/captain,/turf/open/floor/carpet,/area/shuttle/escape)
"aq" = (/obj/machinery/computer/communications,/turf/open/floor/carpet,/area/shuttle/escape)
"ar" = (/obj/machinery/door/airlock/glass{name = "Emergency Shuttle Cockpit"; req_access_txt = "19"},/turf/open/floor/carpet,/area/shuttle/escape)
"as" = (/obj/machinery/status_display,/turf/closed/wall/shuttle/smooth,/area/shuttle/escape)
"at" = (/obj/structure/chair,/turf/open/floor/plasteel/shuttle/red,/area/shuttle/escape)
"au" = (/obj/machinery/flasher{id = "cockpit_flasher"; pixel_x = 6; pixel_y = 24},/obj/structure/flora/kirbyplants{icon_state = "plant-10"; layer = 4.1},/turf/open/floor/plasteel/bar,/area/shuttle/escape)
"av" = (/turf/open/floor/plasteel/bar,/area/shuttle/escape)
"aw" = (/obj/structure/closet/emcloset,/turf/open/floor/plasteel/bar,/area/shuttle/escape)
"ax" = (/obj/structure/table,/obj/item/weapon/storage/firstaid/fire,/obj/item/weapon/storage/firstaid/regular{pixel_x = 2; pixel_y = 3},/obj/item/weapon/crowbar,/turf/open/floor/plasteel/bar,/area/shuttle/escape)
"ay" = (/obj/machinery/flasher{id = "shuttle_flasher"; pixel_x = -24; pixel_y = 6},/obj/machinery/button/flasher{id = "shuttle_flasher"; pixel_x = -24; pixel_y = -6},/turf/open/floor/plasteel/shuttle/red,/area/shuttle/escape)
"az" = (/turf/open/floor/plasteel/shuttle/red,/area/shuttle/escape)
"aA" = (/obj/machinery/door/airlock/glass{name = "Emergency Shuttle Brig"; req_access_txt = "2"},/turf/open/floor/plasteel/bar,/area/shuttle/escape)
"aB" = (/obj/machinery/door/airlock/shuttle{name = "Emergency Shuttle Airlock"; req_access_txt = "2"},/turf/open/floor/plating,/area/shuttle/escape)
"aC" = (/obj/structure/extinguisher_cabinet{pixel_x = 0; pixel_y = -30},/turf/open/floor/plasteel/shuttle/red,/area/shuttle/escape)
"aD" = (/obj/structure/chair{dir = 1},/turf/open/floor/plasteel/shuttle/red,/area/shuttle/escape)
"aE" = (/obj/structure/chair/wood{dir = 4},/turf/open/floor/plasteel/bar,/area/shuttle/escape)
"aF" = (/obj/structure/table/wood,/turf/open/floor/plasteel/bar,/area/shuttle/escape)
"aG" = (/obj/structure/extinguisher_cabinet{pixel_x = 27; pixel_y = 0},/obj/structure/table,/obj/item/weapon/storage/firstaid/toxin,/turf/open/floor/plasteel/bar,/area/shuttle/escape)
"aH" = (/obj/machinery/door/airlock/shuttle{name = "Emergency Shuttle Airlock"},/obj/docking_port/mobile/emergency,/obj/docking_port/stationary{dir = 4; dwidth = 9; height = 11; id = "emergency_home"; name = "emergency evac bay"; width = 22},/turf/open/floor/plating,/area/shuttle/escape)
"aI" = (/obj/structure/table,/obj/machinery/chem_dispenser/drinks/beer,/turf/open/floor/plasteel/bar,/area/shuttle/escape)
"aJ" = (/obj/structure/chair,/turf/open/floor/plasteel/bar,/area/shuttle/escape)
"aK" = (/obj/structure/table/wood,/obj/item/clothing/head/collectable/tophat,/turf/open/floor/plasteel/bar,/area/shuttle/escape)
"aL" = (/mob/living/simple_animal/drone{desc = "A barkeeping drone, an indestructible robot built to tend bars."; dir = 8; health = 3000; languages = 127; laws = "1. Serve drinks. 2. Talk to patrons. 3. Don't get messed up in their affairs."; maxHealth = 3000; name = "Bardrone"; seeStatic = 0},/turf/open/floor/plasteel/bar,/area/shuttle/escape)
"aM" = (/obj/machinery/vending/boozeomat,/turf/open/floor/plasteel/bar,/area/shuttle/escape)
"aN" = (/obj/structure/table,/turf/open/floor/plasteel/bar,/area/shuttle/escape)
"aO" = (/obj/structure/table,/obj/item/weapon/reagent_containers/food/condiment/saltshaker,/obj/item/weapon/reagent_containers/food/condiment/peppermill{step_x = 6; step_y = 4},/turf/open/floor/plasteel/bar,/area/shuttle/escape)
"aP" = (/obj/structure/table,/obj/machinery/chem_dispenser/drinks,/turf/open/floor/plasteel/bar,/area/shuttle/escape)
"aQ" = (/obj/structure/chair{dir = 1},/turf/open/floor/plasteel/bar,/area/shuttle/escape)
"aR" = (/obj/machinery/door/airlock/shuttle{name = "Emergency Shuttle Airlock"},/turf/open/floor/plating,/area/shuttle/escape)
"aS" = (/obj/structure/chair/stool,/turf/open/floor/wood,/area/shuttle/escape)
"aT" = (/obj/structure/table/wood/poker,/obj/effect/spawner/lootdrop{loot = list(/obj/item/weapon/gun/projectile/revolver/russian = 5, /obj/item/weapon/storage/box/syndie_kit/throwing_weapons, /obj/item/toy/cards/deck/syndicate = 2); name = "gambling valuables spawner"},/turf/open/floor/wood,/area/shuttle/escape)
"aU" = (/obj/structure/extinguisher_cabinet{pixel_x = 0; pixel_y = -30},/turf/open/floor/plasteel/bar,/area/shuttle/escape)
"aV" = (/obj/machinery/vending/cigarette,/turf/open/floor/plasteel/bar,/area/shuttle/escape)
"aW" = (/obj/machinery/door/airlock{name = "Unisex Restrooms"; req_access_txt = "0"},/turf/open/floor/plasteel{icon_state = "freezerfloor"},/area/shuttle/escape)
"aX" = (/turf/open/floor/plasteel{icon_state = "freezerfloor"},/area/shuttle/escape)
"aY" = (/obj/structure/extinguisher_cabinet{pixel_x = -5; pixel_y = 30},/turf/open/floor/plasteel{icon_state = "freezerfloor"},/area/shuttle/escape)
"aZ" = (/obj/structure/sink{dir = 4; icon_state = "sink"; pixel_x = 11; pixel_y = 0},/turf/open/floor/plasteel{icon_state = "freezerfloor"},/area/shuttle/escape)
"ba" = (/obj/machinery/door/airlock{name = "Unit 1"},/turf/open/floor/plasteel{icon_state = "freezerfloor"},/area/shuttle/escape)
"bb" = (/obj/machinery/door/airlock{name = "Unit 2"},/turf/open/floor/plasteel{icon_state = "freezerfloor"},/area/shuttle/escape)
"bc" = (/obj/machinery/door/airlock{name = "Unit B"},/turf/open/floor/plasteel{icon_state = "freezerfloor"},/area/shuttle/escape)
"bd" = (/obj/structure/closet/jcloset,/turf/open/floor/plasteel{icon_state = "freezerfloor"},/area/shuttle/escape)
"be" = (/obj/structure/toilet{dir = 1},/turf/open/floor/plasteel{icon_state = "freezerfloor"},/area/shuttle/escape)
"bf" = (/obj/machinery/recharge_station,/turf/open/floor/plasteel{icon_state = "freezerfloor"},/area/shuttle/escape)
"bg" = (/obj/structure/table,/obj/item/weapon/storage/firstaid/fire,/obj/item/weapon/storage/firstaid/regular{pixel_x = 2; pixel_y = 3},/obj/item/weapon/crowbar,/turf/open/floor/plasteel{icon_state = "freezerfloor"},/area/shuttle/escape)
"bh" = (/obj/structure/window/reinforced{dir = 1},/obj/structure/shuttle/engine/heater,/turf/open/floor/plating/airless,/area/shuttle/escape)
"bi" = (/obj/structure/shuttle/engine/propulsion,/turf/open/floor/plating/airless,/area/shuttle/escape)

(1,1,1) = {"
aaaaabacacacacacabaaaa
aaababadaeafaeagababaa
aaabahaiajajajakalabaa
aaabamanaoapajakaqabaa
ababababababarasababab
abatatatacauavavawaxac
abayazazaAavavavavavab
aBaCaDaDacavaEaFaFaFac
abababababavaEaFavaGab
aHavavavavavaEaFavaIab
abaJaJaJavavaEaKaLaMab
acaNaOaNavavaEaFavaPac
acaQaQaQavavaEaFavavac
acavavavavavaEaFaFaFac
abavavavavavavavavavab
aRavaSaTaSaUavavavaVab
ababababababababaWabab
aRaXaXaXaXaXaYaXaXaZac
abbaabbbabbcabbdaXaZab
abbeabbeabbfabbgaXaZac
ababbhbhbhbhbhbhbhabab
aaabbibibibibibibiabaa
"}
