//MAP CONVERTED BY dmm2tgm.py THIS HEADER COMMENT PREVENTS RECONVERSION, DO NOT REMOVE
"a" = (
/turf/open/floor/iron,
/area/station/engineering/main)
"b" = (
/obj/machinery/light/directional/south,
/turf/open/floor/iron/dark,
/area/station/engineering/main)
"c" = (
/obj/machinery/atmospherics/pipe/smart/manifold4w/scrubbers/hidden/layer2,
/obj/machinery/atmospherics/pipe/smart/manifold4w/supply/hidden/layer4,
/turf/open/floor/iron,
/area/station/engineering/main)
"e" = (
/obj/machinery/atmospherics/pipe/smart/manifold4w/supply/hidden/layer4,
/turf/open/floor/iron,
/area/station/engineering/main)
"f" = (
/turf/template_noop,
/area/template_noop)
"h" = (
/turf/closed/wall/r_wall,
/area/space/nearstation)
"i" = (
/obj/effect/turf_decal/stripes/line,
/obj/effect/turf_decal/stripes/line{
	dir = 1
	},
/obj/machinery/atmospherics/pipe/smart/manifold4w/scrubbers/hidden/layer2,
/obj/machinery/atmospherics/pipe/smart/manifold4w/supply/hidden/layer4,
/obj/machinery/door/firedoor,
/obj/machinery/door/airlock/engineering/glass{
	name = "Engine Room"
	},
/obj/effect/mapping_helpers/airlock/access/all/engineering/general,
/turf/open/floor/iron/dark/textured,
/area/station/engineering/main)
"l" = (
/obj/effect/turf_decal/stripes/line{
	dir = 4
	},
/obj/effect/turf_decal/stripes/line{
	dir = 8
	},
/obj/machinery/door/airlock/maintenance{
	name = "Engineering Maintenance"
	},
/obj/effect/mapping_helpers/airlock/access/all/engineering/general,
/turf/open/floor/plating,
/area/station/maintenance/department/engine)
"m" = (
/obj/structure/lattice/catwalk,
/turf/open/space/basic,
/area/space/nearstation)
"o" = (
/obj/machinery/atmospherics/components/unary/vent_scrubber/on/layer2{
	dir = 1
	},
/turf/open/floor/iron/dark,
/area/station/engineering/main)
"r" = (
/obj/structure/lattice/catwalk,
/turf/open/space,
/area/space/nearstation)
"t" = (
/obj/machinery/atmospherics/components/unary/portables_connector/visible{
	dir = 4
	},
/turf/open/floor/iron,
/area/station/engineering/main)
"v" = (
/obj/machinery/atmospherics/components/unary/vent_scrubber/on/layer2,
/turf/open/floor/iron,
/area/station/engineering/main)
"z" = (
/obj/machinery/atmospherics/pipe/smart/simple/orange/visible{
	dir = 4
	},
/obj/effect/spawner/structure/window/reinforced/plasma,
/turf/open/floor/plating,
/area/station/maintenance/department/engine)
"A" = (
/obj/structure/lattice,
/turf/open/space/basic,
/area/space/nearstation)
"B" = (
/turf/open/floor/iron/dark,
/area/station/engineering/main)
"C" = (
/turf/closed/wall/r_wall,
/area/station/maintenance/department/engine)
"D" = (
/obj/machinery/light/directional/north,
/obj/machinery/airalarm/directional/north,
/obj/structure/table,
/turf/open/floor/iron/dark,
/area/station/engineering/main)
"E" = (
/obj/effect/spawner/structure/window/reinforced,
/turf/open/floor/plating,
/area/station/engineering/main)
"F" = (
/obj/effect/turf_decal/stripes/line{
	dir = 1
	},
/obj/effect/turf_decal/stripes/line,
/obj/machinery/door/firedoor,
/obj/machinery/door/airlock/engineering/glass{
	name = "Engine Room"
	},
/obj/effect/mapping_helpers/airlock/access/all/engineering/general,
/turf/open/floor/iron/textured,
/area/station/engineering/main)
"I" = (
/turf/open/floor/plating/airless,
/area/space/nearstation)
"J" = (
/obj/machinery/door/airlock/engineering/glass{
	name = "Engine Room"
	},
/obj/machinery/atmospherics/pipe/smart/manifold4w/scrubbers/hidden/layer2,
/obj/machinery/atmospherics/pipe/smart/manifold4w/supply/hidden/layer4,
/obj/effect/mapping_helpers/airlock/access/all/engineering/general,
/obj/machinery/door/firedoor,
/obj/effect/turf_decal/stripes/line{
	dir = 4
	},
/obj/effect/turf_decal/stripes/line{
	dir = 8
	},
/turf/open/floor/iron/dark/textured,
/area/station/engineering/main)
"K" = (
/obj/structure/table,
/turf/open/floor/iron/dark,
/area/station/engineering/main)
"L" = (
/obj/structure/grille,
/turf/open/floor/plating/airless,
/area/space/nearstation)
"M" = (
/obj/machinery/atmospherics/pipe/smart/manifold4w/scrubbers/hidden/layer2,
/obj/machinery/atmospherics/pipe/smart/manifold4w/supply/hidden/layer4,
/turf/open/floor/iron/dark,
/area/station/engineering/main)
"N" = (
/obj/machinery/atmospherics/components/unary/vent_pump/on/layer4,
/turf/open/floor/iron,
/area/station/engineering/main)
"Q" = (
/obj/machinery/firealarm/directional/north,
/turf/open/floor/iron/dark,
/area/station/engineering/main)
"R" = (
/turf/closed/wall/r_wall,
/area/station/engineering/main)
"W" = (
/obj/machinery/atmospherics/components/unary/vent_pump/on/layer4{
	dir = 1
	},
/turf/open/floor/iron/dark,
/area/station/engineering/main)
"Y" = (
/obj/effect/spawner/structure/window/reinforced/plasma,
/turf/open/floor/plating,
/area/station/engineering/main)
"Z" = (
/obj/effect/spawner/structure/window/reinforced/plasma,
/turf/open/floor/plating,
/area/station/maintenance/department/engine)

(1,1,1) = {"
R
B
B
B
B
R
f
A
A
A
A
A
A
A
A
A
f
f
L
L
L
f
f
m
f
f
"}
(2,1,1) = {"
i
M
M
B
b
R
A
A
m
A
m
A
m
A
m
A
A
A
L
h
L
f
f
m
f
f
"}
(3,1,1) = {"
R
Q
M
B
B
R
f
A
m
A
m
A
m
A
m
A
f
f
L
h
L
f
f
m
f
f
"}
(4,1,1) = {"
R
K
M
W
B
E
A
A
m
A
m
A
m
A
m
A
A
A
L
h
L
f
f
m
m
f
"}
(5,1,1) = {"
R
D
M
B
B
E
f
A
m
A
m
A
m
A
m
A
f
f
L
h
L
f
f
f
m
f
"}
(6,1,1) = {"
R
K
M
o
B
E
A
A
m
A
m
A
m
A
m
A
A
A
L
h
L
f
f
f
m
f
"}
(7,1,1) = {"
R
B
M
B
B
R
f
A
m
A
m
A
m
A
m
A
f
f
L
h
L
f
L
L
m
m
"}
(8,1,1) = {"
R
B
M
B
b
R
A
A
m
A
m
A
m
A
m
A
A
A
L
h
L
A
h
L
L
f
"}
(9,1,1) = {"
R
B
M
B
B
R
f
A
m
A
m
A
m
A
m
A
f
f
L
L
L
f
h
h
L
f
"}
(10,1,1) = {"
R
Y
J
Y
R
R
R
R
R
Y
R
Y
Y
R
A
f
f
f
A
f
A
f
f
A
f
f
"}
(11,1,1) = {"
R
a
c
a
a
a
a
a
a
a
a
a
a
R
R
R
R
R
R
R
R
L
L
L
L
A
"}
(12,1,1) = {"
R
a
c
a
a
a
a
a
a
a
a
a
a
a
a
a
a
a
a
a
R
f
L
h
L
f
"}
(13,1,1) = {"
Y
a
c
a
a
a
a
a
a
a
a
a
a
a
a
a
a
a
a
a
R
f
L
h
L
f
"}
(14,1,1) = {"
Y
a
c
a
a
a
a
a
a
a
a
a
a
a
a
a
a
a
a
a
R
A
L
h
L
A
"}
(15,1,1) = {"
R
a
c
a
a
a
a
a
a
a
a
a
a
a
a
a
a
a
a
a
R
f
L
h
L
f
"}
(16,1,1) = {"
R
v
c
a
a
a
a
a
a
a
a
a
a
a
a
a
a
a
a
a
R
f
L
h
L
f
"}
(17,1,1) = {"
F
a
e
a
a
a
a
a
a
a
a
a
a
a
a
a
a
a
a
a
R
A
L
h
L
A
"}
(18,1,1) = {"
Y
a
e
a
a
a
a
a
a
a
a
a
a
a
a
a
a
a
a
a
R
f
L
h
L
f
"}
(19,1,1) = {"
F
a
e
a
a
a
a
a
a
a
a
a
a
a
a
a
a
a
a
a
R
A
L
h
L
A
"}
(20,1,1) = {"
R
N
e
a
a
a
a
a
a
a
a
a
a
a
a
a
a
a
a
a
R
f
L
h
L
f
"}
(21,1,1) = {"
R
a
a
a
a
a
a
a
a
a
a
a
a
a
a
a
a
a
a
a
R
f
L
h
L
f
"}
(22,1,1) = {"
Y
a
a
a
a
a
a
a
a
a
a
a
a
a
a
a
a
a
a
a
R
A
L
h
L
A
"}
(23,1,1) = {"
Y
a
a
a
a
a
a
a
a
a
a
a
a
a
a
a
a
a
a
a
R
f
L
h
L
f
"}
(24,1,1) = {"
R
a
a
a
a
a
a
a
a
a
a
a
a
a
a
a
a
a
a
a
R
f
L
h
L
f
"}
(25,1,1) = {"
R
a
a
t
a
a
a
a
a
a
a
a
a
R
R
R
R
R
R
R
R
A
L
L
L
A
"}
(26,1,1) = {"
C
Z
l
z
C
C
a
a
a
a
a
a
a
Y
I
I
I
I
I
I
I
f
f
A
f
f
"}
(27,1,1) = {"
f
f
f
f
f
C
a
a
a
a
a
a
a
R
r
r
r
A
A
A
A
A
A
A
A
A
"}
(28,1,1) = {"
f
f
f
f
f
C
a
a
a
a
a
a
a
R
f
f
A
f
A
h
L
f
f
f
f
f
"}
(29,1,1) = {"
f
f
f
f
f
C
R
R
R
R
Y
Y
Y
R
A
A
A
A
A
h
L
f
f
f
f
f
"}
