//MAP CONVERTED BY dmm2tgm.py THIS HEADER COMMENT PREVENTS RECONVERSION, DO NOT REMOVE
"a" = (
/turf/open/space,
/area/space)
"b" = (
/turf/open/misc/asteroid/airless,
/area/ruin/unpowered/no_grav)
"c" = (
/turf/closed/mineral/volcanic/lava_land_surface,
/area/ruin/unpowered/no_grav)
"f" = (
/obj/structure/lattice,
/turf/open/space,
/area/space)
"g" = (
/obj/item/bikehorn,
/turf/open/misc/asteroid/airless,
/area/ruin/unpowered/no_grav)
"h" = (
/turf/closed/wall/mineral/iron,
/area/ruin/unpowered/no_grav)
"i" = (
/obj/structure/rack,
/obj/item/knife/combat/survival,
/obj/effect/turf_decal/sand/plating,
/turf/open/floor/plating,
/area/ruin/unpowered/no_grav)
"j" = (
/obj/effect/turf_decal/sand/plating,
/turf/open/floor/plating,
/area/ruin/unpowered/no_grav)
"k" = (
/obj/structure/rack,
/obj/item/spear,
/obj/effect/turf_decal/sand/plating,
/turf/open/floor/plating,
/area/ruin/unpowered/no_grav)
"l" = (
/obj/structure/rack,
/obj/item/relic,
/obj/effect/turf_decal/sand/plating,
/turf/open/floor/plating,
/area/ruin/unpowered/no_grav)
"m" = (
/obj/structure/mineral_door/wood,
/obj/effect/turf_decal/sand/plating,
/turf/open/floor/plating,
/area/ruin/unpowered/no_grav)
"n" = (
/obj/structure/rack,
/obj/item/dice/d4,
/obj/effect/turf_decal/sand/plating,
/turf/open/floor/plating,
/area/ruin/unpowered/no_grav)
"o" = (
/obj/structure/rack,
/obj/item/dice/d8,
/obj/effect/turf_decal/sand/plating,
/turf/open/floor/plating,
/area/ruin/unpowered/no_grav)
"p" = (
/obj/structure/rack,
/obj/item/dice/d12,
/obj/effect/turf_decal/sand/plating,
/turf/open/floor/plating,
/area/ruin/unpowered/no_grav)
"q" = (
/obj/structure/rack,
/obj/item/dice/d00,
/obj/effect/turf_decal/sand/plating,
/turf/open/floor/plating,
/area/ruin/unpowered/no_grav)
"r" = (
/obj/structure/rack,
/obj/item/dice/d20,
/obj/effect/turf_decal/sand/plating,
/turf/open/floor/plating,
/area/ruin/unpowered/no_grav)
"s" = (
/obj/structure/statue/silver/sec,
/turf/open/floor/mineral/silver,
/area/ruin/unpowered/no_grav)
"t" = (
/obj/structure/statue/silver/md,
/turf/open/floor/mineral/silver,
/area/ruin/unpowered/no_grav)
"u" = (
/obj/structure/table/wood/fancy,
/obj/item/spear/skybulge,
/turf/open/floor/mineral/silver,
/area/ruin/unpowered/no_grav)
"v" = (
/turf/open/floor/mineral/silver,
/area/ruin/unpowered/no_grav)
"w" = (
/obj/structure/mineral_door/silver,
/turf/open/floor/mineral/silver,
/area/ruin/unpowered/no_grav)
"x" = (
/obj/structure/closet/crate/coffin,
/obj/item/stack/sheet/bone,
/turf/open/floor/mineral/silver,
/area/ruin/unpowered/no_grav)
"z" = (
/obj/structure/statue/silver/secborg,
/turf/open/floor/mineral/silver,
/area/ruin/unpowered/no_grav)
"A" = (
/obj/structure/statue/silver/medborg,
/turf/open/floor/mineral/silver,
/area/ruin/unpowered/no_grav)
"B" = (
/obj/structure/table/wood/fancy,
/obj/item/storage/box/donkpockets,
/turf/open/floor/mineral/silver,
/area/ruin/unpowered/no_grav)
"E" = (
/obj/item/dice/d10,
/turf/open/misc/asteroid/airless,
/area/ruin/unpowered/no_grav)
"F" = (
/obj/structure/grille,
/turf/open/space,
/area/ruin/unpowered/no_grav)
"G" = (
/obj/item/dice/d100,
/turf/open/misc/asteroid/airless,
/area/ruin/unpowered/no_grav)
"J" = (
/obj/item/crowbar/red,
/turf/open/misc/asteroid/airless,
/area/ruin/unpowered/no_grav)
"K" = (
/obj/item/dice/d1,
/turf/open/misc/asteroid/airless,
/area/ruin/unpowered/no_grav)

(1,1,1) = {"
a
a
a
a
a
a
a
a
a
a
a
a
a
a
a
a
a
a
a
a
a
a
a
a
a
a
a
a
a
a
a
a
a
a
a
a
a
a
a
a
"}
(2,1,1) = {"
a
a
a
a
a
a
a
a
a
a
a
a
a
a
a
a
a
a
a
a
a
a
a
a
a
a
a
a
a
a
a
a
a
a
a
a
a
a
a
a
"}
(3,1,1) = {"
a
a
a
a
a
a
a
b
b
c
c
c
c
a
a
a
a
c
c
c
c
c
b
b
b
a
a
a
a
a
a
a
a
a
a
a
a
a
a
a
"}
(4,1,1) = {"
a
a
a
a
a
a
b
b
b
c
c
c
c
c
c
c
c
c
c
c
c
c
c
c
b
b
b
c
c
c
a
a
a
a
c
c
c
a
a
a
"}
(5,1,1) = {"
a
a
a
a
a
a
b
b
c
c
c
c
c
c
c
c
c
c
c
c
c
c
c
c
c
c
c
c
c
c
c
c
c
c
c
c
c
a
a
a
"}
(6,1,1) = {"
a
a
a
a
a
b
b
b
c
c
c
c
c
c
c
c
c
c
c
b
c
c
c
c
c
c
c
c
c
b
b
b
b
c
c
c
c
c
a
a
"}
(7,1,1) = {"
a
a
a
a
b
b
b
b
b
b
b
c
b
c
c
c
c
c
b
b
c
c
b
b
c
c
c
b
c
b
c
c
b
c
c
c
c
c
a
a
"}
(8,1,1) = {"
a
b
b
b
b
b
c
c
b
b
b
b
b
b
c
c
c
c
b
b
c
c
c
b
b
c
b
b
c
c
c
c
c
c
b
c
c
a
a
a
"}
(9,1,1) = {"
a
a
c
c
c
c
c
c
c
c
c
c
c
b
c
c
c
b
b
b
b
c
c
c
b
b
b
c
c
c
c
b
c
c
b
c
c
c
a
a
"}
(10,1,1) = {"
a
a
c
c
c
c
c
c
c
c
c
c
c
b
c
c
c
b
b
b
b
c
c
c
b
b
c
c
c
c
b
b
c
c
b
c
c
c
c
a
"}
(11,1,1) = {"
a
a
a
c
c
c
c
c
b
b
b
c
c
b
b
c
c
c
c
b
E
c
b
c
b
c
c
c
c
b
b
c
c
b
b
c
c
c
a
a
"}
(12,1,1) = {"
a
a
a
c
c
c
c
b
b
b
b
c
c
b
b
b
c
c
c
c
c
c
G
c
b
c
c
c
b
b
c
c
c
b
b
c
c
b
b
a
"}
(13,1,1) = {"
a
a
a
c
c
c
c
b
b
b
b
b
c
c
b
b
b
b
c
c
c
c
c
c
b
b
c
c
b
b
c
c
c
c
c
c
c
b
a
a
"}
(14,1,1) = {"
a
a
a
c
c
c
c
b
b
c
b
b
b
c
c
c
c
b
b
b
b
b
c
c
c
b
b
c
b
c
c
c
c
c
c
b
b
a
a
a
"}
(15,1,1) = {"
a
a
a
c
c
c
c
c
b
c
c
b
g
c
c
c
c
c
b
b
b
b
c
c
c
b
b
c
b
c
c
c
c
c
c
b
b
a
a
a
"}
(16,1,1) = {"
a
a
a
c
c
c
c
c
c
c
c
b
b
b
b
c
c
c
c
c
b
b
c
b
b
c
b
c
b
c
c
b
b
b
b
b
b
a
a
a
"}
(17,1,1) = {"
a
a
a
a
c
c
c
c
c
c
b
b
b
b
c
c
c
c
c
c
c
b
b
b
c
c
b
b
b
b
b
b
b
b
b
b
b
a
a
a
"}
(18,1,1) = {"
a
a
a
a
c
c
c
c
c
b
b
c
c
c
c
f
c
c
c
c
c
b
b
c
c
b
b
b
b
b
c
c
c
c
b
b
b
a
a
a
"}
(19,1,1) = {"
a
a
a
a
c
c
c
c
c
c
c
c
a
a
a
f
a
a
f
a
a
c
b
b
c
b
b
b
b
b
b
c
c
c
c
b
b
a
a
a
"}
(20,1,1) = {"
a
a
a
a
b
b
c
c
c
c
a
a
h
h
h
h
h
h
h
h
f
c
c
b
b
b
b
c
c
b
b
c
c
c
c
c
b
a
a
a
"}
(21,1,1) = {"
a
a
a
a
b
b
b
b
c
c
c
f
h
i
j
h
n
j
j
h
a
f
c
c
b
b
b
c
c
c
b
b
c
c
c
c
b
b
a
a
"}
(22,1,1) = {"
a
a
a
a
a
b
b
b
c
c
c
a
h
j
j
m
j
j
j
h
F
F
c
c
J
b
c
c
c
c
c
b
c
c
c
c
c
c
a
a
"}
(23,1,1) = {"
a
a
a
a
a
b
b
b
c
c
a
a
h
k
j
h
o
j
j
j
j
j
j
b
b
b
c
b
b
b
c
b
c
c
c
c
c
a
a
a
"}
(24,1,1) = {"
a
a
a
a
a
a
b
b
c
c
c
a
h
h
h
h
p
j
j
j
j
j
j
b
b
b
c
c
b
b
c
b
c
c
c
c
c
a
a
a
"}
(25,1,1) = {"
a
a
a
a
a
a
b
b
b
c
c
f
h
l
j
h
q
j
j
h
F
F
c
b
b
c
c
c
b
K
c
b
c
c
c
c
c
c
a
a
"}
(26,1,1) = {"
a
a
a
a
a
a
a
b
b
c
c
a
h
j
j
m
j
j
j
h
f
c
c
b
b
c
b
c
c
c
c
b
c
b
c
c
c
c
a
a
"}
(27,1,1) = {"
a
a
a
a
a
a
a
b
b
c
c
f
h
k
j
h
r
v
j
h
a
c
b
b
c
c
b
c
c
c
c
c
c
b
c
c
b
b
a
a
"}
(28,1,1) = {"
a
a
a
a
a
a
a
b
b
c
a
f
h
h
h
h
h
w
h
h
a
c
b
c
c
b
b
c
c
b
c
c
c
b
b
b
b
b
a
a
"}
(29,1,1) = {"
a
a
a
a
a
a
a
b
b
c
a
f
a
a
a
h
s
v
z
h
f
c
b
c
b
b
c
c
c
b
c
c
c
b
c
c
c
a
a
a
"}
(30,1,1) = {"
a
a
a
a
a
a
a
a
b
c
c
c
c
f
f
h
h
v
h
h
a
c
c
c
b
b
c
b
c
b
c
c
c
b
c
c
b
b
a
a
"}
(31,1,1) = {"
a
a
a
a
a
a
a
a
a
c
c
c
c
a
a
h
t
v
A
h
a
a
c
c
c
b
c
b
c
b
b
b
b
b
c
c
b
a
a
a
"}
(32,1,1) = {"
a
a
a
a
a
a
a
a
a
c
c
c
c
c
a
h
h
v
h
h
f
f
f
c
b
b
c
c
c
c
b
b
c
c
c
c
c
a
a
a
"}
(33,1,1) = {"
a
a
a
a
a
a
a
a
a
a
c
c
c
c
f
h
u
v
B
h
a
a
c
c
b
b
b
c
c
c
b
c
c
c
c
c
c
c
a
a
"}
(34,1,1) = {"
a
a
a
a
a
a
a
a
a
a
a
c
c
c
a
h
h
x
h
h
a
a
c
c
c
b
b
c
b
b
b
c
c
c
c
c
c
c
a
a
"}
(35,1,1) = {"
a
a
a
a
a
a
a
a
a
a
a
a
a
c
c
c
h
h
h
f
a
c
c
c
c
c
b
b
b
c
c
c
c
c
c
c
c
a
a
a
"}
(36,1,1) = {"
a
a
a
a
a
a
a
a
a
a
a
a
a
a
a
c
c
c
a
f
c
c
c
c
b
b
b
b
c
c
c
c
c
c
c
a
a
a
a
a
"}
(37,1,1) = {"
a
a
a
a
a
a
a
a
a
a
a
a
a
a
a
a
c
c
c
c
c
c
b
b
b
b
b
b
b
c
c
c
c
c
a
a
a
a
a
a
"}
(38,1,1) = {"
a
a
a
a
a
a
a
a
a
a
a
a
a
a
a
a
a
a
c
c
b
b
b
b
a
a
a
a
b
b
c
c
c
a
a
a
a
a
a
a
"}
(39,1,1) = {"
a
a
a
a
a
a
a
a
a
a
a
a
a
a
a
a
a
a
a
a
b
b
a
a
a
a
a
a
a
b
a
a
a
a
a
a
a
a
a
a
"}
(40,1,1) = {"
a
a
a
a
a
a
a
a
a
a
a
a
a
a
a
a
a
a
a
a
a
a
a
a
a
a
a
a
a
a
a
a
a
a
a
a
a
a
a
a
"}
