"a" = (/turf/open/space,/area/space)
"b" = (/obj/structure/lattice,/turf/open/space,/area/space)
"c" = (/turf/closed/wall,/area/ruin/gasthelizard)
"d" = (/obj/machinery/light{dir = 1},/obj/structure/bed,/obj/effect/decal/remains/human,/turf/open/floor/plasteel/airless/black,/obj/effect/turf_decal/stripes/line{dir = 8},/area/ruin/gasthelizard)
"e" = (/obj/structure/window/reinforced{dir = 4;pixel_x = 0},/turf/open/floor/plasteel/airless/black,/obj/effect/turf_decal/stripes/line{dir = 4},/area/ruin/gasthelizard)
"f" = (/obj/structure/window/reinforced{dir = 8},/obj/machinery/light{dir = 1},/obj/structure/bed,/obj/effect/decal/remains/human,/turf/open/floor/plasteel/airless/black,/obj/effect/turf_decal/stripes/line{dir = 8},/area/ruin/gasthelizard)
"g" = (/obj/structure/window/reinforced{dir = 8},/obj/machinery/light{dir = 1},/obj/structure/bed,/turf/open/floor/plasteel/airless/black,/obj/effect/turf_decal/stripes/line{dir = 8},/area/ruin/gasthelizard)
"h" = (/turf/open/floor/plasteel/airless/black,/obj/effect/turf_decal/stripes/line{dir = 4},/area/ruin/gasthelizard)
"i" = (/turf/open/floor/plasteel/airless/black,/obj/effect/turf_decal/stripes/line{dir = 8},/area/ruin/gasthelizard)
"j" = (/obj/structure/window/reinforced{dir = 4;pixel_x = 0},/obj/machinery/atmospherics/components/unary/outlet_injector,/turf/open/floor/plasteel/airless/black,/obj/effect/turf_decal/stripes/line{dir = 4},/area/ruin/gasthelizard)
"k" = (/obj/structure/window/reinforced{dir = 8},/turf/open/floor/plasteel/airless/black,/obj/effect/turf_decal/stripes/line{dir = 8},/area/ruin/gasthelizard)
"l" = (/obj/machinery/atmospherics/components/unary/outlet_injector,/turf/open/floor/plasteel/airless/black,/obj/effect/turf_decal/stripes/line{dir = 4},/area/ruin/gasthelizard)
"m" = (/obj/structure/closet/crate/freezer,/obj/item/stack/sheet/animalhide/lizard,/obj/item/weapon/reagent_containers/food/snacks/meat/slab/human/mutant/lizard,/obj/item/weapon/reagent_containers/food/snacks/meat/slab/human/mutant/lizard,/obj/item/weapon/reagent_containers/food/snacks/meat/slab/human/mutant/lizard,/obj/item/weapon/reagent_containers/food/snacks/meat/slab/human/mutant/lizard,/obj/item/weapon/reagent_containers/food/snacks/meat/slab/human/mutant/lizard,/obj/item/weapon/reagent_containers/food/snacks/meat/slab/human/mutant/lizard,/turf/open/floor/plasteel{icon_state = "dark"},/area/ruin/gasthelizard)
"n" = (/obj/structure/closet/crate/freezer,/obj/item/weapon/reagent_containers/food/snacks/meat/slab/human/mutant/lizard,/obj/item/weapon/reagent_containers/food/snacks/meat/slab/human/mutant/lizard,/obj/item/weapon/reagent_containers/food/snacks/meat/slab/human/mutant/lizard,/obj/item/weapon/reagent_containers/food/snacks/meat/slab/human/mutant/lizard,/obj/item/weapon/reagent_containers/food/snacks/meat/slab/human/mutant/lizard,/obj/machinery/light{dir = 1},/obj/item/weapon/reagent_containers/food/snacks/meat/slab/human/mutant/lizard,/obj/item/weapon/reagent_containers/food/snacks/meat/slab/human/mutant/lizard,/turf/open/floor/plasteel{icon_state = "dark"},/area/ruin/gasthelizard)
"o" = (/obj/structure/closet/crate/freezer,/obj/item/weapon/reagent_containers/food/snacks/meat/slab/human/mutant/lizard,/obj/item/weapon/reagent_containers/food/snacks/meat/slab/human/mutant/lizard,/obj/item/weapon/reagent_containers/food/snacks/meat/slab/human/mutant/lizard,/obj/item/weapon/reagent_containers/food/snacks/meat/slab/human/mutant/lizard,/obj/item/clothing/under/rank/prisoner,/obj/item/weapon/reagent_containers/food/snacks/meat/slab/human/mutant/lizard,/obj/item/weapon/reagent_containers/food/snacks/meat/slab/human/mutant/lizard,/obj/item/weapon/reagent_containers/food/snacks/meat/slab/human/mutant/lizard,/turf/open/floor/plasteel{icon_state = "dark"},/area/ruin/gasthelizard)
"p" = (/obj/structure/window/reinforced{dir = 1;layer = 2.9},/turf/open/floor/plasteel{dir = 1;icon_state = "blue"},/area/ruin/gasthelizard)
"q" = (/obj/machinery/door/window/brigdoor/northleft,/obj/machinery/atmospherics/components/binary/pump{dir = 1},/turf/open/floor/plasteel{dir = 1;icon_state = "blue"},/area/ruin/gasthelizard)
"r" = (/turf/open/floor/plasteel{icon_state = "dark"},/area/ruin/gasthelizard)
"s" = (/obj/machinery/atmospherics/components/unary/portables_connector/visible{dir = 4},/obj/machinery/portable_atmospherics/canister/nitrous_oxide,/turf/open/floor/plasteel,/area/ruin/gasthelizard)
"t" = (/obj/machinery/atmospherics/pipe/manifold/general/visible{dir = 1},/obj/machinery/power/apc{cell_type = 2500;dir = 1;name = "Worn-out APC";pixel_x = 1;pixel_y = 26},/obj/machinery/light{dir = 1},/turf/open/floor/plasteel,/area/ruin/gasthelizard)
"u" = (/obj/machinery/atmospherics/pipe/simple/general/visible{dir = 4},/turf/open/floor/plasteel,/area/ruin/gasthelizard)
"v" = (/obj/machinery/atmospherics/pipe/manifold/general/visible,/turf/open/floor/plasteel,/area/ruin/gasthelizard)
"w" = (/obj/machinery/atmospherics/pipe/simple/general/visible{dir = 9},/obj/machinery/light{dir = 4;icon_state = "tube1"},/turf/open/floor/plasteel,/area/ruin/gasthelizard)
"x" = (/obj/structure/kitchenspike,/turf/open/floor/plasteel{icon_state = "dark"},/area/ruin/gasthelizard)
"y" = (/obj/structure/table/reinforced,/obj/item/weapon/kitchen/knife/butcher,/obj/item/weapon/restraints/handcuffs,/obj/item/weapon/reagent_containers/spray/pepper,/turf/open/floor/plasteel{icon_state = "dark"},/area/ruin/gasthelizard)
"z" = (/obj/machinery/atmospherics/components/unary/portables_connector/visible{dir = 4},/obj/machinery/portable_atmospherics/canister/carbon_dioxide,/turf/open/floor/plasteel,/area/ruin/gasthelizard)
"A" = (/obj/machinery/atmospherics/pipe/manifold/general/visible{dir = 4;initialize_directions = 11},/turf/open/floor/plasteel,/area/ruin/gasthelizard)
"B" = (/turf/open/floor/plasteel,/area/ruin/gasthelizard)
"C" = (/obj/machinery/gibber,/turf/open/floor/plasteel{icon_state = "dark"},/area/ruin/gasthelizard)
"D" = (/obj/structure/table/reinforced,/obj/item/clothing/suit/straight_jacket,/obj/item/weapon/reagent_containers/syringe/lethal,/obj/item/weapon/reagent_containers/syringe/lethal/choral,/turf/open/floor/plasteel{icon_state = "dark"},/area/ruin/gasthelizard)
"E" = (/obj/machinery/atmospherics/components/unary/portables_connector/visible{dir = 4},/obj/machinery/portable_atmospherics/canister/toxins,/turf/open/floor/plasteel,/area/ruin/gasthelizard)
"F" = (/obj/machinery/atmospherics/pipe/simple/general/visible{dir = 9},/turf/open/floor/plasteel,/area/ruin/gasthelizard)
"G" = (/obj/structure/chair/office/dark,/turf/open/floor/plasteel,/area/ruin/gasthelizard)
"H" = (/obj/machinery/door/airlock/security,/turf/open/floor/plasteel{icon_state = "dark"},/area/ruin/gasthelizard)
"I" = (/obj/item/weapon/reagent_containers/glass/bottle/morphine{pixel_x = -4;pixel_y = 1},/obj/item/weapon/reagent_containers/glass/bottle/chloralhydrate{name = "chloral hydrate bottle"},/obj/item/weapon/reagent_containers/glass/bottle/toxin{pixel_x = 6;pixel_y = 8},/obj/item/weapon/reagent_containers/glass/bottle/morphine{pixel_x = 5;pixel_y = 1},/obj/item/weapon/reagent_containers/glass/bottle/facid{name = "fluorosulfuric acid bottle";pixel_x = -3;pixel_y = 6},/obj/structure/table/reinforced,/turf/open/floor/plasteel{icon_state = "dark"},/area/ruin/gasthelizard)
"J" = (/obj/structure/rack,/obj/item/weapon/storage/toolbox/drone,/obj/item/weapon/melee/baton/cattleprod,/turf/open/floor/plasteel,/area/ruin/gasthelizard)
"K" = (/obj/structure/table,/obj/item/weapon/pen/red,/turf/open/floor/plasteel,/area/ruin/gasthelizard)
"L" = (/obj/structure/table,/obj/item/weapon/paper_bin,/turf/open/floor/plasteel,/area/ruin/gasthelizard)
"M" = (/obj/structure/table,/obj/item/weapon/storage/box/prisoner,/turf/open/floor/plasteel,/area/ruin/gasthelizard)
"N" = (/obj/structure/window/reinforced{dir = 4;pixel_x = 0},/obj/machinery/light,/obj/structure/table,/turf/open/floor/plasteel,/area/ruin/gasthelizard)
"O" = (/obj/machinery/portable_atmospherics/scrubber,/turf/open/floor/plasteel{icon_state = "bot";dir = 1},/area/ruin/gasthelizard)
"P" = (/obj/structure/table/reinforced,/obj/item/weapon/surgicaldrill,/obj/item/weapon/hemostat,/obj/item/weapon/scalpel,/obj/item/weapon/surgical_drapes,/obj/item/weapon/retractor,/obj/item/weapon/cautery,/obj/item/weapon/circular_saw,/obj/machinery/light,/turf/open/floor/plasteel{icon_state = "dark"},/area/ruin/gasthelizard)
"Q" = (/obj/structure/table/optable,/obj/effect/decal/cleanable/blood/old,/turf/open/floor/plasteel{icon_state = "dark"},/area/ruin/gasthelizard)
"R" = (/obj/structure/table/reinforced,/obj/item/weapon/reagent_containers/syringe,/obj/item/weapon/reagent_containers/dropper,/obj/item/weapon/reagent_containers/glass/bottle/mutagen,/obj/item/weapon/reagent_containers/glass/bottle/mutagen,/obj/item/weapon/razor,/turf/open/floor/plasteel{icon_state = "dark"},/area/ruin/gasthelizard)
"S" = (/obj/machinery/suit_storage_unit/security,/turf/open/floor/plasteel,/area/ruin/gasthelizard)
"T" = (/obj/machinery/light,/turf/open/floor/plasteel,/area/ruin/gasthelizard)
"U" = (/obj/structure/closet/emcloset,/turf/open/floor/plasteel,/area/ruin/gasthelizard)
"V" = (/obj/machinery/door/airlock/external,/turf/open/floor/plating,/area/ruin/gasthelizard)
"W" = (/turf/open/floor/plating,/area/ruin/gasthelizard)

(1,1,1) = {"
aaaababababbaaaaaaa
aaababbbbababbbbaaa
aaabccccccccccbbbba
abbbcdefegefhccccca
abbbcijkjkjklcmnocb
abcccpqpqpqpqcrrrcb
abcstuvuvuvuwcxryca
aaczABBBBBBBBcCrDca
bbcEFBBBGBBBBHrrIcb
abcJBBBKLMNOOcPQRcb
abcSTBUcccccccccccb
aacccVccbbbbbbaabba
aabbcWcbbaaaaaaabaa
aaabcVcbaaaaaaaaaaa
"}
