//MAP CONVERTED BY dmm2tgm.py THIS HEADER COMMENT PREVENTS RECONVERSION, DO NOT REMOVE
"a" = (
/turf/template_noop,
/area/template_noop)
"b" = (
/turf/closed/mineral/random,
/area/ruin/powered{
	dynamic_lighting = 0
	})
"c" = (
/turf/open/floor/plating/asteroid/airless,
/area/ruin/powered{
	dynamic_lighting = 0
	})
"d" = (
/obj/structure/flora/ausbushes/fullgrass,
/turf/open/floor/plating/asteroid/airless,
/area/ruin/powered{
	dynamic_lighting = 0
	})
"e" = (
/obj/structure/flora/ausbushes/ywflowers,
/turf/open/floor/plating/asteroid/airless,
/area/ruin/powered{
	dynamic_lighting = 0
	})
"f" = (
/mob/living/simple_animal/pet/gondola,
/turf/open/floor/plating/asteroid/airless,
/area/ruin/powered{
	dynamic_lighting = 0
	})
"g" = (
/obj/structure/flora/ausbushes/sparsegrass,
/turf/open/floor/plating/asteroid/airless,
/area/ruin/powered{
	dynamic_lighting = 0
	})
"h" = (
/obj/effect/overlay/coconut,
/turf/open/floor/plating/asteroid/airless,
/area/ruin/powered{
	dynamic_lighting = 0
	})
"i" = (
/obj/effect/overlay/palmtree_l,
/turf/open/floor/plating/asteroid/airless,
/area/ruin/powered{
	dynamic_lighting = 0
	})
"j" = (
/obj/structure/flora/ausbushes/stalkybush,
/turf/open/floor/plating/asteroid/airless,
/area/ruin/powered{
	dynamic_lighting = 0
	})
"k" = (
/obj/structure/flora/ausbushes/grassybush,
/turf/open/floor/plating/asteroid/airless,
/area/ruin/powered{
	dynamic_lighting = 0
	})
"l" = (
/obj/structure/flora/ausbushes/reedbush,
/turf/open/floor/plating/asteroid/airless,
/area/ruin/powered{
	dynamic_lighting = 0
	})
"m" = (
/obj/structure/flora/ausbushes/lavendergrass,
/turf/open/floor/plating/asteroid/airless,
/area/ruin/powered{
	dynamic_lighting = 0
	})
"n" = (
/obj/structure/flora/ausbushes/brflowers,
/turf/open/floor/plating/asteroid/airless,
/area/ruin/powered{
	dynamic_lighting = 0
	})
"o" = (
/obj/structure/flora/ausbushes/fernybush,
/turf/open/floor/plating/asteroid/airless,
/area/ruin/powered{
	dynamic_lighting = 0
	})
"p" = (
/obj/effect/overlay/palmtree_r,
/turf/open/floor/plating/asteroid/airless,
/area/ruin/powered{
	dynamic_lighting = 0
	})
"q" = (
/obj/structure/flora/junglebush/large,
/turf/open/floor/plating/asteroid/airless,
/area/ruin/powered{
	dynamic_lighting = 0
	})
"r" = (
/turf/open/floor/plating/asteroid/airless,
/area/space)
"s" = (
/obj/structure/flora/ausbushes/sunnybush,
/turf/open/floor/plating/asteroid/airless,
/area/ruin/powered{
	dynamic_lighting = 0
	})
"t" = (
/obj/machinery/door/airlock/survival_pod/vertical,
/turf/open/floor/plating/asteroid/airless,
/area/ruin/powered{
	dynamic_lighting = 0
	})

(1,1,1) = {"
a
a
a
a
a
a
a
a
a
a
a
a
a
a
a
a
a
a
a
a
a
a
a
a
a
a
b
b
b
b
b
b
a
a
a
"}
(2,1,1) = {"
a
a
a
a
b
b
a
a
a
a
a
a
a
a
a
a
a
a
a
a
a
a
a
a
b
b
b
b
b
b
b
b
b
a
a
"}
(3,1,1) = {"
a
a
b
b
b
b
b
a
a
a
a
a
a
a
a
a
a
a
a
b
b
b
b
b
b
b
b
b
b
b
b
b
b
b
c
"}
(4,1,1) = {"
a
b
b
b
b
a
a
a
a
a
a
a
a
a
a
b
b
b
b
b
b
b
b
b
b
b
b
b
b
c
b
b
b
b
b
"}
(5,1,1) = {"
a
b
b
b
a
a
a
a
a
a
a
a
a
a
b
b
b
b
b
b
b
b
b
b
b
c
c
c
c
c
c
c
b
b
b
"}
(6,1,1) = {"
a
a
a
a
a
a
a
a
a
b
b
b
b
b
b
b
b
b
b
b
b
b
b
c
c
c
c
e
c
c
c
f
c
b
b
"}
(7,1,1) = {"
a
a
a
a
a
a
a
a
b
b
b
b
b
b
b
b
b
b
b
b
b
c
c
c
c
m
c
p
c
b
b
b
b
b
c
"}
(8,1,1) = {"
a
a
a
a
a
a
b
b
b
b
b
b
b
b
b
b
c
b
c
c
c
c
c
c
c
c
h
c
c
c
c
b
b
b
c
"}
(9,1,1) = {"
a
a
a
a
a
b
b
b
b
b
b
b
b
c
i
c
c
o
c
c
h
c
c
i
c
c
c
c
k
c
c
b
b
b
c
"}
(10,1,1) = {"
a
a
a
b
b
b
b
b
b
b
b
b
b
b
b
c
c
c
c
c
q
c
c
c
c
c
c
g
c
c
c
b
b
b
c
"}
(11,1,1) = {"
a
a
b
b
b
b
b
b
b
b
b
b
b
b
c
g
l
e
c
c
c
c
c
h
c
f
c
j
c
c
c
b
b
b
c
"}
(12,1,1) = {"
a
a
b
b
b
b
b
b
b
b
b
b
c
c
c
c
m
m
c
f
c
c
c
c
c
c
c
g
m
c
c
b
b
b
c
"}
(13,1,1) = {"
a
b
b
b
b
b
b
b
b
b
b
b
c
c
c
c
g
c
o
c
c
c
c
c
c
q
c
c
c
c
b
b
b
b
c
"}
(14,1,1) = {"
a
b
b
b
b
b
b
b
b
b
b
f
c
c
c
c
j
c
c
c
k
g
c
c
c
c
c
c
c
b
b
b
b
b
c
"}
(15,1,1) = {"
a
b
b
b
b
b
b
b
b
b
b
b
b
b
b
c
c
c
c
c
g
m
c
c
c
r
r
c
c
c
b
b
b
b
c
"}
(16,1,1) = {"
a
b
b
b
b
b
b
b
b
b
b
b
b
b
b
b
b
c
c
c
m
n
c
c
c
c
p
c
c
c
c
b
b
b
c
"}
(17,1,1) = {"
a
b
b
b
b
b
b
b
b
b
b
b
b
b
b
b
b
b
c
d
l
c
c
c
c
c
c
c
c
c
c
c
b
b
c
"}
(18,1,1) = {"
a
b
b
b
b
b
b
b
b
b
c
d
c
b
b
b
b
b
c
c
c
c
c
c
g
s
c
c
c
g
c
c
b
b
b
"}
(19,1,1) = {"
a
b
b
b
b
b
b
b
b
c
c
c
c
c
c
b
b
b
b
c
p
h
c
c
c
e
c
c
c
c
c
c
t
c
t
"}
(20,1,1) = {"
a
c
b
b
b
b
b
b
b
f
c
c
c
c
c
c
c
c
c
c
c
c
c
c
c
c
c
c
c
c
c
b
b
b
b
"}
(21,1,1) = {"
a
c
c
b
b
b
b
b
b
c
c
c
i
c
g
g
c
c
o
c
c
c
c
c
c
c
f
c
c
c
c
c
b
b
b
"}
(22,1,1) = {"
a
c
c
b
b
b
b
b
b
c
c
c
c
c
c
j
c
c
c
c
c
c
c
c
c
c
c
c
c
p
c
c
b
b
b
"}
(23,1,1) = {"
a
c
c
b
b
b
b
b
b
c
c
h
c
c
c
c
c
c
c
c
c
f
q
c
c
c
q
c
c
c
c
c
b
b
b
"}
(24,1,1) = {"
a
a
c
c
b
b
b
b
d
c
c
c
c
c
f
c
c
c
c
c
c
c
c
c
k
c
c
c
c
c
c
c
b
b
b
"}
(25,1,1) = {"
a
a
c
c
b
b
b
c
c
c
c
c
c
c
c
c
g
j
c
c
c
c
c
c
l
k
c
c
c
c
c
b
b
b
a
"}
(26,1,1) = {"
a
a
c
c
b
b
b
c
c
c
c
c
c
c
c
k
n
g
c
e
c
c
c
c
c
c
i
c
c
h
c
b
b
b
a
"}
(27,1,1) = {"
a
a
c
c
b
b
b
b
c
c
c
c
c
c
c
c
c
c
c
c
k
g
c
c
c
c
c
c
c
c
b
b
b
a
a
"}
(28,1,1) = {"
a
a
a
c
c
b
b
b
c
c
c
c
c
d
c
c
c
c
c
c
g
j
n
c
c
c
c
c
c
b
b
b
b
a
a
"}
(29,1,1) = {"
a
a
a
c
c
b
b
c
c
c
d
c
c
c
c
c
c
c
c
c
c
c
c
c
c
g
c
c
c
b
b
b
c
c
a
"}
(30,1,1) = {"
a
a
a
c
b
b
c
c
e
c
g
c
c
c
b
c
c
c
c
c
h
c
c
c
c
c
c
c
b
b
b
c
c
c
a
"}
(31,1,1) = {"
a
a
a
b
b
b
b
c
c
c
c
c
c
b
b
b
c
c
c
p
c
c
c
c
c
c
b
b
b
b
c
c
c
b
b
"}
(32,1,1) = {"
a
a
a
b
b
b
c
c
c
c
c
c
b
b
b
b
b
b
b
b
b
b
b
b
b
b
b
b
b
b
c
c
b
b
b
"}
(33,1,1) = {"
a
a
a
b
b
c
c
c
c
b
b
b
b
b
b
b
b
b
b
b
b
b
b
b
b
b
b
b
b
a
a
b
b
b
a
"}
(34,1,1) = {"
a
a
a
b
b
b
b
b
b
b
b
b
b
b
c
c
c
c
c
b
b
b
b
b
a
a
a
a
a
a
a
b
b
b
a
"}
(35,1,1) = {"
a
a
a
a
b
b
b
b
b
b
b
b
b
a
a
a
a
a
a
a
a
a
a
a
a
a
a
a
a
a
a
a
a
a
a
"}
