"a" = (/turf/open/space,/area/space)
"b" = (/turf/closed/mineral,/area/space)
"c" = (/turf/closed/wall/r_wall,/area/space)
"d" = (/turf/open/floor/plating,/area/space)
"e" = (/obj/machinery/power/smes/magical{desc = "A high-capacity superconducting magnetic energy storage (SMES) unit."; name = "power storage unit"},/turf/open/floor/plating,/area/space)
"f" = (/obj/machinery/door/airlock,/turf/open/floor/plasteel,/area/space)
"g" = (/turf/closed/wall,/area/space)
"h" = (/obj/structure/table,/obj/item/weapon/paper/monitorkey,/obj/item/device/radio/intercom{desc = "Talk through this. Evilly"; freerange = 1; frequency = 1213; name = "Syndicate Intercom"; pixel_x = 32; subspace_transmission = 1; syndie = 1},/obj/item/clothing/glasses/regular,/turf/open/floor/plasteel,/area/space)
"i" = (/obj/structure/table,/turf/open/floor/plasteel,/area/space)
"j" = (/turf/open/floor/plasteel,/area/space)
"k" = (/obj/machinery/door/airlock/external,/turf/open/floor/plating,/area/space)
"l" = (/turf/open/floor/plating/asteroid/airless,/area/space)
"m" = (/obj/machinery/computer/message_monitor,/turf/open/floor/plasteel,/area/space)
"n" = (/obj/structure/chair{dir = 4},/mob/living/simple_animal/hostile/syndicate{desc = "A weary looking syndicate operative."},/turf/open/floor/plasteel,/area/space)
"o" = (/obj/structure/table,/obj/item/weapon/paper{info = "Nothing of interest to report."; name = "november report"},/obj/item/weapon/pen,/turf/open/floor/plasteel,/area/space)
"p" = (/obj/item/device/radio/intercom{desc = "Talk through this. Evilly"; freerange = 1; frequency = 1213; name = "Syndicate Intercom"; pixel_x = 32; subspace_transmission = 1; syndie = 1},/turf/open/floor/plasteel,/area/space)
"q" = (/obj/structure/rack,/obj/item/clothing/suit/space/syndicate,/obj/item/clothing/mask/gas,/obj/item/clothing/head/helmet/space/syndicate,/turf/open/floor/plasteel,/area/space)
"r" = (/obj/machinery/door/airlock,/obj/structure/safe/floor,/obj/item/weapon/paper{info = "I wonder how much longer they will accept my empty reports. They will cancel the case  soon without results.  When the pickup comes, I will tell them I have lost faith in our cause, and beg them to consider a diplomatic solution. How many nuclear teams have been dispatched with those nukes? I must try and prevent more from ever being sent. If they will not listen to reason, I will detonate the warehouse myself. Maybe some day in the immediate future, space will be peaceful, though I don't intend to live to see it. And that is why I write this down- it is my sacrifice that stabilised your worlds, traveller. Spare a thought for me, and please attempt to prevent nuclear proliferation, should it ever rear it's ugly head again. -Donk Co. Operative #451"; name = "odd report"},/obj/item/weapon/gun/projectile/automatic/pistol,/turf/open/floor/plasteel,/area/space)
"s" = (/obj/structure/disposalpipe/segment{dir = 4; icon_state = "pipe-c"},/turf/closed/mineral,/area/space)
"t" = (/obj/structure/disposalpipe/segment{dir = 4},/turf/closed/mineral,/area/space)
"u" = (/obj/structure/disposaloutlet{dir = 4},/obj/structure/disposalpipe/trunk{dir = 8},/turf/open/floor/plating/airless,/area/space)
"v" = (/obj/structure/bed,/obj/item/weapon/bedsheet/brown,/turf/open/floor/plasteel,/area/space)
"w" = (/obj/structure/table,/obj/item/device/flashlight/lamp,/turf/open/floor/plasteel,/area/space)
"x" = (/obj/machinery/vending/snack,/turf/open/floor/plasteel,/area/space)
"y" = (/obj/structure/disposalpipe/segment,/turf/closed/mineral,/area/space)
"z" = (/obj/machinery/vending/cola,/turf/open/floor/plasteel,/area/space)
"A" = (/obj/structure/closet,/obj/item/clothing/gloves/boxing,/turf/open/floor/plasteel,/area/space)
"B" = (/obj/structure/filingcabinet,/obj/item/weapon/paper{info = "A good start to the operation: intercepted Nanotrasen military communications. A convoy is scheduled to transfer nuclear warheads to a new military base. This is as good a chance as any to get our hands on some heavy weaponry, I suggest we take it."; name = "april report"},/obj/item/weapon/paper{info = "Nothing of real interest to report this month. I have intercepted faint transmissions from what appears to be some sort of pirate radio station. They do not appear to be relevant to my assignment."; name = "may report"},/obj/item/weapon/paper{info = "Nanotrasen communications have been noticably less frequent recently.  The pirate radio station I found last month has been transmitting pro-Nanotrasen propaganda. I will continue to monitor it."; name = "june report"},/obj/item/weapon/paper{info = "Nothing of interest to report."; name = "july report"},/obj/item/weapon/paper{info = "Nothing of interest to report."; name = "august report"},/obj/item/weapon/paper{info = "Nothing of interest to report."; name = "september report"},/obj/item/weapon/paper{info = "Nothing of interest to report."; name = "october report"},/obj/item/weapon/paper{info = "1 x Stechtkin pistol - $600<br>1 x silencer - $200<br>shipping charge - $4360<br>total - $5160"; name = "receipt"},/turf/open/floor/plasteel,/area/space)
"C" = (/obj/structure/table,/obj/item/weapon/paper{info = "<b>Mission Details</b>: You have been assigned to a newly constructed listening post constructed within an asteroid in Nanotrasen space to monitor their plasma mining operations. Accurate intel is crucial to the success of our operatives onboard, do not fail us."; name = "mission briefing"},/turf/open/floor/plasteel,/area/space)
"D" = (/obj/machinery/disposal/bin,/obj/structure/disposalpipe/trunk{dir = 4},/turf/open/floor/plasteel,/area/space)
"E" = (/obj/structure/disposalpipe/segment{dir = 4},/turf/closed/wall/r_wall,/area/space)
"F" = (/obj/structure/disposalpipe/segment{dir = 8; icon_state = "pipe-c"},/turf/closed/mineral,/area/space)
"G" = (/obj/machinery/door/airlock{name = "Toilet"},/turf/open/floor/plasteel,/area/space)
"H" = (/turf/open/floor/plasteel/freezer,/area/space)
"I" = (/obj/machinery/shower{icon_state = "shower"; dir = 8},/turf/open/floor/plasteel/freezer,/area/space)
"J" = (/obj/structure/toilet{icon_state = "toilet00"; dir = 8},/turf/open/floor/plasteel/freezer,/area/space)
"K" = (/turf/closed/mineral/clown,/area/space)
"L" = (/turf/closed/wall/shuttle{icon_state = "wall3"},/area/space)
"M" = (/turf/open/floor/plasteel/airless/circuit/gcircuit,/area/space)

(1,1,1) = {"
aaaaaaaaaaaaaaaaaaaaaaaaaaaaaaaaaaaaaaaabbbaaaaaaaaaaaaaaaaaaaaaaaaaaaaaaaaaa
aaaaaaaaaaaaaaaaaaaaaaaaaaaaaaaaaaaaaabbbbbbaaaaaaaaaaaaabbbbbbbbbbaaaaaaaaaa
aaaaaaaaaaaaaaaaaaaaaaaaaaaaaaaaaaaaaabbbbbbbbbaaaaaabbbbbbbbbbbbbbbbaaaaaaaa
aaaaaaaaaaaaaaaaaaaaaaaaaaaaaaaaaaaaaabbbbbbbbbbbbbbbbbbbbbbbbbbbbbbbaaaaaaaa
aaaaaaaaaaaaaaaaaaaaaaaaaaaaaaaaaaaaaaabbbbbbbbbbbbbbbbbbbbbbbbbbbbbbbaaaaaaa
aaaaaaaaaaaaaaaaaaaaaaaaaaaaaaaaaaaaaaaaabbbbbbbbbbbbbbbbbbbbbbbbbbbbbaaaaaaa
aaaaaaaaaaaaaaaaaaaaaaaaaaaaaaaaaaaaaaaaabbbbbbbbbbbbbbbbbbbbbbbbbbbbbbaaaaaa
aaaaaaaaaaaaaaaaaaaaaaaaaaaaaaaaaaaaaaaabbbbbbbbbbbbbbbbbbbbbbbbbbbbbbbbaaaaa
aaaaaaaaaaaaaaaaaaaaaaaaaaaaaaaaaaaaaaaabbbbbbbbbbbbbbbbbbbbbbbccccbbbbbaaaaa
aaaaaaaaaaaaaaaaaaaaaaaaaaaaaaaaaaaaaaaabbbbbbbbbbbbbbbbbbbbbbbcdecbbbbbaaaaa
aaaaaaaaaaaaaaaaaaaaaaaaaaaaaaaaaaaaaaaabbbbbbbbbbbbbbbbbbbbbcccfgccccaaaaaaa
aaaaaaaaaaaaaaaaaaaaaaaaaaaaaaaaaaaaaaaaabbbbbbbbbbbbbbbbbbbcchijjkddkaaaaaaa
aaaaaaaaaaaaaaaaaaaaaaaaaaaaaaaaaaaaaaaaalbbbbbbbbbbbbbbbbbbcmnojjkddkaaaaaaa
aaaaaaaaaaaaaaaaaaaaaaaaaaaaaaaaaabbbbbbalbbbbbbbbbbbbbbbbbbccpijjccccaaaaaaa
aaaaaaaaaaaaaaaaaaaaaaaaaaaaaaaabbbbbbbbllbbbbbbbbbbbbbbbbbbbcjjjqcbbbbaaaaaa
aaaaaaaaaaaaaaaaaaaaaaaaaaaaabbbbbbbbbbbblbbbbbbbbbbbbbbbbccccrgggcbsttuaaaaa
aaaaaaaaaaaaaaaaaaaaaaaaaaaabbbbbbbbbbbbbbbbbbbbbbbbbbbbbbcvwgjjjxcbybbbbbbaa
aaaaaaaaaaaaaaaaaaaaaaaaaaaabbbbbbbbbbbbbbbbbbbbbbbbbbbbbbcjjfjjjzcbybbbbbbba
aaaaaaaaaaaaaaaaaaaaaaaaaaaabbbbbbbbbbbbbbbbbbbbbbbbbbbbbbcABgCjDEEtFbbbbbaaa
aaaaaaaaaaaaaaaaaaaaaaaaaaabbbbbbbbbbbbbbbbbbbbbbbbbbbbbbbcccccGgcbbbbbbbbbaa
aaaaaaaaaaaaaaaaaaaaaaaaaaabbbbbbbbbbbbbbbbbbbbbbbbbbbbbbbbbbbcHIcbbbbbbbbbaa
aaaaaaaaaaaaaaaaaaaaaaaaaaabbbbbbbbbbbbbbbbbbbbbbbbbbbbbbbbbbbcHJcbbbbbbbbbba
aaaaaaaaaaaaaaaaaaaaaaaaaaaabbbbbbbbbbbbbbbbbbbbbbbbbbbbbbbbbbccccbbbbbbbbbbb
aaaaaaaaaaaaaaaaaaaaaaaaaaaabbbbbbbbbbbbbbbbbbbbbbbbbbbbbbbbbbbbbbbbbbbbbbbbb
aaaaaaaaaaaaaaaaaaaaaaaaaaaabbbbbbbbbbbbbbbbbbbbbbbbbbbbbbbbbbbbbbbbbbbbbbbbb
aaaaaaaaaaaaaaaaaaaaaaaaaabbbbbbbbbbbbbbbbbbbbbbbbbbbbbbbbbbbbbbbbbbbbbbbbbbb
aaaaaaaaaaaaaaaaaaaaaaabbbbbbbbbbbbbbbbbbbbbbbbbbbbbbbbbbbbbbbbbbbbbbbbbbbbba
aaaaaaaaaaaaaaaaaaaaabbbbbbbbbbbbbbbbbbbbbbbbbbbbbbbbbbbbbbbbbbbbbbbbbbbbbbba
aaaaaaaaaaaaaaaaaaaaabbbbbbbbbbbbbbbbbbbbbbbbbbbbbbbbbbbbbbbbbbbbbbbbbbbbbbaa
aaaaaaaaaaaaaaaaaaaaabbbbbbbbbbbbbbbbbbbbbbbbbbbbbbbbbbbbbbbbbbbbbbbbbbbbbbaa
aaaaaaaaaaaaaaaaaaaaaabbbbbbbbbbbbbbbbbbbbbbbbbblllbbbbbbbbbbbbbbbbbbbbaaaaaa
aaaaaaaaaaaaaaaaaaaaaabbbbbbbbbbbbbbbbKKbbbbbbbllaaabbbbbbbbbbbbbbbbbaaaaaaaa
aaaaaaaaaaaaaaaaaaaaaabbbbbbbbbbbbbbbbbKbbKbbblllaaaabbbbbbbbbbbbbbaaaaaaaaaa
aaaaaaaaaaaaaaaaaaaaaaabbbbbbbbbbbKbbbbbbbbbbbblaaaaabbbbbbbbbbbbbbaaaaaaaaaa
aaaaaaaaaaaaaaaaaaaaaaaabbbbbbbbbbKKbbbbbbbbbbblaaaabbbbbbbbbbbbbaaaaaaaaaaaa
aaaaaaaaaaaaaaaaaaaaaaaabbbbbbbbbbKKbbbbbbbbbbblaabbbbbbbbbbbbbbaaaaaaaaaaaaa
aaaaaaaaaaaaaaaaaaaaaaaabbbbbbbbbbbbbbbbbKbbbbbbaabbbbbbbbbbbbbaaaaaaaaaaaaaa
aaaaaaaaaaaaaaaaaaaaaabbbbbbbbbbbbbbbbbbbbbbbbbbabbbbbbbbbbbbaaaaaaaaaaaaaaaa
aaaaaabbbbaaaaaaaaaabbbbbbbbbbbbbbbbbbbbbbbbbbbbbbbbbbbbbbbbaaaaaaaaaaaaaaaaa
aaaaabbbbbbbaaaaaabbbbbbbbbbbbbbbbbbbbKKbbbbbbbbbbbbbbbbbbbbaaaaaaaaaaaaaaaaa
aaaabbbbbbbbbbbaaabbbbbbbbbbbbbbbbKbbbbbbbbbbbbbbbbbbbbbbbbaaaaaaaaaaaaaaaaaa
aaabbbbbbbbbbbbbbbbbbbbbbbbbbbbbbbbbbbbbbbbKbbbbbbbbbbbbbbaaaaaaaaaaaaaaaaaaa
aaabbbbbbbbbbbbbbbbbbbbbbbbbbbbbbbbbbbbbbbbbbbbbbbbbbbbbbbaaaaaaaaaaaaaaaaaaa
aaabbbbbbbbbbbbbbbbbbbbbbbbbbbbbbbbbbbbbbbKKbbbbbbbbbbbbbbbaaaaaaaaaaaaaaaaaa
aabbbbbbbbbbbbbbbbbbbbbbbbbbbbbbbbbbbbbbbbbbbbbbbblllllbbbbaaaaaaaaaaaaaaaaaa
aabbbbbbbbbbbbbbbbbbbbbbbbbbbbbbbbbbbbbbbbbbbbbbbbblaaaabbaaaaaaaaaaaaaaaaaaa
aabbbbbbbbbbbbbbbbbbbbbbbbbbbbbbbbbbbbbbbbbbbbbbbbbbllbaaaaaaaaaaaaaaaaaaaaaa
aabbbbbbbbbbbbbbbbbbbbbbbbbbbbbbbbbbbbbbbbbbbbbbbbbbbbbbaaaaaaaaaaaaaaaaaaaaa
abbbbbbbbbbbbbbbbbbbbbbbbbbbbbLLLLLLLbbbbbbbbbbbbbbbbbbbaaaaaaaaaaaaaaaaaaaaa
abbbbbbbbbbbbbbbbbbbbbbbbbbbbblMMMMMLbbbbbbbbbbbbbbbbbbbaaaaaaaaaaaaaaaaaaaaa
abbbbbbbbbbbbbbbbbbbbbbbbbbbbbbMMMMMLbbbbbbbbbbbbbbbbbbbaaaaaaaaaaaaaaaaaaaaa
bbbbbbbbbbbbbbbbbbbbbbbbbbbbbbbbMMMMLbbbbbbbbbbbbbbbbbbbbaaaaaaaaaaaaaaaaaaaa
bbbbbbbbbbbbbbbblbbbbbbbbbbbbbbMMMMMLbbbbbbbbbbbbbbbbbbbbaaaaaaaaaaaaaaaaaaaa
bbbbbbbbbbbbbbbbllbbbbbbbbbbbbblMMMMLbbbbbbbbbbbbbbbbbbbbaaaaaaaaaaaaaaaaaaaa
bbbbbbbbbbbbbbbaalbbbbbbbbbbbbllLLLLLbbbbbbbbbbbbbbbbbbbbaaaaaaaaaaaaaaaaaaaa
bbbbbbbbbbbbbaaaabbbbbbbbbbbbbbbbbbbbbbbbbbbbbbbbbbbbbbbbaaaaaaaaaaaaaaaaaaaa
abbbbbbbbbbbaaaaabbbbbbbbbbbbbbbbbbbbbbbbbbbbbbbbbbbbbbbbaaaaaaaaaaaaaaaaaaaa
aaaaabbbbbbaaaaaabbbbbbbbbbbbbbbbbbbbbbbbbbbbbbbbbbbbbbbbaaaaaaaaaaaaaaaaaaaa
aaaaaaaaaaaaaaaaabbbbbbbbbblbbbbbbbbbbbbbbbbbbbbbbbbbbbbbaaaaaaaaaaaaaaaaaaaa
aaaaaaaaaaaaaaaaaabbbbbbbbllbbbbbbbbbbbbbbbbbbbbbbbbbbbaaaaaaaaaaaaaaaaaaaaaa
aaaaaaaaaaaaaaaaaabbbbbbbbalbbbbbbbbbbbbbbbbbbbbbbbbbbbaaaaaaaaaaaaaaaaaaaaaa
aaaaaaaaaaaaaaaaaabbbbbbbaalbbbbbbbbbbbbbbbbbbbbbbbbbbaaaaaaaaaaaaaaaaaaaaaaa
aaaaaaaaaaaaaaaaaaaabbbbaaabbbbbbbbbbbbbbbbbbbbbbbbbbaaaaaaaaaaaaaaaaaaaaaaaa
aaaaaaaaaaaaaaaaaaaaaaaaaaabbbbbbbbbbbbbbbbbbbbbbbbbbaaaaaaaaaaaaaaaaaaaaaaaa
aaaaaaaaaaaaaaaaaaaaaaaaaabbbbbbbbbbbbbbbbbbbbbbbbbbbaaaaaaaaaaaaaaaaaaaaaaaa
aaaaaaaaaaaaaaaaaaaaaaaaaabbbbbbbbbbbbbbbbbbbbbbbbbaaaaaaaaaaaaaaaaaaaaaaaaaa
aaaaaaaaaaaaaaaaaaaaaaaabbbbbbbbbbbbbbbbbbbbbbbbbbbaaaaaaaaaaaaaaaaaaaaaaaaaa
aaaaaaaaaaaaaaaaaaaaaabbbbbbbbbbbbbbbbbbbbbbbbbbbbbaaaaaaaaaaaaaaaaaaaaaaaaaa
aaaaaaaaaaaaaaaaaaaaaabbbbbbbbbbbbbbbbbbbbbbbbbbbbbaaaaaaaaaaaaaaaaaaaaaaaaaa
aaaaaaaaaaaaaaaaaaaaabbbbbbbbbbbbbbbbbbbbbbbbbbbbbbaaaaaaaaaaaaaaaaaaaaaaaaaa
aaaaaaaaaaaaaaaaaaaaabbbbbbbbbbbbbbbbbbbbbbbbbbbbbaaaaaaaaaaaaaaaaaaaaaaaaaaa
aaaaaaaaaaaaaaaaaaaaabbbbbbbbbbbbbbbbbbbbbbbbbbbbbaaaaaaaaaaaaaaaaaaaaaaaaaaa
aaaaaaaaaaaaaaaaaaaaaaabbbbbbbbbbbbbbbbbbbbbbbbbbaaaaaaaaaaaaaaaaaaaaaaaaaaaa
aaaaaaaaaaaaaaaaaaaaaaabbbbbbbbbbbbbbbbbbbbbbbbbbaaaaaaaaaaaaaaaaaaaaaaaaaaaa
aaaaaaaaaaaaaaaaaaaaaaaaabbbbbbbbbbbbbbbbbbbbbbbbaaaaaaaaaaaaaaaaaaaaaaaaaaaa
aaaaaaaaaaaaaaaaaaaaaaaaaaaaabbbbbbbbbbbbbbbbbbbaaaaaaaaaaaaaaaaaaaaaaaaaaaaa
aaaaaaaaaaaaaaaaaaaaaaaaaaaaaabbbbbbbbbbbbbbbbbbaaaaaaaaaaaaaaaaaaaaaaaaaaaaa
aaaaaaaaaaaaaaaaaaaaaaaaaaaaaaaaaabbbbbbbbbbbbbbaaaaaaaaaaaaaaaaaaaaaaaaaaaaa
aaaaaaaaaaaaaaaaaaaaaaaaaaaaaaaaaaaabbbbbbbbaaaaaaaaaaaaaaaaaaaaaaaaaaaaaaaaa
aaaaaaaaaaaaaaaaaaaaaaaaaaaaaaaaaaaabbbbbbbaaaaaaaaaaaaaaaaaaaaaaaaaaaaaaaaaa
"}
