//MAP CONVERTED BY dmm2tgm.py THIS HEADER COMMENT PREVENTS RECONVERSION, DO NOT REMOVE
"aa" = (
/turf/template_noop,
/area/space)
"ae" = (
/turf/open/floor/sepia,
/area/space)
"aj" = (
/obj/structure/grille,
/obj/structure/window/plastitanium,
/obj/machinery/door/firedoor,
/turf/open/floor/plating,
/area/space)
"am" = (
/obj/machinery/light/small{
	dir = 1
	},
/turf/open/floor/engine/air,
/area/space)
"ax" = (
/obj/structure/sign/warning/vacuum{
	pixel_x = 32
	},
/obj/structure/tank_dispenser/plasma,
/turf/open/floor/plating,
/area/space)
"aA" = (
/turf/open/floor/carpet,
/area/space)
"aB" = (
/obj/structure/table/wood,
/turf/open/floor/carpet,
/area/space)
"aC" = (
/obj/effect/mapping_helpers/airlock/cyclelink_helper{
	dir = 4
	},
/obj/machinery/door/airlock/external{
	id_tag = "syndie_listeningpost_external";
	req_access_txt = "150"
	},
/obj/structure/cable,
/turf/open/floor/plating,
/area/space)
"aD" = (
/turf/open/floor/pod/light,
/area/space)
"aE" = (
/obj/effect/mapping_helpers/airlock/cyclelink_helper{
	dir = 8
	},
/obj/machinery/door/airlock/external{
	id_tag = "syndie_listeningpost_external";
	req_access_txt = "150"
	},
/obj/structure/cable,
/turf/open/floor/plating,
/area/space)
"aF" = (
/turf/open/floor/plating/ashplanet/rocky,
/area/space)
"aG" = (
/turf/closed/mineral/random,
/area/space)
"aH" = (
/turf/open/floor/plating,
/area/space)
"aI" = (
/turf/closed/wall/r_wall/syndicate,
/area/space)
"aM" = (
/obj/machinery/light/small,
/obj/structure/sign/warning/vacuum{
	pixel_x = 32
	},
/obj/effect/decal/cleanable/dirt,
/obj/structure/cable,
/turf/open/floor/plating,
/area/space)
"bk" = (
/obj/structure/sign/poster/contraband/revolver,
/turf/closed/wall/r_wall/syndicate,
/area/space)
"bm" = (
/obj/structure/closet/crate/bin,
/turf/open/floor/pod/dark,
/area/space)
"bF" = (
/obj/structure/sink/kitchen,
/turf/open/floor/plasteel/cafeteria,
/area/space)
"bJ" = (
/obj/docking_port/stationary{
	dir = 4;
	dwidth = 6;
	height = 7;
	id = "caravansyndicate3_listeningpost";
	name = "Syndicate Listening Post";
	width = 15
	},
/obj/docking_port/stationary{
	dir = 4;
	dwidth = 4;
	height = 5;
	id = "caravansyndicate1_listeningpost";
	name = "Syndicate Listening Post";
	width = 9
	},
/turf/template_noop,
/area/space)
"bX" = (
/obj/structure/chair/comfy/teal,
/turf/open/floor/plasteel/rockvault,
/area/space)
"ca" = (
/obj/structure/mecha_wreckage/mauler,
/obj/item/stack/sheet/capitalisium,
/obj/item/stack/sheet/stalinium,
/turf/open/floor/plating,
/area/space)
"cb" = (
/obj/machinery/door/airlock/hatch{
	heat_proof = 1;
	name = "Experimentation Room";
	req_access_txt = "150"
	},
/turf/open/floor/engine/air,
/area/space)
"cd" = (
/obj/structure/sign/plaques/kiddie/perfect_drone,
/turf/closed/wall/r_wall/syndicate,
/area/space)
"co" = (
/turf/open/floor/plasteel/rockvault,
/area/space)
"cu" = (
/obj/machinery/computer/message_monitor,
/turf/open/floor/pod/dark,
/area/space)
"cK" = (
/obj/machinery/hydroponics/constructable,
/obj/item/seeds/coffee/robusta,
/turf/open/floor/plasteel,
/area/space)
"cR" = (
/obj/structure/curtain/bounty,
/turf/open/floor/plasteel/showroomfloor,
/area/space)
"cY" = (
/obj/structure/mineral_door/gold{
	name = "Meeting Room"
	},
/turf/open/floor/plasteel,
/area/space)
"da" = (
/obj/machinery/light/floor,
/turf/open/floor/pod/light,
/area/space)
"dc" = (
/obj/machinery/door/airlock/hatch{
	name = "Telecommunications";
	req_access_txt = "150"
	},
/turf/open/floor/plasteel/dark,
/area/space)
"dx" = (
/obj/structure/table/reinforced,
/obj/machinery/chem_master,
/turf/open/floor/plasteel/rockvault,
/area/space)
"dL" = (
/obj/structure/table/wood/fancy,
/obj/item/storage/fancy/cigarettes/cigars/havana,
/obj/item/storage/fancy/cigarettes/cigpack_syndicate,
/turf/open/floor/pod/dark,
/area/space)
"eC" = (
/obj/structure/sign/poster/contraband/free_drone,
/turf/closed/wall/r_wall/syndicate,
/area/space)
"fy" = (
/obj/structure/sign/poster/contraband/syndicate_recruitment,
/turf/closed/wall/r_wall/syndicate,
/area/space)
"fI" = (
/obj/item/skub,
/turf/open/floor/plasteel/freezer,
/area/space)
"fJ" = (
/obj/machinery/porta_turret/syndicate,
/turf/open/floor/pod/light,
/area/space)
"fW" = (
/obj/machinery/vending/wallmed{
	pixel_x = 32
	},
/turf/open/floor/wood,
/area/space)
"fX" = (
/obj/structure/closet/syndicate/resources,
/turf/open/floor/pod/dark,
/area/space)
"gf" = (
/obj/machinery/smoke_machine,
/turf/open/floor/plasteel/rockvault,
/area/space)
"gs" = (
/obj/machinery/vending/syndichem,
/turf/open/floor/plasteel/rockvault,
/area/space)
"gE" = (
/obj/structure/window/reinforced{
	dir = 1;
	pixel_y = 1
	},
/obj/structure/flora/ausbushes/ppflowers,
/obj/structure/flora/junglebush/b,
/turf/open/floor/plating/grass,
/area/space)
"hh" = (
/obj/machinery/door/airlock{
	name = "Cabin 1"
	},
/turf/open/floor/sepia,
/area/space)
"hJ" = (
/obj/machinery/sleeper/syndie/fullupgrade{
	dir = 4
	},
/turf/open/floor/plasteel/rockvault,
/area/space)
"hP" = (
/obj/machinery/vending/liberationstation,
/turf/open/floor/wood,
/area/space)
"it" = (
/obj/structure/table/wood/fancy/black,
/obj/item/encryptionkey/syndicate,
/obj/item/encryptionkey/syndicate,
/obj/item/encryptionkey/syndicate,
/obj/item/pda/syndicate,
/turf/open/floor/mineral/plastitanium/red,
/area/space)
"jS" = (
/obj/effect/turf_decal/box/white/corners,
/obj/structure/closet/crate/medical,
/obj/item/storage/firstaid/fire{
	pixel_x = 3;
	pixel_y = 3
	},
/obj/item/storage/firstaid/brute,
/obj/item/storage/firstaid/regular{
	pixel_x = -3;
	pixel_y = -3
	},
/obj/item/defibrillator/compact,
/obj/item/storage/firstaid/tactical,
/turf/open/floor/plasteel/rockvault,
/area/space)
"kZ" = (
/obj/machinery/vending/wallmed{
	pixel_x = -32
	},
/turf/open/floor/pod/light,
/area/space)
"lz" = (
/obj/item/cigbutt/roach,
/turf/open/floor/pod/dark,
/area/space)
"mC" = (
/obj/structure/table/wood/fancy/black,
/obj/item/ship_in_a_bottle,
/turf/open/floor/mineral/plastitanium/red,
/area/space)
"mK" = (
/obj/effect/turf_decal/box/white/corners{
	dir = 1
	},
/obj/structure/closet/crate/secure/gear{
	req_access_txt = "150"
	},
/obj/item/clothing/gloves/combat,
/obj/item/clothing/gloves/combat,
/obj/item/clothing/under/syndicate/combat,
/obj/item/clothing/under/syndicate/combat,
/obj/item/storage/belt/military,
/obj/item/storage/belt/military,
/obj/item/clothing/shoes/combat,
/obj/item/clothing/shoes/combat,
/obj/item/clothing/mask/gas/syndicate,
/obj/item/clothing/mask/gas/syndicate,
/obj/item/clothing/glasses/night,
/obj/item/clothing/glasses/night,
/obj/effect/decal/cleanable/dirt,
/obj/effect/decal/cleanable/dirt,
/obj/item/holosign_creator/security,
/turf/open/floor/pod/dark,
/area/space)
"mS" = (
/obj/structure/table/reinforced,
/obj/item/storage/photo_album/syndicate,
/turf/open/floor/pod/dark,
/area/space)
"np" = (
/obj/effect/turf_decal/box/white/corners{
	dir = 8
	},
/obj/structure/closet/crate/secure/weapon{
	req_access_txt = "150"
	},
/obj/item/ammo_box/c10mm{
	pixel_y = 6
	},
/obj/item/ammo_box/c10mm,
/obj/item/ammo_box/magazine/m10mm{
	pixel_x = -5;
	pixel_y = 5
	},
/obj/item/ammo_box/magazine/m10mm{
	pixel_x = -2;
	pixel_y = 2
	},
/obj/item/ammo_box/magazine/m10mm{
	pixel_x = 1;
	pixel_y = -1
	},
/obj/item/ammo_box/magazine/m10mm{
	pixel_x = 4;
	pixel_y = -4
	},
/obj/machinery/atmospherics/components/unary/vent_pump/on,
/obj/item/grenade/spawnergrenade/buzzkill,
/obj/item/grenade/spawnergrenade/buzzkill,
/obj/item/grenade/spawnergrenade/buzzkill,
/turf/open/floor/pod/dark,
/area/space)
"ny" = (
/obj/machinery/door/airlock/hatch{
	name = "Experimentation Lab";
	req_access_txt = "150"
	},
/turf/open/floor/engine/air,
/area/space)
"nE" = (
/obj/machinery/vending/games,
/turf/open/floor/pod/light,
/area/space)
"ob" = (
/obj/machinery/icecream_vat,
/turf/open/floor/plasteel/freezer,
/area/space)
"oh" = (
/obj/effect/mapping_helpers/airlock/locked,
/obj/machinery/door/airlock/vault{
	id_tag = "syndie_lavaland_vault";
	req_access_txt = "150"
	},
/obj/effect/turf_decal/tile/neutral{
	dir = 1
	},
/obj/effect/turf_decal/tile/neutral,
/obj/effect/turf_decal/tile/neutral{
	dir = 4
	},
/obj/effect/turf_decal/tile/neutral{
	dir = 8
	},
/turf/open/floor/plasteel/dark,
/area/space)
"oi" = (
/obj/machinery/shower{
	pixel_y = 14
	},
/turf/open/floor/plasteel/showroomfloor,
/area/space)
"ox" = (
/obj/structure/table/wood,
/obj/machinery/newscaster,
/turf/open/floor/carpet,
/area/space)
"oI" = (
/obj/machinery/microwave,
/turf/open/floor/plasteel/cafeteria,
/area/space)
"oN" = (
/obj/structure/closet/ammunitionlocker,
/turf/open/floor/pod/dark,
/area/space)
"pf" = (
/obj/structure/table/reinforced,
/turf/open/floor/plasteel/cafeteria,
/area/space)
"pC" = (
/obj/structure/table/reinforced,
/obj/machinery/chem_dispenser/fullupgrade,
/turf/open/floor/plasteel/rockvault,
/area/space)
"pE" = (
/obj/structure/bed/roller,
/obj/machinery/iv_drip,
/obj/effect/decal/cleanable/dirt,
/obj/effect/decal/cleanable/dirt,
/obj/effect/turf_decal/tile/neutral{
	dir = 1
	},
/obj/effect/turf_decal/tile/neutral,
/obj/effect/turf_decal/tile/neutral{
	dir = 4
	},
/obj/effect/turf_decal/tile/neutral{
	dir = 8
	},
/mob/living/carbon/monkey{
	faction = list("neutral","Syndicate")
	},
/obj/machinery/light/small{
	dir = 1
	},
/turf/open/floor/engine/air,
/area/space)
"pN" = (
/obj/machinery/washing_machine,
/turf/open/floor/plating,
/area/space)
"qI" = (
/obj/item/target/alien/anchored,
/turf/open/floor/plating,
/area/space)
"qO" = (
/obj/structure/closet/cardboard/metal,
/obj/item/extinguisher/advanced,
/obj/item/flashlight/lantern/syndicate,
/obj/item/flashlight/lantern/syndicate,
/obj/item/soap/syndie,
/obj/item/soap/syndie,
/obj/item/soap/syndie,
/obj/item/storage/box/lights/mixed,
/turf/open/floor/plating,
/area/space)
"sq" = (
/obj/structure/chair/comfy/black{
	dir = 8
	},
/turf/open/floor/pod/dark,
/area/space)
"sT" = (
/turf/open/floor/plasteel/cafeteria,
/area/space)
"tp" = (
/obj/item/paper/monitorkey,
/obj/structure/table,
/turf/open/floor/pod/dark,
/area/space)
"tC" = (
/obj/machinery/vending/wallmed{
	pixel_x = -32
	},
/turf/open/floor/plasteel/cafeteria,
/area/space)
"tT" = (
/obj/structure/reagent_dispensers/beerkeg,
/turf/open/floor/wood,
/area/space)
"tZ" = (
/obj/structure/table/wood/fancy,
/obj/item/storage/fancy/cigarettes/cigars/cohiba,
/turf/open/floor/pod/dark,
/area/space)
"uh" = (
/obj/structure/toilet{
	pixel_y = 18
	},
/obj/machinery/light/small{
	dir = 8
	},
/turf/open/floor/plasteel/showroomfloor,
/area/space)
"um" = (
/obj/machinery/chem_dispenser/drinks/fullupgrade{
	dir = 8
	},
/obj/structure/table/wood,
/turf/open/floor/wood,
/area/space)
"uA" = (
/obj/machinery/vending/wallmed{
	pixel_x = 32
	},
/turf/open/floor/pod/light,
/area/space)
"uQ" = (
/obj/machinery/door/airlock/hatch{
	name = "Telecommunications Control";
	req_access_txt = "150"
	},
/turf/open/floor/circuit/green,
/area/space)
"uR" = (
/obj/machinery/hydroponics/constructable,
/obj/item/seeds/eggplant/eggy,
/turf/open/floor/plasteel,
/area/space)
"uS" = (
/obj/structure/closet/crate/bin,
/turf/open/floor/pod/light,
/area/space)
"uY" = (
/obj/structure/chair/comfy/black{
	dir = 4
	},
/turf/open/floor/pod/dark,
/area/space)
"ve" = (
/obj/machinery/hydroponics/constructable,
/obj/item/seeds/nettle/death,
/turf/open/floor/plasteel,
/area/space)
"vB" = (
/obj/structure/fermenting_barrel,
/turf/open/floor/plasteel,
/area/space)
"vH" = (
/obj/structure/mopbucket,
/obj/item/mop/advanced,
/turf/open/floor/plating,
/area/space)
"vO" = (
/obj/structure/table/wood/fancy/black,
/obj/item/clipboard,
/obj/item/shard/plasma,
/turf/open/floor/mineral/plastitanium/red,
/area/space)
"wa" = (
/obj/structure/table/wood,
/obj/item/toy/figure/syndie,
/obj/item/toy/nuke,
/turf/open/floor/carpet,
/area/space)
"xo" = (
/turf/open/floor/wood,
/area/space)
"xv" = (
/obj/structure/table/wood,
/obj/item/paper_bin,
/obj/item/pen,
/turf/open/floor/carpet,
/area/space)
"xV" = (
/obj/machinery/syndicatebomb/self_destruct{
	anchored = 1
	},
/turf/open/floor/circuit/red,
/area/space)
"yy" = (
/turf/open/floor/pod/dark,
/area/space)
"zb" = (
/obj/structure/bed/roller,
/obj/machinery/iv_drip,
/obj/effect/decal/cleanable/dirt,
/obj/effect/decal/cleanable/dirt,
/obj/effect/turf_decal/tile/neutral{
	dir = 1
	},
/obj/effect/turf_decal/tile/neutral,
/obj/effect/turf_decal/tile/neutral{
	dir = 4
	},
/obj/effect/turf_decal/tile/neutral{
	dir = 8
	},
/mob/living/carbon/monkey{
	faction = list("neutral","Syndicate")
	},
/turf/open/floor/engine/air,
/area/space)
"zJ" = (
/obj/machinery/light/floor,
/turf/open/floor/pod/dark,
/area/space)
"Ai" = (
/obj/structure/table/wood,
/obj/item/toy/prize/mauler,
/obj/item/toy/toy_xeno,
/turf/open/floor/carpet,
/area/space)
"AH" = (
/obj/machinery/vending/wallmed{
	pixel_y = 32
	},
/turf/open/floor/carpet,
/area/space)
"Bb" = (
/obj/structure/mirror{
	pixel_y = 32
	},
/turf/open/floor/plating,
/area/space)
"Bm" = (
/obj/structure/table/wood/fancy/black,
/obj/item/reagent_containers/food/snacks/chocolatebar,
/obj/item/coin/antagtoken,
/turf/open/floor/mineral/plastitanium/red,
/area/space)
"Cj" = (
/obj/item/lazarus_injector,
/obj/item/melee/skateboard,
/turf/open/floor/plating,
/area/space)
"Cn" = (
/obj/structure/table/wood/fancy,
/obj/item/stack/spacecash/c200,
/turf/open/floor/pod/dark,
/area/space)
"CO" = (
/obj/structure/table/wood/fancy/black,
/obj/structure/votebox,
/turf/open/floor/mineral/plastitanium/red,
/area/space)
"EE" = (
/obj/machinery/vending/boozeomat/syndicate_access,
/turf/closed/wall/r_wall/syndicate,
/area/space)
"FJ" = (
/obj/structure/table/reinforced,
/obj/item/stack/spacecash/c100,
/obj/item/storage/pill_bottle/mannitol,
/obj/item/storage/pill_bottle/psicodine,
/turf/open/floor/pod/dark,
/area/space)
"FL" = (
/obj/structure/table/wood/fancy/black,
/obj/item/seeds/kudzu,
/obj/item/seeds/gatfruit,
/turf/open/floor/mineral/plastitanium/red,
/area/space)
"FM" = (
/turf/open/floor/engine/air,
/area/space)
"FR" = (
/obj/item/stack/rods/fifty,
/obj/item/stack/sheet/glass/fifty,
/obj/item/stack/sheet/glass/fifty,
/obj/item/stack/sheet/metal/fifty,
/obj/item/stack/sheet/metal/fifty,
/turf/open/floor/plating,
/area/space)
"FV" = (
/turf/open/floor/plasteel/freezer,
/area/space)
"Gg" = (
/obj/structure/closet/crate,
/obj/item/storage/toolbox/electrical{
	pixel_y = 4
	},
/obj/item/storage/toolbox/mechanical,
/turf/open/floor/plasteel/dark,
/area/space)
"Gn" = (
/obj/item/inducer,
/obj/item/inducer,
/obj/item/stack/cable_coil,
/obj/item/stack/cable_coil,
/obj/item/storage/box/metalfoam,
/obj/item/storage/toolbox/syndicate,
/obj/item/storage/toolbox/syndicate,
/turf/open/floor/plating,
/area/space)
"Gu" = (
/obj/effect/turf_decal/box/white/corners{
	dir = 4
	},
/obj/structure/closet/crate,
/obj/item/storage/box/donkpockets{
	pixel_x = -2;
	pixel_y = 6
	},
/obj/item/storage/box/donkpockets{
	pixel_y = 3
	},
/obj/item/storage/box/donkpockets{
	pixel_x = 2
	},
/obj/effect/decal/cleanable/dirt,
/obj/item/grenade/clusterbuster/smoke,
/turf/open/floor/pod/dark,
/area/space)
"GL" = (
/obj/item/twohanded/required/kirbyplants/random,
/turf/open/floor/carpet,
/area/space)
"GO" = (
/obj/machinery/vending/wallmed{
	pixel_x = 32
	},
/turf/open/floor/sepia,
/area/space)
"GP" = (
/obj/item/twohanded/required/kirbyplants/random,
/turf/open/floor/pod/light,
/area/space)
"Hg" = (
/obj/machinery/vending/sovietsoda,
/turf/open/floor/pod/light,
/area/space)
"Hi" = (
/obj/structure/closet/crate/bin,
/turf/open/floor/wood,
/area/space)
"HA" = (
/obj/machinery/power/floodlight,
/turf/open/floor/plating,
/area/space)
"HH" = (
/obj/machinery/reagentgrinder/constructed,
/obj/structure/table/reinforced,
/turf/open/floor/plasteel/rockvault,
/area/space)
"HK" = (
/obj/item/sharpener,
/turf/open/floor/plasteel/cafeteria,
/area/space)
"HN" = (
/obj/machinery/door/airlock/medical/glass{
	name = "Medbay"
	},
/turf/open/floor/plasteel/rockvault,
/area/space)
"HT" = (
/obj/machinery/airalarm/syndicate{
	pixel_y = 24
	},
/obj/structure/closet/crate,
/obj/item/extinguisher{
	pixel_x = -5;
	pixel_y = 5
	},
/obj/item/extinguisher{
	pixel_x = -2;
	pixel_y = 2
	},
/obj/item/extinguisher{
	pixel_x = 1;
	pixel_y = -1
	},
/obj/item/flashlight{
	pixel_x = -5;
	pixel_y = 5
	},
/obj/item/flashlight{
	pixel_x = -2;
	pixel_y = 2
	},
/obj/item/flashlight{
	pixel_x = 1;
	pixel_y = -1
	},
/obj/item/radio/headset/syndicate/alt{
	pixel_x = -3;
	pixel_y = 3
	},
/obj/item/radio/headset/syndicate/alt,
/obj/item/radio/headset/syndicate/alt{
	pixel_x = 3;
	pixel_y = -3
	},
/obj/effect/decal/cleanable/dirt,
/obj/item/shadowcloak,
/turf/open/floor/pod/dark,
/area/space)
"Jl" = (
/obj/item/storage/box/monkeycubes/syndicate,
/obj/item/storage/box/monkeycubes/syndicate,
/obj/structure/table/reinforced,
/turf/open/floor/engine/air,
/area/space)
"Jy" = (
/obj/structure/window/reinforced{
	dir = 1;
	pixel_y = 1
	},
/obj/structure/flora/ausbushes/fullgrass,
/obj/structure/flora/ausbushes/palebush,
/obj/structure/flora/ausbushes/lavendergrass,
/obj/structure/flora/grass/green,
/turf/open/floor/plating/grass,
/area/space)
"JH" = (
/obj/machinery/door/airlock/public/glass{
	name = "Botany"
	},
/turf/open/floor/pod/light,
/area/space)
"JJ" = (
/obj/structure/window/reinforced{
	dir = 1;
	pixel_y = 1
	},
/obj/structure/flora/ausbushes/brflowers,
/obj/structure/flora/ausbushes/fernybush,
/turf/open/floor/plating/grass,
/area/space)
"JR" = (
/obj/machinery/computer/med_data/syndie{
	req_one_access = null
	},
/turf/open/floor/pod/dark,
/area/space)
"JW" = (
/obj/machinery/field/generator,
/turf/open/floor/pod/dark,
/area/space)
"KP" = (
/obj/structure/reagent_dispensers/watertank,
/turf/open/floor/plating,
/area/space)
"KS" = (
/obj/structure/table/reinforced,
/obj/item/stack/spacecash/c100,
/turf/open/floor/pod/dark,
/area/space)
"Lg" = (
/obj/structure/table/wood/fancy/black,
/obj/item/flashlight/flashdark,
/turf/open/floor/mineral/plastitanium/red,
/area/space)
"Lh" = (
/obj/machinery/door/airlock{
	name = "Unisex Restrooms"
	},
/turf/open/floor/plasteel/showroomfloor,
/area/space)
"Li" = (
/turf/open/floor/plasteel,
/area/space)
"Lz" = (
/obj/structure/window/reinforced{
	dir = 1;
	pixel_y = 1
	},
/obj/structure/flora/ausbushes/sparsegrass,
/obj/structure/flora/ausbushes/genericbush,
/turf/open/floor/plating/grass,
/area/space)
"LG" = (
/obj/structure/chair/bronze{
	dir = 1
	},
/turf/open/floor/pod/dark,
/area/space)
"LM" = (
/obj/structure/table/wood/fancy/black,
/obj/item/dice/fourdd6,
/obj/item/stack/spacecash/c1000,
/turf/open/floor/mineral/plastitanium/red,
/area/space)
"LY" = (
/obj/structure/table/wood/fancy/black,
/obj/item/coin/mythril,
/obj/item/stack/telecrystal,
/turf/open/floor/mineral/plastitanium/red,
/area/space)
"LZ" = (
/obj/structure/bodycontainer/morgue{
	dir = 8
	},
/turf/open/floor/plating,
/area/space)
"MN" = (
/obj/machinery/porta_turret/syndicate,
/turf/open/floor/plating/ashplanet/rocky,
/area/space)
"MT" = (
/obj/machinery/door/airlock/public/glass{
	name = "Kitchen"
	},
/turf/open/floor/pod/light,
/area/space)
"Nl" = (
/obj/machinery/door/airlock/engineering{
	name = "Engineering";
	req_access_txt = "150"
	},
/turf/open/floor/plating,
/area/space)
"Ns" = (
/obj/structure/table/wood/fancy/black,
/obj/item/gun/energy/taser,
/turf/open/floor/mineral/plastitanium/red,
/area/space)
"Nw" = (
/obj/structure/table/reinforced,
/obj/item/storage/box/donkpockets,
/obj/item/storage/fancy/donut_box,
/turf/open/floor/pod/dark,
/area/space)
"NM" = (
/obj/machinery/hydroponics/constructable,
/obj/item/seeds/cannabis/rainbow,
/turf/open/floor/plasteel,
/area/space)
"NO" = (
/obj/machinery/telecomms/relay/preset/ruskie{
	use_power = 0
	},
/turf/open/floor/circuit/green,
/area/space)
"Op" = (
/obj/machinery/door/airlock/public/glass{
	name = "Bar"
	},
/turf/open/floor/wood,
/area/space)
"Pj" = (
/obj/machinery/door/window/brigdoor{
	req_access_txt = "150"
	},
/turf/open/floor/circuit/red,
/area/space)
"PE" = (
/obj/effect/turf_decal/box/white/corners,
/obj/structure/closet/crate,
/obj/item/reagent_containers/glass/beaker/waterbottle/large{
	pixel_x = -3;
	pixel_y = 3
	},
/obj/item/reagent_containers/glass/beaker/waterbottle/large{
	pixel_x = -3;
	pixel_y = 3
	},
/obj/item/reagent_containers/glass/beaker/waterbottle/large,
/obj/item/reagent_containers/glass/beaker/waterbottle/large,
/obj/item/reagent_containers/glass/beaker/waterbottle/large{
	pixel_x = 3;
	pixel_y = -3
	},
/obj/item/reagent_containers/glass/beaker/waterbottle/large{
	pixel_x = 3;
	pixel_y = -3
	},
/obj/effect/decal/cleanable/dirt,
/turf/open/floor/plasteel/dark,
/area/space)
"PJ" = (
/obj/machinery/porta_turret/syndicate,
/turf/template_noop,
/area/space)
"PV" = (
/obj/machinery/chem_dispenser/drinks/beer/fullupgrade{
	dir = 8
	},
/obj/structure/table/wood,
/turf/open/floor/wood,
/area/space)
"Qs" = (
/obj/machinery/door/airlock/maintenance,
/turf/open/floor/plating,
/area/space)
"Qv" = (
/obj/structure/closet/crate/bin,
/turf/open/floor/plating,
/area/space)
"QV" = (
/obj/structure/sign/poster/contraband/c20r,
/turf/closed/wall/r_wall/syndicate,
/area/space)
"Rl" = (
/obj/structure/piano,
/turf/open/floor/carpet,
/area/space)
"Rx" = (
/obj/structure/table/wood/fancy/black,
/obj/item/documents/syndicate/blue,
/obj/item/pen/edagger,
/turf/open/floor/mineral/plastitanium/red,
/area/space)
"SB" = (
/obj/machinery/hydroponics/constructable,
/obj/item/seeds/tea/astra,
/turf/open/floor/plasteel,
/area/space)
"Tm" = (
/obj/structure/filingcabinet,
/obj/item/paper/fluff/ruins/listeningstation/reports/april,
/obj/item/paper/fluff/ruins/listeningstation/reports/may,
/obj/item/paper/fluff/ruins/listeningstation/reports/june,
/obj/item/paper/fluff/ruins/listeningstation/reports/july,
/obj/item/paper/fluff/ruins/listeningstation/reports/august,
/obj/item/paper/fluff/ruins/listeningstation/reports/september,
/obj/item/paper/fluff/ruins/listeningstation/reports/october,
/obj/item/paper/fluff/ruins/listeningstation/receipt,
/obj/effect/decal/cleanable/dirt,
/obj/item/paper/fluff/ruins/listeningstation/odd_report,
/turf/open/floor/pod/dark,
/area/space)
"TW" = (
/obj/machinery/door/airlock/public/glass{
	name = "Dormitories"
	},
/turf/open/floor/pod/light,
/area/space)
"Ue" = (
/obj/structure/table/wood/fancy,
/obj/item/storage/box/drinkingglasses,
/turf/open/floor/pod/dark,
/area/space)
"UQ" = (
/obj/structure/table/optable,
/turf/open/floor/plasteel/rockvault,
/area/space)
"UV" = (
/turf/open/floor/circuit/red,
/area/space)
"Vb" = (
/obj/structure/table/reinforced,
/obj/machinery/chem_heater,
/turf/open/floor/plasteel/rockvault,
/area/space)
"Vk" = (
/obj/structure/punching_bag,
/turf/open/floor/carpet,
/area/space)
"Vo" = (
/obj/structure/window/reinforced{
	dir = 1;
	pixel_y = 1
	},
/obj/structure/flora/ausbushes/reedbush,
/obj/structure/flora/ausbushes/sparsegrass,
/obj/structure/flora/ausbushes/ywflowers,
/turf/open/floor/plating/grass,
/area/space)
"VH" = (
/obj/structure/table/wood/fancy/black,
/obj/item/firing_pin/paywall,
/obj/item/gun/syringe/syndicate,
/turf/open/floor/mineral/plastitanium/red,
/area/space)
"VN" = (
/obj/machinery/hydroponics/constructable,
/obj/item/seeds/apple,
/turf/open/floor/plasteel,
/area/space)
"WF" = (
/obj/machinery/door/airlock/hatch{
	name = "Monkey Pen";
	req_access_txt = "150"
	},
/turf/open/floor/engine/air,
/area/space)
"WU" = (
/obj/machinery/computer/camera_advanced,
/turf/open/floor/pod/dark,
/area/space)
"XE" = (
/obj/machinery/vending/donksofttoyvendor,
/turf/open/floor/pod/light,
/area/space)
"XN" = (
/turf/open/floor/plasteel/dark,
/area/space)
"Yi" = (
/obj/structure/sign/poster/contraband/energy_swords,
/turf/closed/wall/r_wall/syndicate,
/area/space)
"Zp" = (
/obj/structure/bedsheetbin,
/turf/open/floor/plating,
/area/space)

(1,1,1) = {"
aa
aa
aa
aa
aa
aa
aa
aa
aa
aa
aa
aa
aa
aa
aa
aa
aG
aG
aG
aG
aG
aG
aG
aG
aG
aG
aa
aa
aa
aa
aa
aa
aa
aa
aa
aa
aa
aa
"}
(2,1,1) = {"
aa
aa
aa
aa
aa
aa
aG
aG
aG
aG
aG
aa
aa
aa
aG
aG
aG
aG
aG
aG
aG
aI
aI
aI
aI
aG
aG
aa
aa
aa
aa
aa
aa
aa
aa
aa
aa
aa
"}
(3,1,1) = {"
aa
aa
aa
aa
aa
aG
aG
aG
aG
aG
aG
aG
aa
aG
aG
aG
aI
aI
aI
aI
aI
aI
Li
Li
Li
aI
aG
aG
aG
aG
aa
aG
aG
aG
aa
aa
aa
aa
"}
(4,1,1) = {"
aa
aa
aa
aa
aG
aG
aI
aI
aI
aI
aG
aG
aG
aG
aG
aI
aI
hJ
hJ
UQ
co
aI
vB
Li
Li
aI
aG
aG
aG
aG
aG
aG
aG
aG
aG
aa
aa
aa
"}
(5,1,1) = {"
aa
aa
aa
aG
aG
aI
aI
FM
FM
aI
aI
aI
aI
aI
aI
aI
gs
co
co
co
jS
aI
NM
Li
SB
aI
aI
aI
aI
aI
aG
aG
aG
aG
aG
aa
aa
aa
"}
(6,1,1) = {"
aa
aa
aa
aG
aG
aI
am
FM
FM
aj
Jl
aI
pE
zb
zb
aI
pC
co
co
co
aI
aI
cK
Li
VN
aI
fI
FV
ob
aI
aG
aG
aG
aG
aG
aG
aG
aa
"}
(7,1,1) = {"
aa
aa
aG
aG
aG
aI
FM
FM
FM
cb
FM
aI
aj
WF
aj
aI
dx
co
co
co
gf
aI
uR
Li
ve
aI
PE
FV
FV
aI
aG
aG
aG
aG
aG
aG
aG
aa
"}
(8,1,1) = {"
aa
aa
aG
aG
aG
aI
am
FM
FM
aj
FM
FM
FM
FM
FM
ny
co
bX
aj
co
aI
aI
aj
JH
aj
aI
aj
Li
aj
aI
aG
aG
aG
aG
aG
aG
aG
aa
"}
(9,1,1) = {"
aa
aa
aG
aG
aG
aI
aI
aI
aI
aI
aI
aI
aI
aI
aI
aI
HH
Vb
aj
co
aI
aD
aD
aD
sT
tC
sT
sT
sT
aI
aI
aI
aG
aG
aG
aG
aG
aa
"}
(10,1,1) = {"
aa
aa
aa
aG
aG
aG
aI
aG
aG
aG
aI
vH
aH
KP
qO
aI
aj
aj
aI
HN
aI
MT
aI
aI
oI
sT
sT
pf
sT
sT
bF
aI
aG
aG
aG
aG
aG
aa
"}
(11,1,1) = {"
aa
aa
aa
aG
aG
aG
aI
aI
aI
aI
aI
Zp
aH
Qv
aI
aI
uS
aD
kZ
aD
aD
aD
fJ
aj
aj
HK
sT
sT
sT
sT
sT
aI
aG
aG
aG
aG
aa
aa
"}
(12,1,1) = {"
aa
aa
aa
aG
aG
aG
aI
cu
yy
Tm
aI
pN
aH
aI
aI
aD
aD
aD
aD
aD
aD
aD
aD
fJ
aj
aI
FJ
Nw
mS
KS
fy
bk
eC
aI
aG
aG
aa
aa
"}
(13,1,1) = {"
aa
aa
aa
aG
aG
aG
aI
WU
yy
yy
aI
aI
Bb
Qs
aD
aD
da
GP
aI
aj
aI
GP
da
aD
aD
aj
yy
yy
yy
yy
yy
yy
lz
aI
aI
aG
aG
aa
"}
(14,1,1) = {"
aa
aa
aa
aa
aa
aG
aI
JR
yy
yy
tp
aI
LZ
aI
aD
aD
GP
aI
aI
UV
aI
aI
GP
aD
aD
aj
yy
yy
uY
uY
uY
uY
yy
Vo
aI
aG
aG
aa
"}
(15,1,1) = {"
aa
aG
aG
aG
aa
aG
aI
aI
aI
yy
aI
aI
aI
aI
aD
aD
aI
aI
UV
UV
UV
aI
aI
aD
aD
aj
yy
zJ
it
FL
Ns
LY
yy
JJ
aI
aG
aG
aa
"}
(16,1,1) = {"
aa
aG
aa
aa
aa
aG
aI
NO
uQ
XN
dc
XN
XN
dc
aD
aD
aj
UV
UV
xV
UV
Pj
oh
aD
aD
cY
yy
yy
CO
mC
LM
Rx
LG
Lz
aI
aG
aG
aa
"}
(17,1,1) = {"
aa
aG
aa
aG
aG
aG
aI
aI
aI
aD
aI
aI
aI
aI
aD
aD
aI
aI
UV
UV
UV
aI
aI
aD
aD
aj
yy
zJ
Bm
VH
vO
Lg
yy
Jy
aI
aG
aG
aa
"}
(18,1,1) = {"
aa
aG
PJ
aa
aa
aG
aI
aD
aD
aD
aD
aI
ca
aI
aD
aD
GP
aI
aI
UV
aI
aI
GP
aD
aD
aj
yy
yy
sq
sq
sq
sq
yy
gE
aI
aG
aG
aa
"}
(19,1,1) = {"
aa
aG
aI
aj
aj
aI
aI
aD
uA
aD
aD
aI
Cj
aI
XE
aD
da
GP
aI
aj
aI
GP
da
aD
aD
aj
yy
yy
yy
yy
yy
yy
bm
aI
aI
aG
aG
aa
"}
(20,1,1) = {"
aG
aG
aI
aH
aH
HA
aI
aI
aI
aI
aI
aI
aI
aI
aI
nE
aD
aD
aD
aD
aD
aD
aD
fJ
aj
aI
tZ
dL
Cn
Ue
QV
Yi
cd
aI
aG
aG
aG
aG
"}
(21,1,1) = {"
aG
aG
aI
aH
aH
aH
aH
aH
aH
aH
aH
aH
aH
qI
aI
aI
Hg
aD
aD
aD
aD
aD
fJ
aj
aj
tT
xo
xo
xo
xo
xo
aI
aG
aG
aG
aG
aG
aG
"}
(22,1,1) = {"
aG
aG
aI
aH
aH
aH
aH
aH
aH
aH
aH
aH
aH
aH
Gg
aI
aI
aI
aI
TW
aI
Op
aI
aI
hP
xo
xo
xo
xo
xo
xo
aI
aG
aG
aG
aG
aG
aG
"}
(23,1,1) = {"
aa
aG
aI
Gn
FR
aI
aI
aI
aI
aI
aI
Nl
aI
aI
aI
aI
wa
Ai
aI
aD
aI
xo
xo
xo
xo
fW
xo
xo
xo
Hi
aI
aI
aG
aG
aG
aG
aG
aG
"}
(24,1,1) = {"
aa
aG
aI
aI
aI
aI
ae
ae
ae
aj
aA
aA
aA
aA
aA
aA
aA
aA
aI
aD
aI
aI
aI
aI
aI
aI
EE
xo
xo
aI
aI
aG
aG
aG
aG
aG
aG
aG
"}
(25,1,1) = {"
aa
aG
aG
aI
uh
aI
ae
ae
ae
aI
xv
ox
aB
GL
aA
aA
aA
aA
aI
aD
aI
np
mK
oN
aI
aG
aI
um
PV
aI
aG
aG
aG
aG
aG
aG
aG
aa
"}
(26,1,1) = {"
aa
aG
aG
aI
cR
Lh
ae
ae
ae
hh
aA
aA
aA
aA
aA
aA
aA
aA
TW
aD
aD
yy
yy
fX
aI
aG
aI
aI
aI
aI
aG
aG
aG
aa
aa
aa
aa
aa
"}
(27,1,1) = {"
aa
aG
aG
aI
oi
aI
ae
ae
ae
aI
aI
aC
aI
aI
AH
aA
aA
aA
TW
aD
aD
yy
yy
JW
aI
aG
aG
aG
aG
aG
aG
aG
aa
aa
aa
aa
aa
aa
"}
(28,1,1) = {"
aa
aG
aG
aI
aI
aI
ae
GO
ae
aI
ax
aH
aM
aI
Vk
aA
GL
Rl
aI
fJ
aI
HT
Gu
JW
aI
aG
aG
aG
aG
aG
aG
aa
aa
aa
aa
aa
aa
aa
"}
(29,1,1) = {"
aa
aG
aG
aG
aG
aI
aI
aI
aI
aI
aI
aE
aI
aI
aI
aI
aI
aI
aI
aI
aI
aI
aI
aI
aI
aG
aG
aG
aG
aa
aa
aa
aa
aa
aa
aa
aa
aa
"}
(30,1,1) = {"
aa
aa
aa
aG
aG
aG
aG
aG
aG
aF
aF
aF
MN
aG
aG
aG
aG
aG
aG
aG
aG
aG
aG
aG
aG
aG
aa
aa
aa
aa
aa
aa
aa
aa
aa
aa
aa
aa
"}
(31,1,1) = {"
aa
aa
aa
aa
aa
aG
aG
aG
aG
aF
aG
aG
aG
aG
aG
aG
aG
aG
aG
aG
aG
aG
aG
aG
aG
aG
aa
aa
aa
aa
aa
aa
aa
aa
aa
aa
aa
aa
"}
(32,1,1) = {"
aa
aa
aa
aa
aa
aa
aa
aa
aa
bJ
aa
aa
aa
aa
aa
aa
aa
aa
aa
aG
aG
aG
aG
aG
aa
aa
aa
aa
aa
aa
aa
aa
aa
aa
aa
aa
aa
aa
"}
