//MAP CONVERTED BY dmm2tgm.py THIS HEADER COMMENT PREVENTS RECONVERSION, DO NOT REMOVE
"a" = (
/turf/open/space/basic,
/area/space)
"b" = (
/turf/open/floor/plating/asteroid/airless,
/area/ruin/space/has_grav/powered/scp_294)
"c" = (
/obj/structure/lattice,
/turf/open/space/basic,
/area/space)
"d" = (
/obj/structure/lattice,
/turf/open/space/basic,
/area/ruin/space/has_grav/powered/scp_294)
"e" = (
/obj/machinery/porta_turret/syndicate/energy/heavy{
	mode = 1
	},
/turf/open/floor/plating/asteroid/airless,
/area/ruin/space/has_grav/powered/scp_294)
"f" = (
/turf/closed/wall,
/area/ruin/space/has_grav/powered/scp_294)
"g" = (
/turf/closed/wall/rust,
/area/ruin/space/has_grav/powered/scp_294)
"h" = (
/turf/open/floor/plating/airless,
/area/ruin/space/has_grav/powered/scp_294)
"i" = (
/obj/item/wirerod,
/turf/open/floor/plating/airless,
/area/ruin/space/has_grav/powered/scp_294)
"j" = (
/turf/open/floor/plating/airless/astplate,
/area/ruin/space/has_grav/powered/scp_294)
"k" = (
/obj/effect/decal/remains/human,
/turf/open/floor/plating/airless,
/area/ruin/space/has_grav/powered/scp_294)
"l" = (
/obj/machinery/light{
	dir = 4;
	flickering = 1;
	idle_power_usage = 0;
	use_power = 0
	},
/turf/open/floor/plating/airless,
/area/ruin/space/has_grav/powered/scp_294)
"m" = (
/obj/machinery/chem_dispenser/scp_294,
/turf/open/floor/plating/airless,
/area/ruin/space/has_grav/powered/scp_294)
"n" = (
/obj/structure/trap/damage,
/turf/open/floor/plating/airless,
/area/ruin/space/has_grav/powered/scp_294)
"o" = (
/obj/structure/girder,
/turf/open/floor/plating/asteroid/airless,
/area/ruin/space/has_grav/powered/scp_294)
"p" = (
/obj/effect/decal/remains/robot,
/turf/open/floor/plating/airless,
/area/ruin/space/has_grav/powered/scp_294)
"q" = (
/obj/structure/trap/fire,
/turf/open/floor/plating/airless,
/area/ruin/space/has_grav/powered/scp_294)
"r" = (
/obj/structure/trap/stun,
/turf/open/floor/plating/airless,
/area/ruin/space/has_grav/powered/scp_294)
"s" = (
/obj/structure/trap/stun,
/obj/machinery/light{
	flickering = 1;
	idle_power_usage = 0;
	use_power = 0
	},
/turf/open/floor/plating/airless,
/area/ruin/space/has_grav/powered/scp_294)
"t" = (
/obj/item/wrench,
/turf/open/floor/plating/airless,
/area/ruin/space/has_grav/powered/scp_294)
"u" = (
/obj/structure/girder/reinforced,
/turf/open/floor/plating/asteroid/airless,
/area/ruin/space/has_grav/powered/scp_294)
"v" = (
/obj/machinery/porta_turret/syndicate/energy/heavy{
	mode = 1
	},
/turf/closed/wall/rust,
/area/ruin/space/has_grav/powered/scp_294)

(1,1,1) = {"
a
a
a
a
a
a
a
a
a
a
a
a
a
a
a
a
a
a
a
a
"}
(2,1,1) = {"
a
a
a
a
a
a
a
b
b
b
a
a
a
a
a
a
a
a
a
a
"}
(3,1,1) = {"
a
a
a
a
a
b
e
b
b
b
a
a
a
b
a
a
a
a
a
a
"}
(4,1,1) = {"
a
a
a
a
b
b
b
b
b
b
b
b
b
b
b
a
a
a
a
a
"}
(5,1,1) = {"
a
a
a
b
b
b
b
b
b
b
b
b
b
b
b
a
a
a
a
a
"}
(6,1,1) = {"
a
a
a
b
b
f
g
g
f
f
f
f
u
b
d
a
a
a
a
a
"}
(7,1,1) = {"
a
a
a
a
b
f
h
i
h
p
j
r
u
b
a
a
a
a
a
a
"}
(8,1,1) = {"
a
a
a
a
b
f
h
j
h
h
h
s
f
b
b
e
a
a
a
a
"}
(9,1,1) = {"
a
a
a
a
b
f
h
h
h
j
h
t
f
b
b
a
a
a
a
a
"}
(10,1,1) = {"
a
a
a
a
b
f
h
h
m
h
h
h
f
b
a
a
a
a
a
a
"}
(11,1,1) = {"
a
a
a
a
b
g
h
k
h
h
h
h
g
b
d
a
a
a
a
a
"}
(12,1,1) = {"
a
a
a
d
b
f
h
h
j
h
h
h
f
b
d
d
a
a
a
a
"}
(13,1,1) = {"
a
a
a
b
b
f
h
l
n
q
h
k
f
b
a
a
a
a
a
a
"}
(14,1,1) = {"
a
a
a
b
b
f
f
f
o
o
f
f
v
b
a
a
a
a
a
a
"}
(15,1,1) = {"
a
a
a
e
b
b
b
b
b
b
b
b
b
b
b
a
a
a
a
a
"}
(16,1,1) = {"
a
a
a
a
a
b
b
b
b
b
b
b
c
c
b
a
a
a
a
a
"}
(17,1,1) = {"
a
a
a
a
a
a
b
b
b
b
c
a
a
c
a
a
a
a
a
a
"}
(18,1,1) = {"
a
a
a
a
a
a
b
b
b
c
a
a
a
a
a
a
a
a
a
a
"}
(19,1,1) = {"
a
a
a
a
a
a
a
a
a
a
a
a
a
a
a
a
a
a
a
a
"}
(20,1,1) = {"
a
a
a
a
a
a
a
a
a
a
a
a
a
a
a
a
a
a
a
a
"}
