"aa" = (/turf/open/space,/area/space)
"ab" = (/turf/closed/mineral,/area/ruin/unpowered/no_grav)
"ac" = (/turf/open/floor/plating/asteroid/airless,/area/ruin/unpowered/no_grav)
"ad" = (/obj/structure/grille,/obj/structure/window/reinforced/fulltile,/turf/open/floor/plating,/area/ruin/powered/spacebar)
"ae" = (/turf/closed/wall,/area/ruin/powered/spacebar)
"af" = (/obj/structure/grille,/obj/structure/window/reinforced/fulltile,/turf/open/floor/plating,/area/ruin/powered/spacebar)
"ag" = (/turf/open/floor/plating/asteroid,/area/ruin/powered/spacebar)
"ah" = (/obj/structure/grille,/obj/structure/window/reinforced/fulltile,/turf/open/floor/plating/asteroid,/area/ruin/powered/spacebar)
"ai" = (/turf/closed/mineral,/area/ruin/powered/spacebar)
"aj" = (/turf/open/floor/plating/asteroid,/turf/closed/wall/mineral/titanium/interior,/area/ruin/powered/spacebar)
"ak" = (/obj/structure/grille,/obj/structure/window/shuttle,/turf/open/floor/plating,/area/ruin/powered/spacebar)
"al" = (/turf/closed/wall,/area/ruin/powered/spacebar/bar)
"am" = (/turf/closed/wall/mineral/titanium,/area/ruin/powered/spacebar)
"an" = (/obj/structure/chair{dir = 1},/turf/open/floor/mineral/titanium/blue,/area/ruin/powered/spacebar)
"ao" = (/obj/structure/table,/obj/machinery/chem_dispenser/drinks/beer,/turf/open/floor/wood,/area/ruin/powered/spacebar/bar)
"ap" = (/obj/structure/table,/obj/machinery/chem_dispenser/drinks,/turf/open/floor/wood,/area/ruin/powered/spacebar/bar)
"aq" = (/obj/structure/table,/obj/machinery/light/small{dir = 1},/obj/item/weapon/book/manual/barman_recipes,/turf/open/floor/wood,/area/ruin/powered/spacebar/bar)
"ar" = (/turf/open/floor/wood,/area/ruin/powered/spacebar/bar)
"as" = (/obj/structure/table,/obj/item/toy/figure/bartender,/turf/open/floor/wood,/area/ruin/powered/spacebar/bar)
"at" = (/obj/structure/table,/obj/item/weapon/reagent_containers/food/drinks/shaker,/turf/open/floor/wood,/area/ruin/powered/spacebar/bar)
"au" = (/obj/effect/mob_spawn/human/bartender/alive,/turf/open/floor/wood,/area/ruin/powered/spacebar/bar)
"av" = (/obj/structure/reagent_dispensers/beerkeg,/turf/open/floor/wood,/area/ruin/powered/spacebar/bar)
"aw" = (/turf/open/floor/mineral/titanium/blue,/area/ruin/powered/spacebar)
"ax" = (/obj/machinery/airalarm{dir = 4; icon_state = "alarm0"; pixel_x = -22},/turf/open/floor/wood,/area/ruin/powered/spacebar/bar)
"ay" = (/obj/machinery/door/airlock{name = "Bar Storage"; req_access_txt = "25"},/turf/open/floor/wood,/area/ruin/powered/spacebar/bar)
"az" = (/obj/machinery/atmospherics/components/unary/vent_scrubber,/turf/open/floor/wood,/area/ruin/powered/spacebar/bar)
"aA" = (/obj/machinery/atmospherics/components/unary/vent_pump,/turf/open/floor/wood,/area/ruin/powered/spacebar/bar)
"aB" = (/obj/structure/table,/obj/machinery/reagentgrinder,/turf/open/floor/wood,/area/ruin/powered/spacebar/bar)
"aC" = (/turf/open/floor/plating,/obj/structure/shuttle/engine/propulsion/burst,/turf/closed/wall/mineral/titanium/interior,/area/ruin/powered/spacebar)
"aD" = (/obj/machinery/door/airlock/titanium{name = "Escape Pod Airlock"},/turf/open/floor/mineral/titanium/blue,/area/ruin/powered/spacebar)
"aE" = (/obj/machinery/button/door{id = "spacebardock"; name = "pod dock door cycle"; pixel_x = -32},/turf/open/floor/wood,/area/ruin/powered/spacebar/bar)
"aF" = (/obj/machinery/vending/boozeomat,/turf/closed/wall,/area/ruin/powered/spacebar/bar)
"aG" = (/obj/structure/closet/secure_closet/freezer/kitchen,/turf/open/floor/wood,/area/ruin/powered/spacebar/bar)
"aH" = (/obj/machinery/light/small,/obj/structure/table,/obj/machinery/microwave,/obj/machinery/atmospherics/pipe/simple/scrubbers/hidden,/turf/open/floor/wood,/area/ruin/powered/spacebar/bar)
"aI" = (/obj/structure/closet/secure_closet/freezer/fridge,/obj/machinery/atmospherics/pipe/simple/supply/hidden,/turf/open/floor/wood,/area/ruin/powered/spacebar/bar)
"aJ" = (/obj/structure/table,/obj/item/stack/sheet/metal{amount = 10},/turf/open/floor/wood,/area/ruin/powered/spacebar/bar)
"aK" = (/turf/closed/wall,/area/ruin/powered/spacebar)
"aL" = (/obj/machinery/atmospherics/components/unary/vent_scrubber{dir = 4; on = 1},/turf/open/floor/plating/asteroid,/area/ruin/powered/spacebar)
"aM" = (/obj/machinery/atmospherics/pipe/simple/scrubbers/hidden{dir = 4},/turf/open/floor/plating/asteroid,/area/ruin/powered/spacebar)
"aN" = (/obj/machinery/atmospherics/pipe/simple/scrubbers/hidden{dir = 4},/turf/closed/wall,/area/ruin/powered/spacebar/bar)
"aO" = (/obj/structure/table,/obj/machinery/atmospherics/pipe/simple/scrubbers/hidden{dir = 4},/turf/open/floor/wood,/area/ruin/powered/spacebar/bar)
"aP" = (/obj/structure/table,/obj/item/weapon/reagent_containers/food/drinks/beer,/obj/item/weapon/reagent_containers/glass/rag,/obj/machinery/atmospherics/pipe/simple/scrubbers/hidden{dir = 4},/turf/open/floor/wood,/area/ruin/powered/spacebar/bar)
"aQ" = (/obj/machinery/atmospherics/pipe/manifold/scrubbers/hidden{dir = 4},/turf/closed/wall,/area/ruin/powered/spacebar/bar)
"aR" = (/obj/machinery/atmospherics/pipe/simple/supply/hidden,/turf/closed/wall,/area/ruin/powered/spacebar/bar)
"aS" = (/obj/machinery/door/airlock{name = "Bar Storage"; req_access_txt = "25"},/turf/open/floor/plasteel{icon_state = "wood"},/area/ruin/powered/spacebar/bar)
"aT" = (/obj/machinery/atmospherics/components/unary/vent_pump{dir = 4; on = 1},/turf/open/floor/plating/asteroid,/area/ruin/powered/spacebar)
"aU" = (/obj/machinery/atmospherics/pipe/simple/supply/hidden{dir = 4},/turf/open/floor/plating/asteroid,/area/ruin/powered/spacebar)
"aV" = (/obj/machinery/atmospherics/pipe/simple/supply/hidden{dir = 4},/turf/closed/wall,/area/ruin/powered/spacebar/bar)
"aW" = (/obj/structure/chair/stool,/obj/machinery/atmospherics/pipe/simple/supply/hidden{dir = 4},/turf/open/floor/plasteel/bar,/area/ruin/powered/spacebar/bar)
"aX" = (/obj/structure/chair/stool,/obj/machinery/atmospherics/pipe/simple/supply/hidden{dir = 10},/turf/open/floor/plasteel/bar,/area/ruin/powered/spacebar/bar)
"aY" = (/obj/structure/chair/stool,/turf/open/floor/plasteel/bar,/area/ruin/powered/spacebar/bar)
"aZ" = (/turf/open/floor/plasteel/bar,/area/ruin/powered/spacebar/bar)
"ba" = (/obj/machinery/atmospherics/components/unary/vent_scrubber,/turf/open/floor/plasteel/bar,/area/ruin/powered/spacebar/bar)
"bb" = (/obj/machinery/light{dir = 1},/obj/machinery/atmospherics/pipe/simple/scrubbers/hidden,/turf/open/floor/plasteel/bar,/area/ruin/powered/spacebar/bar)
"bc" = (/obj/machinery/atmospherics/pipe/simple/supply/hidden,/turf/open/floor/plasteel/bar,/area/ruin/powered/spacebar/bar)
"bd" = (/obj/machinery/airalarm{frequency = 1439; locked = 0; pixel_y = 23},/turf/open/floor/plasteel/bar,/area/ruin/powered/spacebar/bar)
"be" = (/obj/structure/grille,/obj/structure/window/reinforced/fulltile,/turf/open/floor/plating,/area/ruin/powered/spacebar/bar)
"bf" = (/obj/structure/grille,/obj/structure/window/reinforced/fulltile,/turf/closed/wall,/area/ruin/powered/spacebar/bar)
"bg" = (/obj/machinery/atmospherics/pipe/simple/scrubbers/hidden{dir = 5},/turf/open/floor/plasteel/bar,/area/ruin/powered/spacebar/bar)
"bh" = (/obj/machinery/atmospherics/pipe/manifold/scrubbers/hidden{dir = 4},/turf/open/floor/plasteel/bar,/area/ruin/powered/spacebar/bar)
"bi" = (/obj/machinery/computer/teleporter,/turf/open/floor/plasteel/bar,/area/ruin/powered/spacebar/bar)
"bj" = (/obj/machinery/door/airlock/external,/turf/open/floor/plating,/area/ruin/powered/spacebar/bar)
"bk" = (/turf/open/floor/plating,/area/ruin/powered/spacebar/bar)
"bl" = (/obj/machinery/atmospherics/pipe/manifold/supply/hidden{dir = 8},/turf/open/floor/plasteel/bar,/area/ruin/powered/spacebar/bar)
"bm" = (/obj/machinery/atmospherics/pipe/simple/supply/hidden{dir = 4},/turf/open/floor/plasteel/bar,/area/ruin/powered/spacebar/bar)
"bn" = (/obj/machinery/atmospherics/pipe/simple/scrubbers/hidden,/obj/machinery/atmospherics/pipe/simple/supply/hidden{dir = 4},/turf/open/floor/plasteel/bar,/area/ruin/powered/spacebar/bar)
"bo" = (/obj/machinery/atmospherics/pipe/simple/supply/hidden{dir = 9; pixel_y = 0},/turf/open/floor/plasteel/bar,/area/ruin/powered/spacebar/bar)
"bp" = (/obj/machinery/teleport/station,/turf/open/floor/plasteel/bar,/area/ruin/powered/spacebar/bar)
"bq" = (/obj/machinery/light{icon_state = "tube1"; dir = 8},/turf/open/floor/plasteel/bar,/area/ruin/powered/spacebar/bar)
"br" = (/obj/structure/chair{tag = "icon-chair (EAST)"; icon_state = "chair"; dir = 4},/turf/open/floor/plasteel/bar,/area/ruin/powered/spacebar/bar)
"bs" = (/obj/structure/table/wood,/turf/open/floor/plasteel/bar,/area/ruin/powered/spacebar/bar)
"bt" = (/obj/structure/chair{tag = "icon-chair (WEST)"; icon_state = "chair"; dir = 8},/turf/open/floor/plasteel/bar,/area/ruin/powered/spacebar/bar)
"bu" = (/obj/machinery/atmospherics/pipe/simple/scrubbers/hidden,/turf/open/floor/plasteel/bar,/area/ruin/powered/spacebar/bar)
"bv" = (/obj/machinery/teleport/hub,/turf/open/floor/plasteel/bar,/area/ruin/powered/spacebar/bar)
"bw" = (/obj/structure/chair,/turf/open/floor/plasteel/bar,/area/ruin/powered/spacebar/bar)
"bx" = (/obj/machinery/bluespace_beacon,/turf/open/floor/plasteel/bar,/area/ruin/powered/spacebar/bar)
"by" = (/obj/machinery/atmospherics/components/unary/vent_pump{dir = 8; on = 1},/turf/open/floor/plasteel/bar,/area/ruin/powered/spacebar/bar)
"bz" = (/obj/machinery/vending/cola,/turf/open/floor/plasteel/bar,/area/ruin/powered/spacebar/bar)
"bA" = (/obj/machinery/vending/cigarette,/turf/open/floor/plasteel/bar,/area/ruin/powered/spacebar/bar)
"bB" = (/obj/machinery/vending/coffee,/obj/machinery/atmospherics/pipe/simple/scrubbers/hidden,/turf/open/floor/plasteel/bar,/area/ruin/powered/spacebar/bar)
"bC" = (/obj/machinery/vending/snack,/obj/machinery/light,/turf/open/floor/plasteel/bar,/area/ruin/powered/spacebar/bar)
"bD" = (/obj/structure/chair{dir = 1},/turf/open/floor/plasteel/bar,/area/ruin/powered/spacebar/bar)
"bE" = (/obj/machinery/atmospherics/pipe/simple/scrubbers/hidden,/turf/closed/wall,/area/ruin/powered/spacebar/bar)
"bF" = (/obj/machinery/door/airlock{name = "Unisex Bathroom"},/turf/open/floor/plasteel/freezer,/area/ruin/powered/spacebar/bar)
"bG" = (/obj/machinery/airalarm{dir = 4; icon_state = "alarm0"; pixel_x = -22},/turf/open/floor/plasteel/bar,/area/ruin/powered/spacebar/bar)
"bH" = (/obj/structure/urinal{pixel_x = -32},/obj/machinery/atmospherics/components/unary/vent_pump{dir = 8; on = 1},/turf/open/floor/plasteel/freezer,/area/ruin/powered/spacebar/bar)
"bI" = (/obj/machinery/atmospherics/pipe/simple/scrubbers/hidden,/turf/open/floor/plasteel/freezer,/area/ruin/powered/spacebar/bar)
"bJ" = (/obj/machinery/atmospherics/components/unary/vent_scrubber,/turf/open/floor/plasteel/freezer,/area/ruin/powered/spacebar/bar)
"bK" = (/turf/open/floor/plasteel/freezer,/area/ruin/powered/spacebar/bar)
"bL" = (/obj/structure/urinal{pixel_x = -32},/turf/open/floor/plasteel/freezer,/area/ruin/powered/spacebar/bar)
"bM" = (/obj/machinery/atmospherics/pipe/manifold/scrubbers/hidden{dir = 8},/turf/open/floor/plasteel/freezer,/area/ruin/powered/spacebar/bar)
"bN" = (/obj/machinery/atmospherics/pipe/simple/scrubbers/hidden{dir = 9},/turf/open/floor/plasteel/freezer,/area/ruin/powered/spacebar/bar)
"bO" = (/obj/structure/sink{dir = 4; icon_state = "sink"; pixel_x = 11; pixel_y = 0},/obj/structure/mirror{pixel_x = 28},/turf/open/floor/plasteel/freezer,/area/ruin/powered/spacebar/bar)
"bP" = (/obj/structure/table/wood,/obj/machinery/light{icon_state = "tube1"; dir = 4},/turf/open/floor/plasteel/bar,/area/ruin/powered/spacebar/bar)
"bQ" = (/obj/machinery/light/small{dir = 8},/turf/open/floor/plasteel/freezer,/area/ruin/powered/spacebar/bar)
"bR" = (/obj/structure/toilet{dir = 4},/obj/machinery/light/small{dir = 8},/turf/open/floor/plasteel/freezer,/area/ruin/powered/spacebar/bar)
"bS" = (/obj/machinery/door/airlock{name = "Toilet"},/obj/machinery/atmospherics/pipe/simple/scrubbers/hidden,/turf/open/floor/plasteel/freezer,/area/ruin/powered/spacebar/bar)
"bT" = (/obj/structure/glowshroom/single,/turf/open/floor/plasteel/freezer,/area/ruin/powered/spacebar/bar)
"bU" = (/obj/machinery/atmospherics/pipe/simple/supply/hidden,/turf/open/floor/plating/asteroid,/area/ruin/powered/spacebar)
"bV" = (/obj/machinery/door/airlock/external,/turf/open/floor/plating,/area/ruin/powered/spacebar)
"bW" = (/turf/open/floor/plating,/area/ruin/powered/spacebar)
"bX" = (/obj/machinery/atmospherics/components/unary/tank/air,/turf/open/floor/plating/asteroid,/area/ruin/powered/spacebar)
"bY" = (/obj/machinery/atmospherics/pipe/simple/scrubbers/hidden,/turf/open/floor/plating/asteroid,/area/ruin/powered/spacebar)
"bZ" = (/obj/machinery/button/door{id = "spacebardock"; name = "Podbay Airlock"; pixel_y = -24},/turf/open/floor/plating/asteroid,/area/ruin/powered/spacebar)
"ca" = (/obj/machinery/atmospherics/pipe/simple/supply/hidden{dir = 5},/turf/open/floor/plating/asteroid,/area/ruin/powered/spacebar)
"cb" = (/obj/machinery/atmospherics/pipe/manifold4w/supply/hidden,/obj/machinery/meter,/turf/open/floor/plating/asteroid,/area/ruin/powered/spacebar)
"cc" = (/obj/machinery/atmospherics/pipe/simple/supply/hidden{dir = 9; pixel_y = 0},/turf/open/floor/plating/asteroid,/area/ruin/powered/spacebar)
"cd" = (/obj/machinery/atmospherics/components/binary/valve/open,/turf/open/floor/plating/asteroid,/area/ruin/powered/spacebar)
"ce" = (/obj/machinery/atmospherics/pipe/manifold/scrubbers/hidden{dir = 4},/turf/open/floor/plating/asteroid,/area/ruin/powered/spacebar)
"cf" = (/turf/open/floor/plating/asteroid,/area/ruin/unpowered/no_grav)
"cg" = (/obj/machinery/door/poddoor/preopen{id = "spacebardock"; name = "airlock dock"},/turf/open/floor/plating,/area/ruin/powered/spacebar)
"ch" = (/obj/machinery/atmospherics/pipe/manifold/supply/hidden,/obj/machinery/meter,/turf/open/floor/plating/asteroid,/area/ruin/powered/spacebar)
"ci" = (/obj/machinery/atmospherics/components/unary/vent_pump{dir = 8; on = 1},/turf/open/floor/plating/asteroid,/area/ruin/powered/spacebar)
"cj" = (/obj/structure/grille,/obj/structure/window/reinforced/fulltile,/obj/machinery/atmospherics/pipe/simple/scrubbers/hidden,/turf/open/floor/plating,/area/ruin/powered/spacebar)
"ck" = (/obj/machinery/atmospherics/pipe/simple/scrubbers/hidden,/turf/open/floor/plating/asteroid/airless,/area/ruin/unpowered/no_grav)
"cl" = (/obj/machinery/atmospherics/pipe/simple/scrubbers/hidden,/turf/closed/mineral,/area/ruin/unpowered/no_grav)
"cm" = (/obj/machinery/atmospherics/components/unary/outlet_injector/on{dir = 1},/turf/open/floor/plating/asteroid/airless,/area/ruin/unpowered/no_grav)
"cn" = (/obj/machinery/door/poddoor{id = "spacebardock"; name = "airlock dock"},/turf/open/floor/plating,/area/ruin/powered/spacebar)

(1,1,1) = {"
aaaaaaaaaaaaaaaaaaaaaaaaaaaaaaaaaaaaaaaaaaaaaaaaaaaaaaaaaaaaaaaaaaaaaaaaaaaaaaaa
aaaaaaaaaaaaaaaaaaaaaaaaaaaaaaaaaaaaaaaaaaaaaaaaaaaaaaaaaaaaaaaaaaaaaaaaaaaaaaaa
aaaaaaaaaaaaaaaaaaaaaaaaaaaaaaaaaaaaaaaaaaaaaaaaaaaaaaaaaaaaaaaaaaaaaaaaaaaaaaaa
aaaaaaaaaaaaaaaaaaaaaaaaaaaaaaaaaaaaaaabababaaaaaaaaaaaaaaaaaaaaaaaaaaaaaaaaaaaa
aaaaaaaaaaaaaaaaaaaaaaaaaaaaaaacacacacacababababaaaaaaaaaaaaaaaaaaaaaaaaaaaaaaaa
aaaaaaaaaaaaaaaaaaaaaaaaaaacacacacacacacacacababacacacacacaaaaaaaaaaaaaaaaaaaaaa
aaaaaaaaaaaaaaaaaaaaaaacacacacacacacacacacacacacacacacacacacacaaaaaaaaaaaaaaaaaa
aaaaaaaaaaaaaaaaaaaaacacacacacadadaeadadacacacacacacacacacacacacacaaaaaaaaaaaaaa
aaaaaaaaaaaaaaaaaaacacacafafafagagagagagafafacacafafafafafafahacacacacaaaaaaaaaa
aaaaaaaaaaaaaaaaacacacafagagagagagagaiagagagafafagagagagagagagafafacacacaaaaaaaa
aaaaaaaaaaaaaaacacacafagagagagagagaiaiaiaiagagagagagagagagagagagagafacacaaaaaaaa
aaaaaaaaaaacacacacafagajakajagagaiaiaialalalalalalalalalalalalagagafacacaaaaaaaa
aaaaaaaaaaacacacafagagamanamagagaiaiaialaoapaqaralasatauaravalagagafacacacaaaaaa
aaaaaaaaacacafafagagagamawamagagaiaiaialaxarararayarazaAaraBalagagagafacacaaaaaa
aaaaaaababacafagagagagaCaDaCagagagaiaialaEarararaFaGaHaIaraJalagagagafacacaaaaaa
aaaaaaaaabacaKagagagagagagagagaLaMaMaMaNaOaOaPaOaNaNaQaRaSalalagagagaKacaaaaaaaa
aaaaaaaaabacafafagagagagagagagaTaUaUaUaVaWaXaYaYaZbabbbcaZbdalagagagafacabaaaaaa
aaaaaaaaacacacacafagagagagagagagalbebfalaZbcaZaZaZbgbhbcaZbibeagagafacacababaaaa
aaaaaaaaaaacacafagagagagagagagagbjbkbkbjaZblbmbmbmbmbnboaZbpbeagagafacabababaaaa
aaaaaaaaaaacacafagagagagagagagagalbebealbqbcbrbsbtaZbuaZaZbvbeagagafacacaaaaaaaa
aaaaaaaaacacafagagagagagagagagagagagagalbwbcaZaZaZbxbuaZaZaZbeagagafacacaaaaaaaa
aaaaaaaaabacafagagagagagagagagagagagagalbsblbyaZbzbAbBbCaZaZalagagafacacacaaaaaa
aaaaaaababacafagagagagagagagagagagagagalbDbcaZaZalalbEalalbFalaiagagafacacacaaaa
aaaaaaaaabacafagagagagagagagagajakajagalbGblbmbmaVbHbIbJbKbKalaiagagagafacabaaaa
aaaaaaaaacacafagagagagagagagagamanamagbeaZbcaZbwalbLbMbNbKbOalaiaiagagafacabaaaa
aaaaaaaaacacacafagagagagagagagamawamagagbebcaZbPalalbEbQbKbOalaiaiagagafacabaaaa
aaaaaaaaaaacacafagagagagagagagaCaDaCagagagbeaZbDalbRbSbKbTbKalaiaiagagafacacaaaa
aaaaaaaaaaacaKaKaKaKagagagagagagagagagagagbUbealalalbEalalalalaiaiagafacacacaaaa
aaaaaaaaaaaabVbWbWbVagagagagagagagagagagaibUbXbXbXaibYaiaiaiaiaiagagafacacacaaaa
aaaaaaaaaaaaaKaKaKaKagagagagagagagbZagaiaibUcacbccagbYaiaiaiaiaiagafacacacaaaaaa
aaaaaaaaaaaaacacaKagaKbWbWbWbWbWbWaKagagaibUagcdagaLceagagaiaiagagafaccfaaaaaaaa
aaaaaaaaaaaaacabaKagaKcgcgcgcgcgcgaKagagagcaaUchciagbYagagagagagafaKacabaaaaaaaa
aaaaaaaaaaaaababaKaKaKbWbWbWbWbWbWaKaKaKaKafafafafafcjafafafafaKacacacacaaaaaaaa
aaaaaaaaaaaaababababaKbWbWbWbWbWbWaKacacacacacacacacckacacacacacacacacaaaaaaaaaa
aaaaaaaaaaaaaaaaababaKbWbWbWbWbWbWaKacacacacacacacacclacacacacacacaaaaaaaaaaaaaa
aaaaaaaaaaaaaaaaaaaaaKbWbWbWbWbWbWaKacacacacaaaaaaaccmacababaaaaaaaaaaaaaaaaaaaa
aaaaaaaaaaaaaaaaaaaaaKcncncncncncnaKacacaaaaaaaaaaaaaaaaaaaaaaaaaaaaaaaaaaaaaaaa
aaaaaaaaaaaaaaaaaaaaaKaaaaaaaaaaaaaKaaaaaaaaaaaaaaaaaaaaaaaaaaaaaaaaaaaaaaaaaaaa
aaaaaaaaaaaaaaaaaaaaaaaaaaaaaaaaaaaaaaaaaaaaaaaaaaaaaaaaaaaaaaaaaaaaaaaaaaaaaaaa
aaaaaaaaaaaaaaaaaaaaaaaaaaaaaaaaaaaaaaaaaaaaaaaaaaaaaaaaaaaaaaaaaaaaaaaaaaaaaaaa
"}
