//MAP CONVERTED BY dmm2tgm.py THIS HEADER COMMENT PREVENTS RECONVERSION, DO NOT REMOVE
"aK" = (
/turf/open/floor/iron/dark,
/area/ruin/space/has_grav/thelizardsgas)
"bp" = (
/obj/structure/cable,
/obj/machinery/atmospherics/components/unary/vent_pump/on/layer4{
	dir = 4
	},
/turf/open/floor/plating,
/area/ruin/space/has_grav/thelizardsgas)
"bt" = (
/obj/machinery/computer/atmos_control/tank/plasma_tank{
	dir = 8
	},
/turf/open/floor/iron/dark/smooth_corner{
	dir = 8
	},
/area/ruin/space/has_grav/thelizardsgas)
"bW" = (
/obj/effect/spawner/random/structure/billboard/lizardsgas,
/turf/open/floor/plating/asteroid/airless,
/area/ruin/space/has_grav/thelizardsgas)
"cm" = (
/obj/machinery/power/terminal{
	dir = 1
	},
/obj/structure/cable,
/obj/machinery/atmospherics/pipe/smart/manifold4w/supply/hidden/layer4,
/obj/machinery/atmospherics/pipe/smart/manifold4w/scrubbers/hidden/layer2,
/turf/open/floor/plating,
/area/ruin/space/has_grav/thelizardsgas)
"cF" = (
/obj/machinery/atmospherics/components/unary/vent_scrubber/on/layer2{
	dir = 1
	},
/turf/open/floor/plating,
/area/ruin/space/has_grav/thelizardsgas)
"iA" = (
/obj/machinery/atmospherics/components/unary/portables_connector/visible{
	dir = 8
	},
/turf/open/floor/plating,
/area/ruin/space/has_grav/thelizardsgas)
"jv" = (
/obj/machinery/airalarm/directional/north,
/turf/open/floor/iron/dark/smooth_edge{
	dir = 1
	},
/area/ruin/space/has_grav/thelizardsgas)
"kS" = (
/obj/machinery/atmospherics/components/unary/vent_pump/siphon/atmos/plasma_output,
/turf/open/floor/engine/plasma,
/area/ruin/space/has_grav/thelizardsgas)
"mR" = (
/turf/closed/wall,
/area/ruin/space/has_grav/thelizardsgas)
"rs" = (
/obj/structure/cable,
/obj/machinery/button/door/directional/west{
	id = gasstation;
	name = "Shutters"
	},
/turf/open/floor/iron/dark/smooth_edge{
	dir = 8
	},
/area/ruin/space/has_grav/thelizardsgas)
"ss" = (
/obj/machinery/atmospherics/pipe/smart/simple/yellow/hidden,
/obj/machinery/door/airlock/external/glass,
/obj/effect/mapping_helpers/airlock/cyclelink_helper{
	dir = 1
	},
/turf/open/floor/plating,
/area/ruin/space/has_grav/thelizardsgas)
"sN" = (
/obj/machinery/atmospherics/pipe/smart/simple/yellow/hidden,
/obj/structure/cable,
/turf/open/floor/plating,
/area/ruin/space/has_grav/thelizardsgas)
"uh" = (
/obj/effect/spawner/structure/window/reinforced,
/turf/open/floor/plating,
/area/ruin/space/has_grav/thelizardsgas)
"wb" = (
/turf/open/floor/plating/asteroid/airless,
/area/ruin/space/has_grav/thelizardsgas)
"xy" = (
/obj/machinery/atmospherics/pipe/smart/manifold4w/supply/hidden/layer4,
/obj/machinery/atmospherics/pipe/smart/manifold4w/scrubbers/hidden/layer2,
/turf/open/floor/plating,
/area/ruin/space/has_grav/thelizardsgas)
"zz" = (
/obj/machinery/door/window,
/obj/structure/cable,
/turf/open/floor/iron/dark/smooth_corner{
	dir = 4
	},
/area/ruin/space/has_grav/thelizardsgas)
"AZ" = (
/obj/structure/cable,
/obj/machinery/power/apc/auto_name/directional/north,
/turf/open/floor/iron/dark/smooth_corner,
/area/ruin/space/has_grav/thelizardsgas)
"Bu" = (
/obj/machinery/atmospherics/pipe/smart/simple/yellow/visible,
/obj/structure/lattice/catwalk,
/turf/template_noop,
/area/ruin/space/has_grav/thelizardsgas)
"Cv" = (
/obj/machinery/door/airlock/hatch,
/obj/structure/cable,
/obj/machinery/atmospherics/pipe/smart/manifold4w/supply/hidden/layer4,
/obj/machinery/atmospherics/pipe/smart/manifold4w/scrubbers/hidden/layer2,
/turf/open/floor/plating,
/area/ruin/space/has_grav/thelizardsgas)
"CA" = (
/turf/template_noop,
/area/template_noop)
"CV" = (
/obj/effect/spawner/structure/window/reinforced,
/turf/open/space/basic,
/area/ruin/space/has_grav/thelizardsgas)
"DG" = (
/turf/open/floor/engine/plasma,
/area/ruin/space/has_grav/thelizardsgas)
"Es" = (
/obj/machinery/portable_atmospherics/scrubber,
/turf/open/floor/plating,
/area/ruin/space/has_grav/thelizardsgas)
"FJ" = (
/turf/open/floor/iron/dark/smooth_edge{
	dir = 4
	},
/area/ruin/space/has_grav/thelizardsgas)
"GM" = (
/obj/machinery/atmospherics/pipe/smart/simple/yellow/hidden,
/obj/machinery/door/airlock/external/glass,
/obj/effect/mapping_helpers/airlock/cyclelink_helper,
/obj/machinery/door/poddoor/shutters/preopen{
	id = gasstation;
	name = "Gas Station Shutters"
	},
/turf/open/floor/plating,
/area/ruin/space/has_grav/thelizardsgas)
"Hc" = (
/obj/structure/flora/rock/pile{
	icon_state = "basalt"
	},
/turf/open/floor/plating/asteroid/airless,
/area/ruin/space/has_grav/thelizardsgas)
"Io" = (
/obj/machinery/power/smes,
/turf/open/floor/plating,
/area/ruin/space/has_grav/thelizardsgas)
"Jg" = (
/obj/structure/lattice/catwalk,
/obj/machinery/atmospherics/components/unary/portables_connector{
	dir = 4
	},
/turf/template_noop,
/area/ruin/space/has_grav/thelizardsgas)
"JP" = (
/obj/machinery/atmospherics/pipe/smart/manifold4w/supply/hidden/layer4,
/turf/open/floor/plating,
/area/ruin/space/has_grav/thelizardsgas)
"Kw" = (
/obj/machinery/atmospherics/components/unary/portables_connector/visible/layer2{
	dir = 1
	},
/obj/machinery/portable_atmospherics/scrubber,
/turf/open/floor/plating,
/area/ruin/space/has_grav/thelizardsgas)
"LA" = (
/turf/closed/wall/r_wall,
/area/ruin/space/has_grav/thelizardsgas)
"LT" = (
/obj/machinery/portable_atmospherics/pump,
/turf/open/floor/plating,
/area/ruin/space/has_grav/thelizardsgas)
"Mw" = (
/obj/structure/cable,
/obj/machinery/atmospherics/pipe/smart/manifold4w/supply/hidden/layer4,
/obj/machinery/atmospherics/pipe/smart/manifold4w/scrubbers/hidden/layer2,
/turf/open/floor/plating,
/area/ruin/space/has_grav/thelizardsgas)
"MB" = (
/obj/structure/lattice/catwalk,
/obj/machinery/atmospherics/pipe/smart/simple/yellow/hidden{
	dir = 8
	},
/turf/template_noop,
/area/ruin/space/has_grav/thelizardsgas)
"Ow" = (
/obj/structure/table/reinforced,
/turf/open/floor/iron/dark/smooth_edge,
/area/ruin/space/has_grav/thelizardsgas)
"Pb" = (
/obj/machinery/atmospherics/pipe/smart/simple/yellow/hidden,
/turf/open/floor/plating{
	icon_state = "platingdmg1"
	},
/area/ruin/space/has_grav/thelizardsgas)
"Qg" = (
/turf/closed/mineral,
/area/ruin/space/has_grav/thelizardsgas)
"Qi" = (
/obj/structure/lattice/catwalk,
/obj/machinery/atmospherics/components/unary/portables_connector{
	dir = 8
	},
/turf/template_noop,
/area/ruin/space/has_grav/thelizardsgas)
"Ss" = (
/obj/machinery/atmospherics/pipe/smart/simple/yellow/hidden,
/turf/open/floor/plating,
/area/ruin/space/has_grav/thelizardsgas)
"Tj" = (
/obj/effect/spawner/structure/window/reinforced,
/obj/machinery/atmospherics/pipe/smart/simple/yellow/visible,
/turf/open/floor/plating,
/area/ruin/space/has_grav/thelizardsgas)
"Ud" = (
/obj/effect/spawner/structure/window/reinforced,
/obj/machinery/atmospherics/pipe/smart/simple/green/visible{
	dir = 4
	},
/turf/open/floor/plating,
/area/ruin/space/has_grav/thelizardsgas)
"Uh" = (
/obj/machinery/atmospherics/components/unary/outlet_injector/atmos/plasma_input{
	dir = 4
	},
/turf/open/floor/engine/plasma,
/area/ruin/space/has_grav/thelizardsgas)
"Um" = (
/obj/structure/flora/rock/pile,
/turf/open/floor/plating/asteroid/airless,
/area/ruin/space/has_grav/thelizardsgas)
"Uz" = (
/obj/structure/cable,
/turf/open/floor/plating,
/area/ruin/space/has_grav/thelizardsgas)
"VP" = (
/obj/structure/table/reinforced,
/turf/open/floor/iron/dark/smooth_corner{
	dir = 1
	},
/area/ruin/space/has_grav/thelizardsgas)
"Wh" = (
/turf/open/floor/plating,
/area/ruin/space/has_grav/thelizardsgas)
"WP" = (
/obj/structure/lattice/catwalk,
/obj/machinery/atmospherics/pipe/smart/manifold4w/yellow/hidden,
/turf/template_noop,
/area/ruin/space/has_grav/thelizardsgas)
"Ys" = (
/obj/machinery/portable_atmospherics/canister/air,
/obj/machinery/atmospherics/components/unary/portables_connector/visible/layer4{
	dir = 1
	},
/turf/open/floor/plating,
/area/ruin/space/has_grav/thelizardsgas)
"Zs" = (
/obj/structure/cable,
/obj/machinery/atmospherics/pipe/smart/manifold4w/supply/hidden/layer4,
/turf/open/floor/plating,
/area/ruin/space/has_grav/thelizardsgas)

(1,1,1) = {"
CA
CA
CA
CA
CA
CA
CA
CA
CA
CA
CA
CA
CA
CA
CA
CA
CA
CA
CA
CA
CA
CA
CA
CA
CA
"}
(2,1,1) = {"
CA
CA
CA
CA
CA
CA
CA
CA
CA
CA
CA
CA
CA
CA
CA
CA
CA
CA
CA
CA
CA
CA
CA
CA
CA
"}
(3,1,1) = {"
CA
CA
CA
CA
Qg
Qg
Qg
Qg
Qg
Qg
Qg
Qg
CA
CA
CA
CA
CA
CA
CA
CA
CA
CA
CA
CA
CA
"}
(4,1,1) = {"
CA
CA
CA
Qg
Qg
mR
mR
mR
mR
mR
mR
Qg
Qg
CA
CA
CA
CA
CA
CA
CA
CA
CA
CA
CA
CA
"}
(5,1,1) = {"
CA
CA
CA
Qg
Qg
mR
AZ
rs
zz
Uz
Uz
mR
Qg
Qg
CA
CA
CA
CA
CA
CA
CA
CA
CA
CA
CA
"}
(6,1,1) = {"
CA
CA
CA
Qg
Qg
mR
jv
aK
Ow
Wh
Uz
Wh
mR
Qg
CA
CA
CA
CA
Jg
CA
CA
Jg
CA
CA
CA
"}
(7,1,1) = {"
CA
CA
Qg
Qg
Qg
mR
bt
FJ
VP
Wh
Uz
Wh
mR
Qg
CA
CA
CA
CA
MB
CA
CA
MB
CA
CA
CA
"}
(8,1,1) = {"
CA
CA
Qg
Qg
LA
LA
uh
uh
uh
Wh
Uz
Wh
mR
mR
mR
mR
CA
CA
MB
CA
CA
MB
CA
CA
CA
"}
(9,1,1) = {"
CA
CA
Qg
Qg
LA
DG
DG
kS
Tj
Ss
sN
Ss
Ss
GM
Pb
ss
Bu
Bu
WP
Bu
Bu
WP
CA
CA
CA
"}
(10,1,1) = {"
CA
CA
Qg
Qg
LA
DG
DG
DG
uh
Wh
bp
Wh
Wh
mR
mR
mR
CA
CA
MB
CA
CA
MB
CA
CA
CA
"}
(11,1,1) = {"
CA
CA
CA
Qg
LA
Uh
DG
DG
uh
Wh
Zs
Wh
Wh
CV
CA
CA
CA
CA
MB
CA
CA
MB
CA
CA
CA
"}
(12,1,1) = {"
CA
CA
CA
Qg
LA
Ud
uh
uh
uh
Wh
Zs
Wh
Wh
CV
CA
CA
CA
CA
Qi
CA
CA
Qi
CA
CA
CA
"}
(13,1,1) = {"
CA
CA
CA
Qg
mR
iA
JP
Ys
mR
Wh
Zs
Wh
Wh
CV
CA
CA
CA
CA
CA
CA
CA
CA
CA
CA
CA
"}
(14,1,1) = {"
CA
CA
CA
Qg
mR
Es
JP
Wh
mR
Wh
Zs
Wh
Wh
CV
CA
CA
CA
CA
CA
CA
CA
CA
CA
CA
CA
"}
(15,1,1) = {"
CA
CA
CA
Qg
mR
LT
xy
Kw
mR
Wh
Zs
Wh
Wh
CV
CA
CA
CA
CA
CA
CA
CA
CA
CA
CA
CA
"}
(16,1,1) = {"
CA
CA
CA
Qg
mR
Io
cm
Mw
Cv
Mw
Mw
cF
Wh
CV
CA
CA
CA
CA
CA
CA
CA
CA
CA
CA
CA
"}
(17,1,1) = {"
CA
CA
CA
Qg
mR
mR
mR
mR
mR
Wh
Wh
Wh
Wh
mR
Qg
Um
wb
CA
CA
CA
CA
CA
CA
CA
CA
"}
(18,1,1) = {"
CA
CA
CA
Qg
Qg
wb
wb
mR
Wh
Wh
Wh
Wh
Wh
mR
Qg
wb
wb
wb
CA
CA
CA
CA
CA
CA
CA
"}
(19,1,1) = {"
CA
CA
CA
Qg
wb
wb
Um
mR
Wh
Wh
Wh
Wh
Wh
mR
Qg
Qg
wb
wb
bW
CA
CA
CA
CA
CA
CA
"}
(20,1,1) = {"
CA
CA
CA
CA
wb
wb
Qg
mR
Wh
Wh
Wh
Wh
Wh
mR
Qg
Hc
wb
wb
wb
CA
CA
CA
CA
CA
CA
"}
(21,1,1) = {"
CA
CA
CA
CA
wb
Qg
Qg
mR
mR
mR
mR
mR
mR
mR
wb
wb
wb
wb
wb
CA
CA
CA
CA
CA
CA
"}
(22,1,1) = {"
CA
CA
CA
CA
CA
wb
Qg
Qg
Qg
Qg
Qg
Qg
Qg
Qg
wb
Qg
wb
wb
wb
CA
CA
CA
CA
CA
CA
"}
(23,1,1) = {"
CA
CA
CA
CA
CA
CA
CA
CA
CA
CA
CA
CA
CA
CA
CA
CA
CA
CA
CA
CA
CA
CA
CA
CA
CA
"}
(24,1,1) = {"
CA
CA
CA
CA
CA
CA
CA
CA
CA
CA
CA
CA
CA
CA
CA
CA
CA
CA
CA
CA
CA
CA
CA
CA
CA
"}
(25,1,1) = {"
CA
CA
CA
CA
CA
CA
CA
CA
CA
CA
CA
CA
CA
CA
CA
CA
CA
CA
CA
CA
CA
CA
CA
CA
CA
"}
