//MAP CONVERTED BY dmm2tgm.py THIS HEADER COMMENT PREVENTS RECONVERSION, DO NOT REMOVE
"a" = (
/turf/template_noop,
/area/template_noop)
"c" = (
/obj/machinery/door/airlock,
/turf/open/floor/mineral/plastitanium,
/area/ruin/space/has_grav/powered{
	name = "Unexplored Location"
	})
"d" = (
/obj/machinery/computer/arcade/orion_trail{
	dir = 4
	},
/turf/open/floor/mineral/plastitanium,
/area/ruin/space/has_grav/powered{
	name = "Unexplored Location"
	})
"f" = (
/obj/machinery/computer{
	desc = "A communications console utilizing a language completely alien to you. The images on the screen suggest it sends messages to a far-off asteroid. Either way, you have no idea how to use it.";
	dir = 4;
	name = "Communications Console"
	},
/turf/open/floor/mineral/plastitanium,
/area/ruin/space/has_grav/powered{
	name = "Unexplored Location"
	})
"g" = (
/obj/machinery/computer{
	desc = "Obviously, by the images, this console controls the outside solar panels, but the language it uses is unknown to you.";
	name = "Solar Panel Control"
	},
/turf/open/floor/mineral/plastitanium,
/area/ruin/space/has_grav/powered{
	name = "Unexplored Location"
	})
"i" = (
/obj/structure/rack,
/obj/item/poster/random_contraband{
	pixel_x = 4;
	pixel_y = 13
	},
/obj/item/poster/random_contraband{
	pixel_x = 3;
	pixel_y = 12
	},
/obj/item/poster/random_contraband{
	pixel_x = 2;
	pixel_y = 11
	},
/obj/item/poster/random_contraband{
	pixel_x = 1;
	pixel_y = 10
	},
/obj/item/poster/random_contraband{
	pixel_y = 9
	},
/obj/item/poster/random_contraband{
	pixel_x = -1;
	pixel_y = 8
	},
/obj/item/poster/random_contraband{
	pixel_x = -2;
	pixel_y = 7
	},
/obj/item/poster/random_contraband{
	pixel_x = -3;
	pixel_y = 6
	},
/obj/item/poster/random_contraband{
	pixel_x = -4;
	pixel_y = 5
	},
/obj/item/poster/random_contraband{
	pixel_x = -5;
	pixel_y = 4
	},
/turf/open/floor/mineral/plastitanium,
/area/ruin/space/has_grav/powered{
	name = "Unexplored Location"
	})
"m" = (
/obj/effect/spawner/structure/window/reinforced/plasma/plastitanium,
/turf/open/floor/plating,
/area/ruin/space/has_grav/powered{
	name = "Unexplored Location"
	})
"o" = (
/obj/machinery/light,
/turf/open/floor/mineral/plastitanium,
/area/ruin/space/has_grav/powered{
	name = "Unexplored Location"
	})
"p" = (
/obj/item/gps/spaceruin,
/obj/structure/rack,
/turf/open/floor/mineral/plastitanium,
/area/ruin/space/has_grav/powered{
	name = "Unexplored Location"
	})
"r" = (
/turf/open/floor/mineral/plastitanium,
/area/ruin/space/has_grav/powered{
	name = "Unexplored Location"
	})
"t" = (
/obj/structure/table,
/obj/machinery/light{
	dir = 1
	},
/turf/open/floor/mineral/plastitanium,
/area/ruin/space/has_grav/powered{
	name = "Unexplored Location"
	})
"u" = (
/obj/structure/table,
/turf/open/floor/mineral/plastitanium,
/area/ruin/space/has_grav/powered{
	name = "Unexplored Location"
	})
"x" = (
/obj/machinery/light/small,
/turf/open/floor/mineral/plastitanium,
/area/ruin/space/has_grav/powered{
	name = "Unexplored Location"
	})
"y" = (
/obj/structure/fans/tiny,
/obj/machinery/door/airlock/external/glass,
/turf/open/floor/plating,
/area/ruin/space/has_grav/powered{
	name = "Unexplored Location"
	})
"B" = (
/obj/machinery/suit_storage_unit/open,
/turf/open/floor/mineral/plastitanium,
/area/ruin/space/has_grav/powered{
	name = "Unexplored Location"
	})
"J" = (
/turf/open/floor/iron/solarpanel/airless,
/area/ruin/space/has_grav/powered{
	name = "Unexplored Location"
	})
"N" = (
/obj/structure/table,
/obj/item/tank/jetpack/oxygen{
	pixel_y = 4
	},
/turf/open/floor/mineral/plastitanium,
/area/ruin/space/has_grav/powered{
	name = "Unexplored Location"
	})
"O" = (
/obj/structure/lattice/catwalk,
/turf/template_noop,
/area/template_noop)
"Q" = (
/obj/structure/table,
/obj/machinery/light{
	dir = 1
	},
/obj/item/clothing/shoes/magboots/syndie,
/turf/open/floor/mineral/plastitanium,
/area/ruin/space/has_grav/powered{
	name = "Unexplored Location"
	})
"R" = (
/obj/structure/bed,
/obj/item/bedsheet/syndie,
/turf/open/floor/mineral/plastitanium,
/area/ruin/space/has_grav/powered{
	name = "Unexplored Location"
	})
"T" = (
/turf/open/floor/mineral/plastitanium/red,
/area/ruin/space/has_grav/powered{
	name = "Unexplored Location"
	})
"V" = (
/turf/closed/wall/mineral/plastitanium,
/area/ruin/space/has_grav/powered{
	name = "Unexplored Location"
	})
"W" = (
/obj/structure/closet,
/obj/item/paper/pamphlet/violent_video_games,
/turf/open/floor/mineral/plastitanium,
/area/ruin/space/has_grav/powered{
	name = "Unexplored Location"
	})
"Z" = (
/obj/structure/lattice,
/turf/template_noop,
/area/template_noop)

(1,1,1) = {"
a
a
a
a
a
a
a
Z
O
O
O
O
O
Z
a
"}
(2,1,1) = {"
a
a
J
J
J
a
Z
Z
V
m
y
m
V
Z
Z
"}
(3,1,1) = {"
a
a
Z
Z
Z
a
a
V
V
r
T
r
V
V
a
"}
(4,1,1) = {"
a
a
a
a
Z
a
a
V
Q
r
T
r
i
V
a
"}
(5,1,1) = {"
V
V
V
V
Z
Z
Z
V
u
r
T
r
i
V
a
"}
(6,1,1) = {"
m
d
f
V
O
O
V
V
B
r
T
r
i
V
a
"}
(7,1,1) = {"
m
r
x
V
m
m
V
g
r
r
T
r
i
V
a
"}
(8,1,1) = {"
m
r
r
c
r
r
c
r
r
r
T
r
o
V
a
"}
(9,1,1) = {"
m
r
x
V
m
m
V
p
r
r
T
r
i
V
a
"}
(10,1,1) = {"
m
W
R
V
O
O
V
V
B
r
T
r
i
V
a
"}
(11,1,1) = {"
V
V
V
V
Z
Z
Z
V
N
r
T
r
i
V
a
"}
(12,1,1) = {"
a
a
a
a
Z
a
a
V
t
r
T
r
i
V
a
"}
(13,1,1) = {"
a
a
Z
Z
Z
a
a
V
V
r
T
r
V
V
a
"}
(14,1,1) = {"
a
a
J
J
J
a
Z
Z
V
m
y
m
V
Z
Z
"}
(15,1,1) = {"
a
a
a
a
a
a
a
Z
O
O
O
O
O
Z
a
"}
