//MAP CONVERTED BY dmm2tgm.py THIS HEADER COMMENT PREVENTS RECONVERSION, DO NOT REMOVE
"a" = (
/turf/template_noop,
/area/template_noop)
"b" = (
/obj/effect/spawner/random/engineering/material_cheap,
/turf/open/floor/iron/dark/airless,
/area/ruin/unpowered/no_grav)
"c" = (
/obj/effect/spawner/random/medical/patient_stretcher,
/turf/open/floor/iron/dark/airless,
/area/ruin/unpowered/no_grav)
"e" = (
/obj/machinery/power/smes,
/turf/open/floor/plating,
/area/ruin/unpowered/no_grav)
"g" = (
/obj/effect/spawner/random/structure/crate_loot,
/turf/open/floor/iron/dark/airless,
/area/ruin/unpowered/no_grav)
"i" = (
/turf/closed/wall/mineral/plastitanium,
/area/ruin/unpowered/no_grav)
"j" = (
/turf/open/floor/plating,
/area/ruin/unpowered/no_grav)
"k" = (
/turf/closed/wall/mineral/plastitanium,
/area/ruin/space/has_grav/skyrat)
"r" = (
/obj/machinery/door/airlock/hatch,
/turf/open/floor/iron/dark/airless,
/area/ruin/unpowered/no_grav)
"t" = (
/obj/structure/closet/crate/radiation,
/obj/effect/spawner/random/exotic/syndie,
/turf/open/floor/iron/dark/airless,
/area/ruin/unpowered/no_grav)
"u" = (
/obj/structure/closet/crate/secure/engineering,
/obj/item/pickaxe/drill/jackhammer,
/obj/item/gun/energy/plasmacutter/adv,
/obj/effect/spawner/random/medical/firstaid,
/turf/open/floor/plating,
/area/ruin/unpowered/no_grav)
"v" = (
/obj/machinery/door/airlock/external/glass,
/turf/open/floor/plating,
/area/ruin/unpowered/no_grav)
"w" = (
/mob/living/simple_animal/hostile/vox/ranged/space/laser,
/turf/open/floor/iron/dark/airless,
/area/ruin/unpowered/no_grav)
"y" = (
/obj/machinery/door/airlock/maintenance{
	req_access_txt = "12"
	},
/turf/open/floor/plating,
/area/ruin/unpowered/no_grav)
"H" = (
/obj/effect/spawner/random/structure/crate_abandoned,
/turf/open/floor/iron/dark/airless,
/area/ruin/unpowered/no_grav)
"K" = (
/mob/living/simple_animal/hostile/vox/melee,
/turf/open/floor/plating,
/area/ruin/unpowered/no_grav)
"L" = (
/obj/structure/closet/crate/radiation,
/obj/effect/spawner/random/engineering/material_rare,
/obj/effect/spawner/random/engineering/material_rare,
/obj/effect/spawner/random/engineering/material_cheap,
/obj/effect/spawner/random/engineering/material_cheap,
/obj/effect/spawner/random/engineering/material_cheap,
/obj/effect/spawner/random/engineering/material,
/obj/effect/spawner/random/engineering/material,
/obj/effect/spawner/random/engineering/material,
/obj/effect/spawner/random/engineering/material,
/turf/open/floor/iron/dark/airless,
/area/ruin/unpowered/no_grav)
"M" = (
/obj/structure/lattice,
/turf/template_noop,
/area/ruin/unpowered/no_grav)
"N" = (
/turf/open/floor/iron/dark/airless,
/area/ruin/unpowered/no_grav)
"O" = (
/obj/structure/shuttle/engine/propulsion{
	dir = 8
	},
/turf/template_noop,
/area/ruin/unpowered/no_grav)
"P" = (
/obj/effect/mob_spawn/human/corpse/syndicatecommando,
/turf/open/floor/iron/dark/airless,
/area/ruin/unpowered/no_grav)
"Q" = (
/obj/structure/closet/crate/radiation,
/obj/effect/spawner/random/engineering/material,
/obj/effect/spawner/random/engineering/material,
/obj/effect/spawner/random/engineering/material,
/obj/effect/spawner/random/engineering/material,
/obj/effect/spawner/random/engineering/material_rare,
/obj/effect/spawner/random/engineering/material_rare,
/turf/open/floor/iron/dark/airless,
/area/ruin/unpowered/no_grav)
"Z" = (
/obj/structure/closet/crate/radiation,
/obj/effect/spawner/random/contraband/narcotics,
/obj/effect/spawner/random/contraband/narcotics,
/obj/effect/spawner/random/contraband/narcotics,
/turf/open/floor/iron/dark/airless,
/area/ruin/unpowered/no_grav)

(1,1,1) = {"
a
a
a
a
O
O
a
a
a
a
"}
(2,1,1) = {"
a
O
O
i
i
i
i
O
O
a
"}
(3,1,1) = {"
a
i
i
i
e
K
i
i
i
a
"}
(4,1,1) = {"
a
i
L
i
u
j
i
Z
i
a
"}
(5,1,1) = {"
a
i
t
i
i
y
i
Q
i
a
"}
(6,1,1) = {"
a
i
N
N
w
N
N
b
i
a
"}
(7,1,1) = {"
a
v
N
N
c
N
g
N
v
a
"}
(8,1,1) = {"
a
i
w
N
N
N
N
N
i
a
"}
(9,1,1) = {"
a
i
N
N
N
b
N
N
i
a
"}
(10,1,1) = {"
a
M
N
i
i
r
i
H
i
a
"}
(11,1,1) = {"
a
a
M
i
N
N
i
P
i
a
"}
(12,1,1) = {"
a
a
a
a
M
N
i
i
i
a
"}
(13,1,1) = {"
a
a
a
a
a
M
k
a
a
a
"}
