//MAP CONVERTED BY dmm2tgm.py THIS HEADER COMMENT PREVENTS RECONVERSION, DO NOT REMOVE
"bj" = (
/obj/machinery/door/airlock/titanium,
/obj/effect/mapping_helpers/airlock/cyclelink_helper{
	dir = 4
	},
/turf/open/floor/plating,
/area/ruin/powered/golem_ship)
"cQ" = (
/obj/structure/reagent_dispensers/fueltank,
/turf/open/floor/plating,
/area/ruin/powered/golem_ship)
"eK" = (
/obj/effect/spawner/structure/window/shuttle,
/turf/open/floor/plating,
/area/ruin/powered/golem_ship)
"gP" = (
/obj/item/book/manual/wiki/research_and_development{
	name = "Sacred Text of the Liberator";
	pixel_x = -4;
	pixel_y = 3
	},
/obj/structure/table/wood,
/turf/open/floor/mineral/titanium/white,
/area/ruin/powered/golem_ship)
"hb" = (
/obj/structure/table/wood,
/obj/item/areaeditor/blueprints{
	desc = "Use to build new structures in the wastes.";
	name = "land claim"
	},
/turf/open/floor/wood,
/area/ruin/powered/golem_ship)
"hd" = (
/obj/machinery/door/window{
	dir = 4
	},
/turf/open/floor/mineral/titanium/white,
/area/ruin/powered/golem_ship)
"hQ" = (
/turf/open/floor/mineral/titanium/white,
/area/ruin/powered/golem_ship)
"is" = (
/obj/machinery/door/airlock/titanium,
/turf/open/floor/mineral/titanium/white,
/area/ruin/powered/golem_ship)
"lI" = (
/obj/structure/bed,
/obj/item/bedsheet/rd/royal_cape,
/obj/structure/window/reinforced{
	dir = 4
	},
/turf/open/floor/mineral/titanium/white,
/area/ruin/powered/golem_ship)
"mU" = (
/obj/machinery/mineral/equipment_vendor/golem,
/turf/open/floor/mineral/titanium,
/area/ruin/powered/golem_ship)
"ph" = (
/obj/structure/table/wood,
/turf/open/floor/wood,
/area/ruin/powered/golem_ship)
"pD" = (
/obj/structure/table/wood,
/obj/item/storage/firstaid/fire{
	pixel_x = 6;
	pixel_y = 6
	},
/obj/item/storage/firstaid/fire{
	pixel_x = 3;
	pixel_y = 3
	},
/turf/open/floor/wood,
/area/ruin/powered/golem_ship)
"sV" = (
/obj/machinery/light/small,
/turf/open/floor/plating,
/area/ruin/powered/golem_ship)
"tU" = (
/obj/structure/table/wood,
/obj/item/storage/toolbox/mechanical{
	pixel_x = 2;
	pixel_y = 4
	},
/obj/item/storage/toolbox/mechanical,
/turf/open/floor/mineral/titanium,
/area/ruin/powered/golem_ship)
"vg" = (
/turf/open/floor/plating,
/area/ruin/powered/golem_ship)
"wI" = (
/turf/template_noop,
/area/template_noop)
"xR" = (
/obj/machinery/door/airlock/titanium,
/obj/effect/mapping_helpers/airlock/cyclelink_helper{
	dir = 1
	},
/turf/open/floor/plating,
/area/ruin/powered/golem_ship)
"xW" = (
/turf/closed/wall/mineral/titanium,
/area/ruin/powered/golem_ship)
"yC" = (
/obj/structure/fans/tiny,
/obj/machinery/door/airlock/titanium,
/turf/open/floor/mineral/titanium,
/area/ruin/powered/golem_ship)
"yW" = (
/obj/machinery/door/airlock/titanium,
/obj/structure/fans/tiny,
/obj/effect/mapping_helpers/airlock/cyclelink_helper{
	dir = 8
	},
/turf/open/floor/plating,
/area/ruin/powered/golem_ship)
"Ar" = (
/obj/structure/shuttle/engine/propulsion{
	dir = 4
	},
/turf/open/floor/plating,
/area/ruin/powered/golem_ship)
"Bn" = (
/obj/machinery/door/airlock/titanium,
/obj/effect/mapping_helpers/airlock/cyclelink_helper,
/turf/open/floor/plating,
/area/ruin/powered/golem_ship)
"Eq" = (
/obj/structure/fans/tiny,
/obj/machinery/door/airlock/titanium,
/obj/effect/mapping_helpers/airlock/cyclelink_helper,
/turf/open/floor/plating,
/area/ruin/powered/golem_ship)
"Hg" = (
/obj/effect/turf_decal/siding/wood{
	dir = 1
	},
/turf/open/floor/wood,
/area/ruin/powered/golem_ship)
"HK" = (
/obj/machinery/computer/arcade/orion_trail{
	dir = 8
	},
/turf/open/floor/mineral/titanium,
/area/ruin/powered/golem_ship)
"HP" = (
/obj/structure/ore_box,
/turf/open/floor/mineral/titanium,
/area/ruin/powered/golem_ship)
"Jc" = (
/obj/structure/table/wood,
/turf/open/floor/mineral/titanium,
/area/ruin/powered/golem_ship)
"Je" = (
/obj/structure/fans/tiny,
/obj/machinery/door/airlock/titanium,
/obj/effect/mapping_helpers/airlock/cyclelink_helper{
	dir = 1
	},
/turf/open/floor/plating,
/area/ruin/powered/golem_ship)
"KH" = (
/turf/open/floor/wood,
/area/ruin/powered/golem_ship)
"KI" = (
/obj/effect/turf_decal/siding/wood,
/turf/open/floor/wood,
/area/ruin/powered/golem_ship)
"Md" = (
/turf/closed/wall/mineral/titanium/nodiagonal,
/area/ruin/powered/golem_ship)
"NU" = (
/obj/structure/reagent_dispensers/watertank,
/turf/open/floor/plating,
/area/ruin/powered/golem_ship)
"Pk" = (
/obj/structure/table/wood,
/obj/item/resonator/upgraded{
	pixel_x = 3;
	pixel_y = 6
	},
/obj/item/disk/design_disk/golem_shell{
	pixel_x = -7;
	pixel_y = -3
	},
/turf/open/floor/wood,
/area/ruin/powered/golem_ship)
"Pm" = (
/obj/structure/extinguisher_cabinet{
	pixel_y = 30
	},
/turf/open/floor/plating,
/area/ruin/powered/golem_ship)
"Pz" = (
/obj/effect/mob_spawn/human/golem/adamantine,
/turf/open/floor/wood,
/area/ruin/powered/golem_ship)
"Qj" = (
/turf/open/floor/mineral/titanium,
/area/ruin/powered/golem_ship)
"Qk" = (
/obj/machinery/door/airlock/titanium,
/obj/structure/fans/tiny,
/turf/open/floor/mineral/titanium,
/area/ruin/powered/golem_ship)
"Rz" = (
/obj/structure/table/wood,
/obj/machinery/reagentgrinder{
	desc = "Used to grind things up into raw materials and liquids.";
	pixel_y = 5
	},
/obj/effect/turf_decal/siding/wood{
	dir = 1
	},
/turf/open/floor/wood,
/area/ruin/powered/golem_ship)
"TL" = (
/obj/machinery/mineral/ore_redemption,
/turf/open/floor/mineral/titanium,
/area/ruin/powered/golem_ship)
"Ub" = (
/obj/structure/table/wood,
/obj/item/storage/firstaid/brute{
	pixel_x = 6;
	pixel_y = 6
	},
/obj/item/storage/firstaid/brute{
	pixel_x = 3;
	pixel_y = 3
	},
/obj/item/surgical_drapes{
	pixel_x = 15
	},
/turf/open/floor/wood,
/area/ruin/powered/golem_ship)
"UI" = (
/obj/item/resonator,
/turf/open/floor/wood,
/area/ruin/powered/golem_ship)
"Vf" = (
/obj/machinery/autolathe,
/turf/open/floor/mineral/titanium,
/area/ruin/powered/golem_ship)
"Wg" = (
/obj/structure/closet/crate,
/obj/item/shovel,
/obj/item/shovel,
/obj/item/shovel,
/obj/item/pickaxe,
/obj/item/pickaxe,
/obj/item/pickaxe,
/obj/item/storage/bag/ore,
/obj/item/storage/bag/ore,
/obj/item/mining_scanner,
/obj/item/flashlight/lantern,
/obj/item/card/id/mining,
/turf/open/floor/wood,
/area/ruin/powered/golem_ship)
"WP" = (
/obj/structure/shuttle/engine/heater{
	dir = 4
	},
/obj/structure/window/reinforced{
	dir = 8
	},
/turf/open/floor/plating,
/area/ruin/powered/golem_ship)
"Zf" = (
/obj/machinery/light{
	dir = 8
	},
/turf/open/floor/mineral/titanium/white,
/area/ruin/powered/golem_ship)

(1,1,1) = {"
wI
wI
wI
wI
wI
wI
xW
Md
Md
xW
wI
wI
wI
wI
wI
wI
"}
(2,1,1) = {"
wI
wI
wI
wI
wI
wI
Md
Zf
gP
Md
wI
wI
wI
wI
wI
wI
"}
(3,1,1) = {"
wI
wI
wI
xW
Md
Qk
Md
hd
lI
Md
yC
Md
xW
wI
wI
wI
"}
(4,1,1) = {"
wI
wI
wI
Md
Qj
Qj
Qj
hQ
hQ
Qj
Qj
Qj
Md
wI
wI
wI
"}
(5,1,1) = {"
wI
wI
wI
Md
Qj
Qj
Qj
hQ
hQ
Qj
Qj
Qj
Md
wI
wI
wI
"}
(6,1,1) = {"
xW
Md
Md
Md
Qj
Qj
Qj
hQ
hQ
Qj
Qj
Qj
Md
Md
Md
xW
"}
(7,1,1) = {"
Md
Pz
Pz
KI
Qj
Qj
Qj
hQ
hQ
Qj
Qj
Qj
Hg
Pz
Pz
Md
"}
(8,1,1) = {"
Md
UI
UI
KI
Qj
Qj
Qj
hQ
hQ
Qj
Qj
Qj
Hg
UI
UI
Md
"}
(9,1,1) = {"
Md
KH
KH
KI
Qj
Qj
Qj
hQ
hQ
Qj
Qj
Qj
Hg
KH
KH
Md
"}
(10,1,1) = {"
Md
Wg
KH
KI
Qj
Qj
Qj
hQ
hQ
Qj
Qj
Qj
Hg
KH
ph
Md
"}
(11,1,1) = {"
Md
Wg
KH
KI
Qj
Qj
Qj
hQ
hQ
Qj
Qj
Qj
Hg
KH
Ub
Md
"}
(12,1,1) = {"
Md
Wg
KH
KI
Qj
Qj
Qj
hQ
hQ
Qj
Qj
Qj
Hg
KH
pD
Md
"}
(13,1,1) = {"
Md
Wg
KH
KI
tU
Jc
Qj
hQ
hQ
Qj
Qj
Qj
Rz
hb
Pk
Md
"}
(14,1,1) = {"
Md
Md
Md
Md
eK
eK
Md
is
is
Md
eK
eK
Md
Md
Md
Md
"}
(15,1,1) = {"
Eq
vg
vg
xR
hQ
hQ
hQ
hQ
hQ
hQ
hQ
hQ
Bn
vg
vg
Je
"}
(16,1,1) = {"
Eq
vg
vg
xR
hQ
hQ
hQ
hQ
hQ
hQ
hQ
hQ
Bn
vg
vg
Je
"}
(17,1,1) = {"
Md
NU
cQ
Md
Qj
Qj
HK
hQ
hQ
TL
Qj
Qj
Md
NU
cQ
Md
"}
(18,1,1) = {"
Md
WP
WP
Md
mU
HP
Md
bj
bj
Md
HP
Vf
Md
WP
WP
Md
"}
(19,1,1) = {"
Md
Ar
Ar
Md
WP
WP
Md
Pm
sV
Md
WP
WP
Md
Ar
Ar
Md
"}
(20,1,1) = {"
wI
wI
wI
wI
Ar
Ar
Md
yW
yW
Md
Ar
Ar
wI
wI
wI
wI
"}
