//MAP CONVERTED BY dmm2tgm.py THIS HEADER COMMENT PREVENTS RECONVERSION, DO NOT REMOVE
"al" = (
/obj/machinery/cryopod,
/obj/structure/curtain,
/obj/machinery/computer/cryopod{
	pixel_y = 25
	},
/turf/open/floor/pod/dark,
/area/station/crew)
"az" = (
/obj/machinery/light/small{
	dir = 1
	},
/obj/effect/turf_decal/industrial/hatch/yellow{
	dir = 4
	},
/obj/machinery/power/smes/engineering,
/obj/structure/cable,
/turf/open/floor/pod/dark,
/area/station/crew)
"bo" = (
/obj/machinery/power/shuttle/engine/electric{
	dir = 4
	},
/obj/structure/cable,
/turf/open/floor/plating/airless,
/area/station/crew)
"bN" = (
/obj/machinery/atmospherics/pipe/simple/orange/hidden{
	dir = 10
	},
/obj/machinery/power/terminal{
	dir = 1
	},
/obj/structure/cable,
/turf/open/floor/plating,
/area/station/crew)
"bZ" = (
/obj/effect/turf_decal/corner/red,
/turf/open/floor/iron/dark,
/area/station/crew)
"dZ" = (
/obj/machinery/power/shuttle/engine/fueled/plasma{
	dir = 4
	},
/turf/open/floor/plating/airless,
/area/station/crew)
"gl" = (
/obj/machinery/door/airlock/hatch{
	id_tag = "caravansyndicate3_bolt_port";
	name = "External Airlock";
	normalspeed = 0;
	req_access_txt = "150"
	},
/obj/docking_port/mobile{
	dir = 2;
	dwidth = 6;
	height = 7;
	name = "Syndicate Drop Ship";
	port_direction = 8;
	preferred_direction = 4;
	width = 15
	},
/obj/structure/fans/tiny,
/turf/open/floor/mineral/plastitanium,
/area/station/crew)
"ha" = (
/obj/machinery/power/port_gen/pacman{
	anchored = 1
	},
/obj/item/wrench,
/obj/effect/decal/cleanable/dirt,
/obj/structure/cable,
/obj/effect/turf_decal/industrial/warning{
	dir = 6
	},
/obj/machinery/atmospherics/pipe/simple/orange/hidden{
	dir = 9
	},
/turf/open/floor/plating,
/area/station/crew)
"hN" = (
/obj/effect/turf_decal/corner/red/three_quarters{
	dir = 8
	},
/turf/open/floor/iron/dark,
/area/station/crew)
"je" = (
/obj/machinery/computer/autopilot{
	dir = 8
	},
/obj/effect/turf_decal/corner/red/three_quarters{
	dir = 4
	},
/turf/open/floor/iron/dark,
/area/station/crew)
"jk" = (
/obj/machinery/holopad/emergency/command,
/turf/open/floor/iron/dark,
/area/station/crew)
"ka" = (
/obj/machinery/atmospherics/pipe/simple/orange/hidden{
	dir = 4
	},
/obj/machinery/suit_storage_unit/syndicate,
/turf/open/floor/pod/dark,
/area/station/crew)
"mG" = (
/obj/structure/grille,
/obj/structure/window/reinforced/plasma/plastitanium,
/turf/open/floor/plating,
/area/station/crew)
"ns" = (
/obj/structure/chair/comfy/shuttle,
/turf/open/floor/pod/dark,
/area/station/crew)
"qE" = (
/obj/effect/turf_decal/industrial/warning{
	dir = 9
	},
/obj/machinery/stasis,
/turf/open/floor/mineral/plastitanium,
/area/station/crew)
"rz" = (
/obj/structure/chair/comfy/shuttle,
/obj/machinery/light/small{
	dir = 4
	},
/turf/open/floor/pod/dark,
/area/station/crew)
"rD" = (
/obj/effect/turf_decal/corner/red/three_quarters{
	dir = 4
	},
/turf/open/floor/iron/dark,
/area/station/crew)
"rU" = (
/obj/structure/grille,
/obj/structure/window/reinforced/plasma/plastitanium,
/turf/open/floor/iron/dark,
/area/station/crew)
"rV" = (
/obj/machinery/suit_storage_unit/syndicate,
/turf/open/floor/pod/dark,
/area/station/crew)
"sn" = (
/obj/structure/table/reinforced,
/obj/machinery/airalarm/syndicate{
	pixel_y = 24;
	dir = 1
	},
/obj/structure/cable,
/turf/open/floor/pod/dark,
/area/station/crew)
"ss" = (
/obj/effect/turf_decal/corner/red{
	dir = 5
	},
/turf/open/floor/iron/dark,
/area/station/crew)
"uy" = (
/obj/structure/chair/comfy/shuttle,
/obj/machinery/light/small{
	dir = 8
	},
/turf/open/floor/pod/dark,
/area/station/crew)
"vw" = (
/obj/structure/table/reinforced,
/obj/item/storage/briefcase,
/turf/open/floor/pod/dark,
/area/station/crew)
"wH" = (
/obj/machinery/atmospherics/components/unary/shuttle/heater{
	dir = 4
	},
/obj/structure/window/reinforced{
	dir = 8;
	pixel_x = -4
	},
/obj/machinery/door/window/left/directional/north{
	dir = 4;
	name = "Engine Access"
	},
/turf/open/floor/plating/airless,
/area/station/crew)
"xC" = (
/obj/machinery/light/small{
	dir = 8
	},
/turf/open/floor/iron/dark,
/area/station/crew)
"Bp" = (
/obj/machinery/atmospherics/pipe/simple/orange/hidden,
/obj/effect/turf_decal/corner/red{
	dir = 10
	},
/turf/open/floor/iron/dark,
/area/station/crew)
"BQ" = (
/obj/effect/turf_decal/corner/red{
	dir = 10
	},
/turf/open/floor/iron/dark,
/area/station/crew)
"Cm" = (
/obj/machinery/firealarm{
	dir = 1;
	pixel_y = -26
	},
/obj/machinery/atmospherics/pipe/simple/orange/hidden{
	dir = 9
	},
/obj/machinery/suit_storage_unit/syndicate,
/turf/open/floor/pod/dark,
/area/station/crew)
"Dt" = (
/obj/effect/turf_decal/industrial/warning{
	dir = 8
	},
/obj/machinery/light/small,
/obj/structure/table/reinforced,
/obj/item/storage/backpack/duffelbag/syndie/surgery,
/obj/item/defibrillator/compact/combat,
/obj/item/soap/syndie,
/obj/item/storage/firstaid/tactical,
/obj/item/storage/firstaid/tactical,
/obj/item/storage/firstaid/tactical,
/turf/open/floor/mineral/plastitanium,
/area/station/crew)
"Dx" = (
/turf/open/floor/iron/dark,
/area/station/crew)
"EO" = (
/obj/structure/table/reinforced,
/obj/item/disk/design_disk/ammo_c9mm,
/obj/machinery/power/apc/syndicate{
	dir = 8;
	name = "Syndicate Drop Ship APC";
	pixel_y = 25
	},
/obj/structure/cable,
/turf/open/floor/pod/dark,
/area/station/crew)
"Fa" = (
/obj/effect/turf_decal/industrial/warning{
	dir = 10
	},
/obj/structure/rack,
/obj/item/melee/transforming/energy/sword/saber/red,
/obj/item/melee/transforming/energy/sword/saber/red,
/obj/item/melee/transforming/energy/sword/saber/red,
/obj/item/gun/ballistic/automatic/pistol/APS,
/obj/item/gun/ballistic/automatic/pistol/APS,
/obj/item/gun/ballistic/automatic/pistol/APS,
/obj/item/ammo_box/magazine/pistolm9mm,
/obj/item/ammo_box/magazine/pistolm9mm,
/obj/item/ammo_box/magazine/pistolm9mm,
/obj/item/ammo_box/magazine/pistolm9mm,
/obj/item/ammo_box/magazine/pistolm9mm,
/obj/item/ammo_box/magazine/pistolm9mm,
/obj/item/ammo_box/magazine/pistolm9mm,
/obj/item/ammo_box/magazine/pistolm9mm,
/obj/item/ammo_box/magazine/pistolm9mm,
/obj/item/ammo_box/magazine/pistolm9mm,
/obj/item/ammo_box/magazine/pistolm9mm,
/obj/item/ammo_box/magazine/pistolm9mm,
/obj/item/ammo_box/magazine/pistolm9mm,
/turf/open/floor/mineral/plastitanium,
/area/station/crew)
"FM" = (
/obj/structure/table/reinforced,
/obj/item/assembly/flash/handheld,
/obj/effect/turf_decal/corner/red/three_quarters{
	dir = 8
	},
/turf/open/floor/iron/dark,
/area/station/crew)
"Gx" = (
/obj/machinery/power/smes/shuttle{
	dir = 4
	},
/obj/structure/cable,
/obj/structure/window/reinforced{
	dir = 8;
	pixel_x = -4
	},
/obj/machinery/door/window/left/directional/north{
	dir = 4;
	name = "Engine Access"
	},
/turf/open/floor/plating/airless,
/area/station/crew)
"GR" = (
/obj/effect/turf_decal/corner/red{
	dir = 4
	},
/turf/open/floor/iron/dark,
/area/station/crew)
"HB" = (
/obj/machinery/computer/helm{
	dir = 8
	},
/obj/effect/turf_decal/corner/red{
	dir = 9
	},
/turf/open/floor/iron/dark,
/area/station/crew)
"HJ" = (
/obj/effect/turf_decal/industrial/warning{
	dir = 8
	},
/obj/structure/sign/warning/vacuum/directional/south,
/obj/machinery/mineral/ore_redemption{
	dir = 8
	},
/turf/open/floor/mineral/plastitanium,
/area/station/crew)
"HM" = (
/obj/structure/table/reinforced,
/obj/machinery/light/small{
	dir = 8
	},
/obj/machinery/microwave,
/obj/effect/spawner/random/food_or_drink/donkpockets,
/obj/effect/spawner/random/food_or_drink/donkpockets,
/obj/effect/spawner/random/food_or_drink/donkpockets,
/obj/effect/spawner/random/food_or_drink/donkpockets,
/obj/effect/spawner/random/food_or_drink/donkpockets,
/obj/effect/spawner/random/food_or_drink/donkpockets,
/obj/effect/turf_decal/corner/red/three_quarters{
	dir = 1
	},
/turf/open/floor/iron/dark,
/area/station/crew)
"IU" = (
/obj/machinery/atmospherics/pipe/simple/orange/hidden{
	dir = 10
	},
/turf/open/floor/iron/dark,
/area/station/crew)
"Jv" = (
/turf/template_noop,
/area/template_noop)
"KS" = (
/obj/machinery/door/airlock/hatch{
	id_tag = "caravansyndicate3_bolt_starboard";
	name = "External Airlock";
	normalspeed = 0;
	req_access_txt = "150"
	},
/obj/structure/fans/tiny,
/turf/open/floor/mineral/plastitanium,
/area/station/crew)
"Ll" = (
/obj/machinery/light/small{
	dir = 4
	},
/obj/structure/showcase/cyborg/assault,
/turf/open/floor/pod/dark,
/area/station/crew)
"Lq" = (
/obj/effect/turf_decal/industrial/warning{
	dir = 8
	},
/obj/structure/sign/warning/vacuum/directional/north,
/obj/machinery/autolathe/hacked,
/turf/open/floor/mineral/plastitanium,
/area/station/crew)
"NH" = (
/obj/effect/turf_decal/industrial/warning{
	dir = 8
	},
/obj/machinery/light/small{
	dir = 1
	},
/obj/machinery/vending/security/marine{
	all_items_free = 1
	},
/turf/open/floor/mineral/plastitanium,
/area/station/crew)
"Pg" = (
/obj/effect/turf_decal/corner/red/three_quarters,
/turf/open/floor/iron/dark,
/area/station/crew)
"Pt" = (
/obj/effect/turf_decal/industrial/warning{
	dir = 4
	},
/obj/structure/closet/crate,
/obj/item/stack/sheet/metal/twenty,
/obj/item/stack/sheet/glass{
	amount = 10
	},
/obj/item/stack/sheet/mineral/plastitanium{
	amount = 20
	},
/obj/item/storage/box/lights/bulbs,
/obj/item/storage/toolbox/mechanical,
/obj/item/stack/sheet/mineral/plasma{
	amount = 20
	},
/obj/machinery/atmospherics/pipe/manifold4w/orange/hidden,
/obj/machinery/power/terminal{
	dir = 8
	},
/obj/structure/cable,
/obj/item/stack/sheet/mineral/plasma{
	amount = 20
	},
/turf/open/floor/plating,
/area/station/crew)
"PJ" = (
/obj/structure/table/reinforced,
/obj/item/toy/plush/nukeplushie,
/turf/open/floor/pod/dark,
/area/station/crew)
"PY" = (
/obj/effect/turf_decal/industrial/hatch/yellow{
	dir = 4
	},
/obj/machinery/light/small,
/obj/machinery/atmospherics/miner/plasma,
/obj/machinery/atmospherics/components/unary/vent_scrubber/on/layer3{
	dir = 4
	},
/obj/structure/window/reinforced/plasma/spawner/east,
/obj/structure/window/reinforced/plasma/spawner/north,
/turf/open/floor/engine/plasma,
/area/station/crew)
"Ri" = (
/obj/structure/chair/comfy/shuttle{
	dir = 4
	},
/turf/open/floor/iron/dark,
/area/station/crew)
"RB" = (
/obj/machinery/photocopier/faxmachine/longrange,
/obj/structure/table/reinforced,
/obj/effect/turf_decal/corner/red/three_quarters{
	dir = 1
	},
/turf/open/floor/iron/dark,
/area/station/crew)
"Sl" = (
/obj/structure/table/reinforced,
/obj/machinery/light/small{
	dir = 8
	},
/obj/item/paper_bin,
/obj/item/folder/syndicate/red,
/obj/item/pen/red,
/turf/open/floor/pod/dark,
/area/station/crew)
"Tn" = (
/turf/closed/wall/mineral/plastitanium/nodiagonal,
/area/station/crew)
"Vf" = (
/obj/machinery/door/airlock/hatch{
	id_tag = "caravansyndicate3_bolt_port";
	name = "External Airlock";
	normalspeed = 0;
	req_access_txt = "150"
	},
/turf/open/floor/iron/dark,
/area/station/crew)
"VA" = (
/obj/structure/table/reinforced,
/obj/machinery/light/small{
	dir = 8
	},
/obj/item/ammo_box/a357,
/obj/item/ammo_box/a357,
/obj/item/ammo_box/a357,
/obj/item/card/emag,
/obj/item/areaeditor/shuttle,
/obj/effect/turf_decal/corner/red/three_quarters{
	dir = 4
	},
/turf/open/floor/iron/dark,
/area/station/crew)
"Wr" = (
/obj/machinery/suit_storage_unit/syndicate{
	name = "captain's suit storage unit";
	storage_type = /obj/item/clothing/shoes/magboots/syndie;
	suit_type = /obj/item/clothing/suit/space/hardsuit/syndi/elite
	},
/obj/effect/turf_decal/corner/red/three_quarters,
/turf/open/floor/iron/dark,
/area/station/crew)
"YU" = (
/obj/effect/turf_decal/industrial/warning{
	dir = 10
	},
/obj/structure/closet/syndicate{
	anchored = 1
	},
/obj/item/clothing/under/syndicate/combat,
/obj/item/clothing/under/syndicate/combat,
/obj/item/clothing/under/syndicate/combat,
/obj/item/storage/belt/military,
/obj/item/storage/belt/military,
/obj/item/storage/belt/military,
/obj/item/crowbar/red,
/obj/item/crowbar/red,
/obj/item/crowbar/red,
/obj/item/clothing/mask/gas/syndicate,
/obj/item/clothing/mask/gas/syndicate,
/obj/item/clothing/mask/gas/syndicate,
/turf/open/floor/mineral/plastitanium,
/area/station/crew)
"ZB" = (
/turf/closed/wall/mineral/plastitanium,
/area/station/crew)
"ZI" = (
/obj/effect/turf_decal/industrial/warning{
	dir = 9
	},
/obj/structure/ore_box,
/obj/item/storage/bag/ore,
/obj/item/tank/internals/emergency_oxygen/double,
/obj/item/tank/internals/emergency_oxygen/double,
/obj/item/tank/internals/emergency_oxygen/double,
/obj/item/tank/internals/emergency_oxygen/double,
/obj/item/tank/internals/emergency_oxygen/double,
/obj/item/tank/internals/emergency_oxygen/double,
/obj/item/pickaxe,
/obj/item/pickaxe,
/obj/item/pickaxe,
/turf/open/floor/mineral/plastitanium,
/area/station/crew)
"ZJ" = (
/obj/machinery/atmospherics/components/binary/pump{
	dir = 8;
	name = "fuel pump"
	},
/turf/open/floor/iron/dark,
/area/station/crew)
"ZZ" = (
/obj/effect/turf_decal/corner/red/three_quarters{
	dir = 1
	},
/turf/open/floor/iron/dark,
/area/station/crew)

(1,1,1) = {"
ZB
Jv
dZ
bo
dZ
Jv
ZB
"}
(2,1,1) = {"
Tn
Tn
wH
Gx
wH
Tn
Tn
"}
(3,1,1) = {"
Tn
az
bN
Pt
ha
PY
Tn
"}
(4,1,1) = {"
Tn
sn
ss
ZJ
BQ
ka
Tn
"}
(5,1,1) = {"
Tn
EO
ss
IU
Bp
Cm
Tn
"}
(6,1,1) = {"
Tn
al
ss
Dx
BQ
rV
Tn
"}
(7,1,1) = {"
Tn
NH
Fa
Dx
qE
Dt
Tn
"}
(8,1,1) = {"
Tn
Tn
Tn
Vf
Tn
Tn
Tn
"}
(9,1,1) = {"
gl
xC
Dx
Dx
Dx
xC
KS
"}
(10,1,1) = {"
Tn
Lq
YU
Dx
ZI
HJ
Tn
"}
(11,1,1) = {"
Tn
Tn
Tn
Vf
Tn
Tn
Tn
"}
(12,1,1) = {"
Tn
uy
rD
Dx
ZZ
Sl
Tn
"}
(13,1,1) = {"
rU
ns
ss
Dx
BQ
vw
rU
"}
(14,1,1) = {"
rU
ns
ss
Dx
BQ
PJ
rU
"}
(15,1,1) = {"
Tn
rz
hN
Dx
Pg
Ll
Tn
"}
(16,1,1) = {"
Tn
Tn
Tn
Vf
Tn
Tn
Tn
"}
(17,1,1) = {"
Tn
HM
Dx
Dx
jk
VA
Tn
"}
(18,1,1) = {"
mG
Wr
GR
Ri
bZ
FM
mG
"}
(19,1,1) = {"
mG
mG
RB
HB
je
mG
mG
"}
(20,1,1) = {"
Jv
mG
mG
mG
mG
mG
Jv
"}
