//MAP CONVERTED BY dmm2tgm.py THIS HEADER COMMENT PREVENTS RECONVERSION, DO NOT REMOVE
"a" = (
/turf/template_noop,
/area/template_noop)
"c" = (
/turf/closed/wall/mineral/plastitanium,
/area/ship/security)
"e" = (
/obj/machinery/porta_turret/centcom_shuttle/ballistic{
	dir = 5;
	name = "ship turret";
	on = 0
	},
/turf/closed/wall/mineral/plastitanium,
/area/ship/security)
"l" = (
/obj/machinery/power/shuttle/engine/electric{
	dir = 4
	},
/obj/structure/cable{
	icon_state = "0-4"
	},
/turf/open/floor/plating/airless,
/area/ship/security)
"m" = (
/obj/machinery/power/smes/shuttle/precharged{
	dir = 8
	},
/obj/structure/cable{
	icon_state = "0-8"
	},
/turf/closed/wall/mineral/plastitanium,
/area/ship/security)
"q" = (
/obj/machinery/power/terminal{
	dir = 8
	},
/obj/structure/cable{
	icon_state = "0-2"
	},
/turf/closed/wall/mineral/plastitanium,
/area/ship/security)
"s" = (
/obj/machinery/computer/helm,
/obj/structure/cable{
	icon_state = "1-2"
	},
/obj/machinery/light{
	dir = 1
	},
/obj/machinery/vending/security/marine{
	all_items_free = 1;
	pixel_y = 32
	},
/turf/open/floor/mineral/plastitanium/red,
/area/ship/security)
"t" = (
/obj/effect/decal/cleanable/dirt,
/obj/machinery/power/smes/engineering,
/obj/structure/cable{
	icon_state = "0-4"
	},
/obj/machinery/cryopod{
	alpha = 30;
	dir = 1
	},
/turf/open/floor/mineral/plastitanium/red,
/area/ship/security)
"w" = (
/obj/effect/decal/cleanable/dirt,
/obj/structure/cable{
	icon_state = "2-8"
	},
/obj/structure/cable{
	icon_state = "1-8"
	},
/obj/structure/closet/wall/orange{
	dir = 8;
	name = "fuel locker";
	pixel_x = 28
	},
/obj/item/stack/sheet/mineral/uranium{
	amount = 10
	},
/turf/open/floor/mineral/plastitanium/red,
/area/ship/security)
"A" = (
/obj/effect/decal/cleanable/dirt,
/obj/docking_port/mobile{
	callTime = 50;
	dir = 4;
	dwidth = 4;
	height = 5;
	ignitionTime = 25;
	launch_status = 0;
	name = "Syndicate Fighter";
	port_direction = 2;
	preferred_direction = 4;
	width = 9
	},
/obj/machinery/door/airlock/hatch{
	id_tag = "syndicatefighter"
	},
/obj/structure/fans/tiny,
/turf/open/floor/plating,
/area/ship/security)
"C" = (
/obj/machinery/power/terminal{
	dir = 1
	},
/obj/structure/cable{
	icon_state = "0-2"
	},
/turf/open/floor/mineral/plastitanium/red,
/area/ship/security)
"D" = (
/obj/machinery/power/apc/auto_name/east{
	auto_name = 0;
	desc = "A control terminal for the ship's electrical systems.";
	name = "Syndicate Interceptor APC"
	},
/obj/structure/cable{
	icon_state = "1-2"
	},
/obj/structure/cable,
/obj/machinery/turretid{
	desc = "Used to control the Inteceptor's automated defenses.";
	pixel_x = 26;
	pixel_y = -10;
	req_access = list(150)
	},
/obj/machinery/holopad/emergency/command{
	name = "advanced holopad"
	},
/turf/open/floor/mineral/plastitanium/red,
/area/ship/security)
"G" = (
/obj/item/radio/intercom/wideband{
	pixel_y = -29
	},
/obj/structure/cable,
/obj/machinery/power/port_gen/pacman/uranium,
/turf/open/floor/mineral/plastitanium/red,
/area/ship/security)
"H" = (
/obj/effect/decal/cleanable/dirt,
/obj/effect/decal/cleanable/dirt,
/obj/structure/cable{
	icon_state = "1-2"
	},
/obj/structure/closet/wall/red{
	dir = 8;
	name = "uniform closet";
	pixel_x = 28
	},
/obj/item/clothing/suit/space/syndicate/black/red,
/obj/item/clothing/suit/space/syndicate/black/red,
/obj/item/clothing/suit/space/syndicate/black/red,
/obj/item/clothing/head/helmet/space/syndicate/black/red,
/obj/item/clothing/head/helmet/space/syndicate/black/red,
/obj/item/clothing/head/helmet/space/syndicate/black/red,
/obj/item/tank/internals/emergency_oxygen/double,
/obj/item/tank/internals/emergency_oxygen/double,
/obj/item/tank/internals/emergency_oxygen/double,
/obj/item/storage/toolbox/syndicate,
/obj/item/stack/cable_coil/red,
/obj/item/resonator,
/obj/item/resonator,
/obj/item/resonator,
/obj/item/melee/transforming/energy/sword/saber/red{
	name = "energy saber"
	},
/obj/item/melee/transforming/energy/sword/saber/red{
	name = "energy saber"
	},
/obj/item/melee/transforming/energy/sword/saber/red{
	name = "energy saber"
	},
/obj/item/mining_scanner,
/obj/item/mining_scanner,
/obj/item/mining_scanner,
/obj/item/areaeditor/shuttle,
/turf/open/floor/mineral/plastitanium/red,
/area/ship/security)
"K" = (
/obj/effect/decal/cleanable/dirt,
/obj/structure/cable{
	icon_state = "1-2"
	},
/obj/machinery/computer/cryopod{
	pixel_y = -32
	},
/obj/machinery/autolathe,
/obj/machinery/light,
/turf/open/floor/mineral/plastitanium/red,
/area/ship/security)
"R" = (
/obj/machinery/power/terminal{
	dir = 8
	},
/obj/structure/cable,
/turf/closed/wall/mineral/plastitanium,
/area/ship/security)
"U" = (
/obj/machinery/porta_turret/centcom_shuttle/ballistic{
	dir = 6;
	name = "ship turret";
	on = 0
	},
/turf/closed/wall/mineral/plastitanium,
/area/ship/security)

(1,1,1) = {"
a
l
c
c
A
c
c
l
a
"}
(2,1,1) = {"
a
m
c
t
C
G
c
m
a
"}
(3,1,1) = {"
c
q
s
w
D
H
K
R
c
"}
(4,1,1) = {"
c
c
c
c
c
c
c
c
c
"}
(5,1,1) = {"
c
c
a
a
a
a
a
c
c
"}
(6,1,1) = {"
e
a
a
a
a
a
a
a
U
"}
