//MAP CONVERTED BY dmm2tgm.py THIS HEADER COMMENT PREVENTS RECONVERSION, DO NOT REMOVE
"ai" = (
/obj/structure/grille,
/obj/structure/window/reinforced/fulltile,
/turf/open/floor/plating,
/area/station/command/bridge)
"aP" = (
/obj/machinery/atmospherics/pipe/smart/manifold4w/scrubbers/hidden/layer2,
/obj/machinery/suit_storage_unit/rd,
/turf/open/floor/iron,
/area/station/science)
"bm" = (
/obj/structure/window/reinforced/spawner/west,
/obj/structure/window/reinforced,
/obj/structure/rack,
/obj/item/assembly/signaler,
/obj/item/assembly/signaler,
/obj/item/assembly/signaler,
/obj/item/assembly/signaler,
/turf/open/floor/iron,
/area/station/commons/storage/primary)
"bv" = (
/obj/structure/rack,
/obj/item/pipe_dispenser,
/obj/item/pipe_dispenser,
/obj/item/transfer_valve,
/obj/item/transfer_valve,
/obj/item/transfer_valve,
/obj/item/storage/toolbox/mechanical,
/turf/open/floor/iron,
/area/station/science)
"cB" = (
/obj/structure/window/reinforced/spawner/north,
/obj/structure/rack,
/obj/item/assembly/infra,
/obj/item/assembly/infra,
/obj/item/assembly/infra,
/obj/item/assembly/infra,
/turf/open/floor/iron,
/area/station/commons/storage/primary)
"cH" = (
/obj/machinery/chem_dispenser,
/obj/machinery/light/small,
/turf/open/floor/iron,
/area/station/medical)
"da" = (
/turf/template_noop,
/area/station/external)
"dE" = (
/obj/structure/window/reinforced/spawner/east,
/obj/structure/window/reinforced/spawner/north,
/obj/structure/rack,
/obj/item/assembly/prox_sensor,
/obj/item/assembly/prox_sensor,
/obj/item/assembly/prox_sensor,
/obj/item/assembly/prox_sensor,
/turf/open/floor/iron,
/area/station/commons/storage/primary)
"eo" = (
/obj/machinery/atmospherics/pipe/smart/manifold4w/supply/hidden/layer4,
/obj/machinery/atmospherics/pipe/smart/manifold4w/scrubbers/hidden/layer2,
/turf/open/floor/plating,
/area/station/maintenance/aft)
"fi" = (
/obj/machinery/atmospherics/pipe/smart/manifold4w/supply/hidden/layer4,
/obj/machinery/atmospherics/pipe/smart/manifold4w/scrubbers/hidden/layer2,
/obj/structure/cable,
/turf/open/floor/iron,
/area/station/commons/storage/primary)
"fo" = (
/turf/template_noop,
/area/template_noop)
"fJ" = (
/obj/structure/cable,
/obj/machinery/power/shuttle/engine/electric{
	dir = 4
	},
/turf/open/floor/plating,
/area/station/external)
"fL" = (
/obj/structure/rack,
/obj/item/clothing/mask/balaclava,
/obj/item/clothing/under/suit/black_really,
/obj/item/clothing/under/suit/black,
/obj/item/clothing/mask/russian_balaclava,
/obj/item/clothing/under/syndicate/camo,
/obj/item/clothing/under/syndicate/camo,
/obj/item/clothing/under/syndicate/camo,
/obj/item/clothing/under/syndicate/camo,
/turf/open/floor/iron,
/area/station/command/bridge)
"fS" = (
/obj/structure/grille,
/obj/structure/window/reinforced/fulltile,
/turf/open/floor/plating,
/area/station/science)
"gL" = (
/obj/machinery/atmospherics/pipe/smart/manifold4w/supply/hidden/layer4,
/obj/machinery/atmospherics/pipe/smart/manifold4w/scrubbers/hidden/layer2,
/obj/structure/cable,
/obj/machinery/door/airlock/medical,
/turf/open/floor/iron,
/area/station/medical)
"hb" = (
/obj/structure/table/reinforced,
/obj/item/grenade/chem_grenade/pyro,
/obj/item/grenade/chem_grenade/pyro,
/obj/item/grenade/chem_grenade/pyro,
/obj/item/grenade/chem_grenade/cryo,
/obj/item/grenade/chem_grenade/cryo,
/obj/item/grenade/chem_grenade/cryo,
/turf/open/floor/iron,
/area/station/medical)
"hm" = (
/turf/open/floor/plating,
/area/station/maintenance/aft)
"hn" = (
/obj/machinery/power/apc/auto_name/directional/east,
/obj/structure/cable,
/turf/open/floor/iron,
/area/station/cargo)
"hC" = (
/obj/machinery/atmospherics/components/unary/vent_scrubber/on/layer2{
	dir = 1
	},
/turf/open/floor/iron,
/area/station/cargo)
"hI" = (
/obj/machinery/atmospherics/pipe/smart/manifold4w/scrubbers/hidden/layer2,
/obj/machinery/light/small,
/turf/open/floor/iron,
/area/station/science)
"ir" = (
/obj/structure/chair/comfy/brown,
/turf/open/floor/iron,
/area/station/medical)
"jI" = (
/turf/open/floor/iron,
/area/station/cargo)
"kt" = (
/obj/machinery/atmospherics/components/unary/vent_pump/on/layer4{
	dir = 8
	},
/turf/open/floor/iron,
/area/station/commons/storage/primary)
"kv" = (
/obj/structure/window/reinforced,
/obj/structure/rack,
/obj/item/assembly/signaler,
/obj/item/assembly/signaler,
/obj/item/assembly/signaler,
/obj/item/assembly/signaler,
/turf/open/floor/iron,
/area/station/commons/storage/primary)
"lD" = (
/obj/machinery/light/small{
	dir = 4
	},
/turf/open/floor/iron,
/area/station/commons/storage/primary)
"lH" = (
/obj/machinery/power/smes/engineering{
	dir = 4
	},
/obj/structure/window/reinforced/spawner/west,
/obj/machinery/door/window/left/directional/east,
/obj/structure/cable,
/obj/machinery/atmospherics/pipe/smart/manifold4w/orange/visible,
/turf/open/floor/plating,
/area/station/maintenance/aft)
"mw" = (
/obj/structure/fans/tiny,
/turf/open/floor/engine,
/area/station/science)
"np" = (
/turf/open/floor/iron,
/area/station/command/bridge)
"nN" = (
/obj/structure/punching_bag{
	name = "Margaret Thatcher"
	},
/turf/open/floor/iron,
/area/station/command/bridge)
"pf" = (
/obj/structure/fans/tiny,
/obj/machinery/door/poddoor{
	id = "irishdoors";
	name = "Cargo Bay Blast Door"
	},
/turf/open/floor/plating,
/area/station/cargo)
"po" = (
/obj/machinery/airalarm/directional/south,
/obj/structure/reagent_dispensers/fueltank,
/obj/machinery/light/small,
/obj/structure/cable,
/turf/open/floor/iron,
/area/station/science)
"ps" = (
/obj/machinery/atmospherics/pipe/smart/manifold4w/supply/hidden/layer4,
/obj/machinery/atmospherics/pipe/smart/manifold4w/scrubbers/hidden/layer2,
/obj/structure/cable,
/obj/machinery/door/airlock/command/glass,
/turf/open/floor/iron,
/area/station/command/bridge)
"qc" = (
/obj/machinery/atmospherics/pipe/smart/manifold4w/supply/hidden/layer4,
/obj/machinery/atmospherics/pipe/smart/manifold4w/scrubbers/hidden/layer2,
/obj/structure/cable,
/obj/structure/plaque/static_plaque,
/turf/open/floor/iron,
/area/station/command/bridge)
"qQ" = (
/obj/machinery/atmospherics/components/tank/air,
/turf/open/floor/plating,
/area/station/maintenance/aft)
"qY" = (
/obj/structure/cable,
/obj/machinery/atmospherics/pipe/smart/manifold4w/scrubbers/hidden/layer2,
/obj/item/stack/sheet/mineral/plasma/thirty,
/obj/item/stack/sheet/mineral/plasma/thirty,
/turf/open/floor/plating,
/area/station/maintenance/aft)
"rc" = (
/obj/structure/cable,
/turf/open/floor/plating,
/area/station/maintenance/aft)
"re" = (
/obj/machinery/atmospherics/pipe/smart/manifold4w/supply/hidden/layer4,
/obj/machinery/atmospherics/pipe/smart/manifold4w/scrubbers/hidden/layer2,
/obj/structure/cable,
/obj/machinery/door/airlock/maintenance_hatch,
/turf/open/floor/iron,
/area/station/maintenance/aft)
"rl" = (
/obj/machinery/atmospherics/components/unary/thermomachine/freezer,
/turf/open/floor/iron,
/area/station/science)
"rq" = (
/obj/structure/rack,
/obj/item/storage/cans/sixbeer,
/obj/item/storage/cans/sixbeer,
/obj/item/reagent_containers/cup/glass/bottle/molotov,
/obj/item/reagent_containers/cup/glass/bottle/molotov,
/obj/item/reagent_containers/cup/glass/bottle/molotov,
/obj/item/reagent_containers/cup/glass/bottle/molotov,
/turf/open/floor/iron,
/area/station/command/bridge)
"ru" = (
/obj/machinery/atmospherics/components/unary/vent_scrubber/on/layer2{
	dir = 1
	},
/obj/machinery/light/small,
/turf/open/floor/iron,
/area/station/commons/storage/primary)
"rx" = (
/turf/open/floor/iron,
/area/station/commons/storage/primary)
"rK" = (
/obj/structure/table/reinforced,
/obj/machinery/syndicatebomb/empty,
/obj/machinery/syndicatebomb/empty,
/obj/item/grenade/c4,
/obj/item/grenade/c4,
/obj/item/grenade/c4,
/obj/item/grenade/c4,
/turf/open/floor/iron,
/area/station/medical)
"ss" = (
/turf/closed/wall,
/area/station/science)
"sE" = (
/obj/machinery/power/terminal{
	dir = 4
	},
/obj/structure/cable,
/obj/machinery/atmospherics/pipe/smart/manifold4w/scrubbers/hidden/layer2,
/turf/open/floor/plating,
/area/station/maintenance/aft)
"sI" = (
/obj/machinery/atmospherics/components/unary/vent_pump/on/layer4,
/turf/open/floor/iron,
/area/station/command/bridge)
"tj" = (
/obj/machinery/atmospherics/pipe/smart/manifold4w/supply/hidden/layer4,
/obj/machinery/atmospherics/pipe/smart/manifold4w/scrubbers/hidden/layer2,
/obj/machinery/power/apc/auto_name/directional/north,
/obj/structure/cable,
/turf/open/floor/iron,
/area/station/commons/storage/primary)
"tk" = (
/obj/machinery/autolathe,
/obj/item/stack/sheet/iron/fifty,
/obj/item/stack/sheet/glass/fifty,
/obj/machinery/light/small{
	dir = 4
	},
/turf/open/floor/iron,
/area/station/cargo)
"tC" = (
/turf/open/floor/engine,
/area/station/science)
"tF" = (
/obj/machinery/suit_storage_unit/mining/eva,
/turf/open/floor/iron,
/area/station/cargo)
"tX" = (
/obj/structure/reagent_dispensers/fueltank,
/obj/machinery/atmospherics/pipe/smart/manifold4w/scrubbers/hidden/layer2,
/turf/open/floor/plating,
/area/station/maintenance/aft)
"ub" = (
/obj/machinery/atmospherics/components/unary/vent_scrubber/on/layer2{
	dir = 8
	},
/obj/machinery/power/apc/auto_name/directional/north,
/obj/structure/cable,
/turf/open/floor/iron,
/area/station/medical)
"uc" = (
/obj/machinery/atmospherics/components/unary/vent_pump/on/layer4{
	dir = 1
	},
/obj/machinery/airalarm/directional/west,
/turf/open/floor/iron,
/area/station/medical)
"ud" = (
/obj/machinery/atmospherics/pipe/smart/manifold4w/supply/hidden/layer4,
/obj/machinery/atmospherics/pipe/smart/manifold4w/scrubbers/hidden/layer2,
/obj/structure/cable,
/obj/machinery/holopad,
/turf/open/floor/iron,
/area/station/command/bridge)
"uw" = (
/obj/machinery/power/smes/engineering,
/obj/structure/cable,
/turf/open/floor/plating,
/area/station/maintenance/aft)
"vO" = (
/obj/structure/cable,
/obj/machinery/light/small{
	dir = 8
	},
/turf/open/floor/plating,
/area/station/maintenance/aft)
"vP" = (
/obj/machinery/power/port_gen/pacman,
/turf/open/floor/plating,
/area/station/maintenance/aft)
"wk" = (
/obj/machinery/suit_storage_unit/engine,
/turf/open/floor/plating,
/area/station/maintenance/aft)
"wr" = (
/obj/item/radio/intercom{
	pixel_y = 28
	},
/obj/structure/rack,
/obj/item/ammo_box/magazine/sniper_rounds,
/obj/item/ammo_box/magazine/sniper_rounds,
/obj/item/ammo_box/magazine/sniper_rounds/soporific,
/obj/item/ammo_box/magazine/sniper_rounds/soporific,
/obj/item/ammo_box/magazine/sniper_rounds/soporific,
/obj/item/ammo_box/magazine/sniper_rounds/soporific,
/turf/open/floor/iron,
/area/station/command/bridge)
"xb" = (
/turf/closed/wall,
/area/station/command/bridge)
"xj" = (
/obj/machinery/power/port_gen/pacman,
/obj/structure/cable,
/obj/machinery/atmospherics/pipe/smart/manifold4w/scrubbers/hidden/layer2,
/turf/open/floor/plating,
/area/station/maintenance/aft)
"xw" = (
/obj/structure/fans/tiny,
/obj/machinery/door/poddoor{
	id = "irishdoors";
	name = "Cargo Bay Blast Door"
	},
/obj/docking_port/mobile{
	can_move_docking_ports = 1;
	dir = 2;
	launch_status = 0;
	name = "mining ship";
	port_direction = 8;
	preferred_direction = 4
	},
/turf/open/floor/plating,
/area/station/cargo)
"xI" = (
/obj/machinery/door/poddoor{
	id = "irishvent";
	name = "Ordnance Vent"
	},
/turf/open/floor/engine,
/area/station/science)
"xW" = (
/obj/machinery/door/airlock/research/glass/incinerator,
/turf/open/floor/iron,
/area/station/science)
"xZ" = (
/obj/machinery/portable_atmospherics/canister/oxygen,
/turf/open/floor/plating,
/area/station/maintenance/aft)
"yA" = (
/turf/closed/wall,
/area/station/medical)
"yU" = (
/obj/structure/cable,
/obj/machinery/atmospherics/pipe/smart/manifold4w/scrubbers/hidden/layer2,
/turf/open/floor/plating,
/area/station/maintenance/aft)
"yY" = (
/obj/machinery/atmospherics/pipe/smart/manifold4w/scrubbers/hidden/layer2,
/turf/open/floor/iron,
/area/station/commons/storage/primary)
"zg" = (
/obj/structure/grille,
/obj/structure/window/reinforced/fulltile,
/turf/open/floor/plating,
/area/station/maintenance/aft)
"zm" = (
/obj/machinery/computer/helm{
	dir = 8
	},
/turf/open/floor/iron,
/area/station/command/bridge)
"Ar" = (
/obj/machinery/atmospherics/components/unary/vent_scrubber/on/layer2,
/turf/open/floor/iron,
/area/station/science)
"Az" = (
/obj/machinery/atmospherics/pipe/smart/manifold4w/supply/hidden/layer4,
/obj/machinery/atmospherics/pipe/smart/manifold4w/scrubbers/hidden/layer2,
/obj/structure/cable,
/obj/machinery/door/airlock/research,
/turf/open/floor/iron,
/area/station/science)
"AM" = (
/turf/open/floor/iron,
/area/station/science)
"AP" = (
/obj/machinery/portable_atmospherics/canister/plasma,
/obj/machinery/light/small{
	dir = 1
	},
/turf/open/floor/plating,
/area/station/maintenance/aft)
"Bh" = (
/turf/open/floor/iron,
/area/station/medical)
"BE" = (
/obj/structure/rack,
/obj/item/gun/ballistic/automatic/sniper_rifle,
/obj/item/gun/ballistic/automatic/sniper_rifle,
/turf/open/floor/iron,
/area/station/command/bridge)
"BV" = (
/obj/machinery/atmospherics/pipe/smart/manifold4w/supply/hidden/layer4,
/turf/open/floor/iron,
/area/station/science)
"BY" = (
/obj/machinery/portable_atmospherics/canister/oxygen,
/obj/machinery/light/small,
/turf/open/floor/plating,
/area/station/maintenance/aft)
"CN" = (
/obj/structure/tank_dispenser,
/turf/open/floor/iron,
/area/station/science)
"CR" = (
/obj/machinery/doppler_array,
/obj/machinery/power/apc/auto_name/directional/south,
/obj/structure/cable,
/turf/open/floor/iron,
/area/station/science)
"Dp" = (
/turf/closed/wall,
/area/station/cargo)
"DZ" = (
/obj/structure/window/reinforced/spawner/west,
/obj/structure/window/reinforced/spawner/north,
/obj/structure/rack,
/obj/item/assembly/igniter,
/obj/item/assembly/igniter,
/obj/item/assembly/igniter,
/obj/item/assembly/igniter,
/turf/open/floor/iron,
/area/station/commons/storage/primary)
"Ep" = (
/obj/machinery/atmospherics/components/unary/vent_pump/on/layer4{
	dir = 4
	},
/turf/open/floor/iron,
/area/station/science)
"Ex" = (
/obj/machinery/computer/crew{
	dir = 8
	},
/turf/open/floor/iron,
/area/station/command/bridge)
"Fh" = (
/obj/structure/table/reinforced,
/obj/item/grenade/chem_grenade/large,
/obj/item/grenade/chem_grenade/large,
/obj/item/grenade/chem_grenade/large,
/obj/item/grenade/chem_grenade/large,
/obj/item/grenade/chem_grenade/large,
/obj/item/stack/cable_coil,
/obj/item/screwdriver,
/turf/open/floor/iron,
/area/station/medical)
"Fj" = (
/obj/machinery/power/apc/auto_name/directional/west,
/turf/open/floor/plating,
/area/station/maintenance/aft)
"Fu" = (
/obj/structure/window/reinforced/spawner/north,
/obj/structure/rack,
/obj/item/storage/belt/utility/full/engi,
/obj/item/storage/belt/utility/full/engi,
/turf/open/floor/iron,
/area/station/commons/storage/primary)
"Gp" = (
/obj/machinery/atmospherics/components/unary/vent_pump/on/layer4{
	dir = 8
	},
/obj/structure/cable,
/obj/machinery/airalarm/directional/north,
/turf/open/floor/iron,
/area/station/cargo)
"GB" = (
/obj/machinery/button/door{
	id = "irishdoors";
	name = "Cargo Bay Shutters";
	pixel_x = 26
	},
/obj/machinery/suit_storage_unit/mining/eva,
/turf/open/floor/iron,
/area/station/cargo)
"Ia" = (
/obj/structure/cable,
/turf/closed/wall,
/area/station/maintenance/aft)
"Im" = (
/obj/machinery/atmospherics/pipe/layer_manifold/supply,
/turf/open/floor/plating,
/area/station/maintenance/aft)
"Iz" = (
/obj/structure/cable,
/obj/machinery/power/terminal{
	dir = 8
	},
/turf/open/floor/plating,
/area/station/maintenance/aft)
"IE" = (
/obj/machinery/mineral/ore_redemption{
	dir = 1
	},
/turf/open/floor/iron,
/area/station/cargo)
"KI" = (
/obj/structure/grille,
/obj/structure/window/reinforced/fulltile,
/turf/open/floor/plating,
/area/station/medical)
"KJ" = (
/obj/machinery/power/shuttle/engine/electric{
	dir = 4
	},
/obj/structure/cable,
/turf/open/floor/plating,
/area/template_noop)
"La" = (
/obj/machinery/atmospherics/pipe/smart/manifold4w/supply/hidden/layer4,
/obj/machinery/atmospherics/pipe/smart/manifold4w/scrubbers/hidden/layer2,
/obj/structure/cable,
/obj/machinery/light/small{
	dir = 8
	},
/turf/open/floor/iron,
/area/station/commons/storage/primary)
"Lb" = (
/obj/item/food/canned/beans{
	pixel_x = -5;
	pixel_y = 3
	},
/obj/item/food/canned/beans{
	pixel_x = 2;
	pixel_y = 3
	},
/obj/item/food/canned/beans{
	pixel_x = -2
	},
/obj/item/reagent_containers/cup/glass/waterbottle/large{
	pixel_x = 5
	},
/obj/item/reagent_containers/cup/glass/waterbottle/large{
	pixel_x = 1;
	pixel_y = -3
	},
/obj/item/reagent_containers/cup/glass/waterbottle/large{
	pixel_x = 8;
	pixel_y = -3
	},
/obj/structure/closet/crate{
	name = "food crate"
	},
/obj/item/storage/cans/sixbeer,
/obj/item/food/rationpack,
/obj/item/food/rationpack,
/obj/item/food/rationpack,
/obj/item/food/rationpack,
/obj/item/food/rationpack,
/obj/item/food/rationpack,
/turf/open/floor/iron,
/area/station/science)
"Lw" = (
/obj/machinery/atmospherics/pipe/smart/manifold4w/scrubbers/hidden/layer2,
/turf/closed/wall,
/area/station/maintenance/aft)
"LU" = (
/obj/machinery/atmospherics/pipe/smart/manifold4w/supply/hidden/layer4,
/obj/machinery/atmospherics/pipe/smart/manifold4w/scrubbers/hidden/layer2,
/obj/structure/cable,
/turf/open/floor/iron,
/area/station/medical)
"Ml" = (
/obj/machinery/atmospherics/components/unary/outlet_injector/on/layer2{
	dir = 1
	},
/turf/open/floor/plating,
/area/station/maintenance/aft)
"Mo" = (
/obj/machinery/power/terminal{
	dir = 8
	},
/obj/structure/cable,
/turf/open/floor/plating,
/area/station/maintenance/aft)
"Mu" = (
/obj/structure/window/reinforced,
/obj/structure/rack,
/obj/item/assembly/voice,
/obj/item/assembly/voice,
/obj/item/assembly/voice,
/obj/item/assembly/voice,
/obj/machinery/atmospherics/pipe/smart/manifold4w/supply/hidden/layer4,
/obj/machinery/atmospherics/pipe/smart/manifold4w/scrubbers/hidden/layer2,
/obj/structure/cable,
/turf/open/floor/iron,
/area/station/commons/storage/primary)
"MQ" = (
/obj/machinery/atmospherics/pipe/smart/manifold4w/supply/hidden/layer4,
/obj/machinery/atmospherics/pipe/smart/manifold4w/scrubbers/hidden/layer2,
/obj/structure/cable,
/obj/machinery/door/airlock/mining/glass,
/turf/open/floor/iron,
/area/station/cargo)
"Nr" = (
/obj/machinery/chem_heater,
/turf/open/floor/iron,
/area/station/medical)
"Nx" = (
/obj/structure/rack,
/obj/item/storage/bag/ore,
/obj/item/storage/bag/ore,
/obj/item/storage/bag/ore,
/obj/item/pickaxe/silver,
/obj/item/pickaxe/silver,
/obj/item/pickaxe/silver,
/obj/item/t_scanner/adv_mining_scanner/lesser,
/obj/item/t_scanner/adv_mining_scanner/lesser,
/obj/item/t_scanner/adv_mining_scanner/lesser,
/obj/item/extraction_pack,
/obj/item/extraction_pack,
/obj/machinery/light/small{
	dir = 8
	},
/turf/open/floor/iron,
/area/station/cargo)
"NB" = (
/obj/machinery/atmospherics/pipe/smart/manifold4w/supply/hidden/layer4,
/obj/machinery/atmospherics/pipe/smart/manifold4w/scrubbers/hidden/layer2,
/obj/structure/cable,
/obj/machinery/airalarm/directional/west,
/turf/open/floor/iron,
/area/station/commons/storage/primary)
"Ob" = (
/obj/machinery/portable_atmospherics/pump,
/turf/open/floor/iron,
/area/station/science)
"Oq" = (
/obj/machinery/atmospherics/pipe/smart/manifold4w/supply/hidden/layer4,
/obj/machinery/atmospherics/pipe/smart/manifold4w/scrubbers/hidden/layer2,
/obj/structure/cable,
/turf/open/floor/iron,
/area/station/science)
"Px" = (
/obj/machinery/atmospherics/pipe/smart/manifold4w/supply/hidden/layer4,
/obj/machinery/atmospherics/pipe/smart/manifold4w/scrubbers/hidden/layer2,
/obj/structure/cable,
/turf/open/floor/iron,
/area/station/cargo)
"PN" = (
/obj/structure/window/reinforced/spawner/east,
/obj/structure/window/reinforced,
/obj/structure/rack,
/obj/item/assembly/timer,
/obj/item/assembly/timer,
/obj/item/assembly/timer,
/obj/item/assembly/timer,
/turf/open/floor/iron,
/area/station/commons/storage/primary)
"PP" = (
/obj/machinery/atmospherics/components/unary/thermomachine/heater,
/turf/open/floor/iron,
/area/station/science)
"PX" = (
/obj/machinery/power/shuttle/engine/electric{
	dir = 4
	},
/obj/structure/cable,
/turf/open/floor/plating,
/area/station/external)
"Sj" = (
/obj/machinery/cryopod,
/obj/machinery/computer/cryopod{
	pixel_y = -24
	},
/turf/open/floor/iron,
/area/station/science)
"Sl" = (
/obj/machinery/atmospherics/pipe/smart/manifold4w/scrubbers/hidden/layer2,
/turf/open/floor/iron,
/area/station/cargo)
"Tw" = (
/obj/machinery/portable_atmospherics/canister/plasma,
/turf/open/floor/plating,
/area/station/maintenance/aft)
"Vp" = (
/obj/machinery/airalarm/directional/north,
/obj/machinery/light/small{
	dir = 1
	},
/obj/structure/rack,
/obj/item/suppressor,
/obj/item/suppressor,
/turf/open/floor/iron,
/area/station/command/bridge)
"Vt" = (
/obj/structure/cable,
/obj/machinery/atmospherics/components/unary/vent_scrubber/on/layer2{
	dir = 1
	},
/turf/open/floor/iron,
/area/station/command/bridge)
"VH" = (
/obj/machinery/power/apc/auto_name/directional/south,
/obj/structure/cable,
/obj/machinery/light/small,
/turf/open/floor/iron,
/area/station/command/bridge)
"Wq" = (
/obj/machinery/igniter{
	id = "toxins"
	},
/turf/open/floor/engine,
/area/station/science)
"Xq" = (
/obj/machinery/chem_master,
/turf/open/floor/iron,
/area/station/medical)
"XV" = (
/turf/closed/wall,
/area/station/maintenance/aft)
"YH" = (
/obj/structure/rack,
/obj/item/reagent_containers/cup/beaker/large,
/obj/item/reagent_containers/cup/beaker/large,
/obj/item/reagent_containers/cup/beaker/large,
/obj/item/reagent_containers/cup/beaker/large,
/obj/item/reagent_containers/cup/beaker/large,
/obj/item/reagent_containers/cup/beaker/large,
/turf/open/floor/iron,
/area/station/medical)
"Zj" = (
/obj/machinery/power/smes/engineering{
	dir = 4
	},
/obj/structure/window/reinforced/spawner/west,
/obj/machinery/door/window/left/directional/east,
/obj/structure/cable,
/turf/open/floor/plating,
/area/station/maintenance/aft)
"ZC" = (
/obj/machinery/button/door{
	id = "irishvent";
	name = "Vent Button";
	pixel_y = 24
	},
/obj/machinery/portable_atmospherics/pump,
/obj/machinery/button/ignition{
	id = "toxins";
	name = "Igniter button";
	pixel_y = 34
	},
/turf/open/floor/iron,
/area/station/science)
"ZD" = (
/obj/machinery/atmospherics/pipe/smart/manifold4w/scrubbers/hidden/layer2,
/turf/open/floor/iron,
/area/station/science)

(1,1,1) = {"
fo
fo
fo
fo
da
fo
PX
KJ
PX
KJ
fJ
fo
da
fo
fo
fo
fo
"}
(2,1,1) = {"
fo
fo
XV
XV
XV
XV
Zj
zg
Zj
zg
lH
XV
XV
XV
XV
fo
fo
"}
(3,1,1) = {"
fo
fo
XV
Tw
Tw
Fj
Mo
vO
Iz
rc
Iz
xZ
xZ
xZ
XV
fo
fo
"}
(4,1,1) = {"
fo
fo
XV
AP
Tw
hm
hm
hm
rc
hm
hm
xZ
xZ
BY
XV
fo
fo
"}
(5,1,1) = {"
fo
fo
XV
wk
hm
hm
hm
hm
yU
sE
qY
xj
tX
tX
Lw
Ml
fo
"}
(6,1,1) = {"
ss
xI
ss
ss
ss
ss
qQ
Im
eo
uw
vP
Dp
Dp
Dp
Dp
Dp
Dp
"}
(7,1,1) = {"
ss
Wq
tC
tC
tC
ss
XV
XV
re
Ia
XV
Dp
tF
Nx
tF
jI
pf
"}
(8,1,1) = {"
ss
tC
tC
mw
tC
ss
NB
La
fi
fi
fi
MQ
Px
Sl
hC
jI
xw
"}
(9,1,1) = {"
ss
ss
xW
ss
ss
ss
tj
DZ
fi
bm
rx
Dp
Gp
jI
jI
jI
pf
"}
(10,1,1) = {"
ss
ZC
AM
AM
CR
ss
fi
cB
fi
kv
rx
IE
hn
tk
GB
jI
pf
"}
(11,1,1) = {"
ss
Ob
AM
Ep
po
ss
fi
fi
fi
yY
ru
yA
yA
yA
yA
yA
yA
"}
(12,1,1) = {"
fS
rl
AM
BV
Oq
Az
kt
Fu
fi
Mu
fi
gL
LU
uc
YH
Xq
KI
"}
(13,1,1) = {"
fS
PP
AM
AM
aP
fS
rx
dE
fi
PN
rx
yA
ub
Bh
ir
cH
KI
"}
(14,1,1) = {"
fS
Ar
ZD
ZD
hI
fS
rx
lD
fi
rx
rx
yA
hb
Fh
rK
Nr
KI
"}
(15,1,1) = {"
fS
bv
Lb
CN
Sj
ss
xb
xb
ps
xb
xb
yA
KI
KI
KI
KI
yA
"}
(16,1,1) = {"
ss
ss
ss
ss
ss
ss
fL
rq
qc
np
np
xb
fo
fo
fo
fo
fo
"}
(17,1,1) = {"
fo
fo
fo
fo
fo
xb
Vp
sI
ud
Vt
VH
xb
fo
fo
fo
fo
fo
"}
(18,1,1) = {"
fo
fo
fo
fo
fo
xb
wr
BE
zm
Ex
nN
xb
fo
fo
fo
fo
fo
"}
(19,1,1) = {"
fo
fo
fo
fo
fo
xb
ai
ai
ai
ai
ai
xb
fo
fo
fo
fo
fo
"}
