//MAP CONVERTED BY dmm2tgm.py THIS HEADER COMMENT PREVENTS RECONVERSION, DO NOT REMOVE
"aJ" = (
/turf/closed/wall/mineral/titanium/nodiagonal,
/area/station/commons/dorms)
"bi" = (
/obj/machinery/atmospherics/pipe/smart/manifold4w/orange/visible,
/turf/open/floor/plating,
/area/station/maintenance/aft)
"bk" = (
/obj/structure/cable,
/obj/machinery/atmospherics/pipe/smart/manifold4w/supply/hidden/layer4,
/obj/machinery/atmospherics/pipe/smart/manifold4w/scrubbers/hidden/layer2,
/turf/open/floor/mineral/titanium,
/area/station/security)
"bL" = (
/obj/structure/weightmachine/weightlifter,
/obj/effect/turf_decal/tile/lime/mono,
/obj/structure/window/reinforced/spawner/east,
/turf/open/floor/mineral/titanium,
/area/station/commons/dorms)
"cJ" = (
/obj/effect/turf_decal/tile/red/mono,
/obj/machinery/vending/security,
/turf/open/floor/mineral/titanium,
/area/station/ai_monitored/security/armory)
"cM" = (
/obj/effect/turf_decal/tile/lime/mono,
/obj/structure/table/reinforced,
/obj/item/food/pizza/meat/raw,
/turf/open/floor/mineral/titanium,
/area/station/commons/dorms)
"dh" = (
/obj/structure/grille,
/obj/structure/window/reinforced/shuttle,
/turf/open/floor/plating,
/area/station/command/bridge)
"dm" = (
/obj/effect/turf_decal/tile/blue,
/obj/machinery/power/apc/auto_name/directional/east,
/obj/structure/cable,
/turf/open/floor/mineral/titanium,
/area/station/commons/dorms)
"dy" = (
/obj/structure/rack,
/obj/effect/turf_decal/tile/red/mono,
/obj/machinery/airalarm/directional/south,
/obj/item/gun/ballistic/shotgun/riot,
/obj/item/gun/ballistic/shotgun/riot,
/turf/open/floor/mineral/titanium,
/area/station/ai_monitored/security/armory)
"dB" = (
/obj/machinery/atmospherics/pipe/smart/manifold4w/scrubbers/hidden/layer2,
/turf/open/floor/mineral/titanium,
/area/station/commons/dorms)
"dH" = (
/obj/effect/turf_decal/tile/yellow/mono,
/obj/machinery/computer/mech_bay_power_console,
/turf/open/floor/mineral/titanium,
/area/station/cargo)
"dJ" = (
/obj/machinery/atmospherics/pipe/smart/manifold4w/orange/visible,
/obj/structure/cable,
/turf/open/floor/plating,
/area/station/maintenance/aft)
"dK" = (
/obj/effect/turf_decal/tile/bottlegreen/mono,
/obj/machinery/power/apc/auto_name/directional/south,
/obj/structure/cable,
/turf/open/floor/mineral/titanium,
/area/station/hallway/primary/central)
"dN" = (
/obj/effect/turf_decal/tile/bottlegreen/mono,
/obj/structure/cable,
/obj/machinery/atmospherics/pipe/smart/manifold4w/scrubbers/hidden/layer2,
/obj/machinery/atmospherics/pipe/smart/manifold4w/supply/hidden/layer4,
/turf/open/floor/mineral/titanium,
/area/station/hallway/primary/central)
"dS" = (
/obj/structure/grille,
/obj/structure/window/reinforced/shuttle,
/turf/open/floor/plating,
/area/station/commons/dorms)
"eO" = (
/obj/machinery/space_heater,
/obj/structure/window/reinforced/spawner/west,
/obj/machinery/door/window/right/directional/east,
/turf/open/floor/plating,
/area/station/maintenance/aft)
"eW" = (
/obj/structure/chair/office{
	dir = 4
	},
/obj/structure/cable,
/obj/machinery/atmospherics/pipe/smart/manifold4w/scrubbers/hidden/layer2,
/obj/machinery/atmospherics/components/unary/vent_pump/on/layer4{
	dir = 8
	},
/turf/open/floor/mineral/titanium,
/area/station/command/bridge)
"fy" = (
/obj/structure/cable,
/obj/machinery/atmospherics/pipe/smart/manifold4w/supply/hidden/layer4,
/obj/machinery/atmospherics/pipe/smart/manifold4w/scrubbers/hidden/layer2,
/obj/effect/turf_decal/tile/lime/mono,
/obj/machinery/door/airlock{
	name = "Dormitories"
	},
/turf/open/floor/mineral/titanium,
/area/station/commons/dorms)
"fC" = (
/obj/effect/turf_decal/tile/yellow/mono,
/obj/machinery/button/door{
	id = "cargodoors";
	name = "Blast Door Control";
	pixel_x = 24
	},
/turf/open/floor/mineral/titanium,
/area/station/cargo)
"gp" = (
/obj/effect/turf_decal/tile/bottlegreen/mono,
/obj/machinery/atmospherics/components/unary/vent_pump/on/layer4{
	dir = 1
	},
/turf/open/floor/mineral/titanium,
/area/station/hallway/primary/central)
"gJ" = (
/obj/machinery/atmospherics/pipe/smart/manifold4w/scrubbers/hidden/layer2,
/turf/closed/wall/mineral/titanium,
/area/station/security)
"hc" = (
/obj/machinery/door/poddoor{
	id = "cargodoors";
	name = "Cargo Bay Blast Door"
	},
/obj/structure/fans/tiny,
/turf/open/floor/plating,
/area/station/cargo)
"hm" = (
/obj/effect/turf_decal/tile/yellow/mono,
/turf/open/floor/mineral/titanium,
/area/station/cargo)
"hx" = (
/turf/closed/wall/mineral/titanium,
/area/station/security)
"hJ" = (
/obj/machinery/atmospherics/pipe/smart/manifold4w/supply/hidden/layer4,
/turf/open/floor/mineral/titanium,
/area/station/cargo)
"hU" = (
/obj/effect/turf_decal/tile/red/mono,
/obj/structure/cable,
/obj/machinery/atmospherics/pipe/smart/manifold4w/supply/hidden/layer4,
/obj/machinery/atmospherics/pipe/smart/manifold4w/scrubbers/hidden/layer2,
/turf/open/floor/mineral/titanium,
/area/station/ai_monitored/security/armory)
"in" = (
/obj/structure/cable,
/obj/machinery/atmospherics/pipe/smart/manifold4w/supply/hidden/layer4,
/obj/machinery/atmospherics/pipe/smart/manifold4w/scrubbers/hidden/layer2,
/obj/effect/turf_decal/tile/red/mono,
/obj/machinery/door/airlock/security/glass,
/turf/open/floor/mineral/titanium,
/area/station/security)
"iK" = (
/obj/machinery/computer/autopilot{
	dir = 8
	},
/obj/effect/turf_decal/tile/blue,
/turf/open/floor/mineral/titanium,
/area/station/command/bridge)
"iO" = (
/obj/machinery/atmospherics/pipe/smart/manifold4w/orange/visible,
/obj/structure/cable,
/obj/machinery/light{
	dir = 4
	},
/turf/open/floor/plating,
/area/station/maintenance/aft)
"iY" = (
/obj/effect/turf_decal/tile/blue,
/obj/machinery/light{
	dir = 4
	},
/turf/open/floor/mineral/titanium,
/area/station/commons/dorms)
"jc" = (
/obj/effect/turf_decal/tile/red/mono,
/obj/structure/rack,
/obj/item/clothing/mask/gas/sechailer/swat,
/obj/item/clothing/mask/gas/sechailer/swat,
/obj/item/clothing/mask/gas/sechailer/swat,
/obj/item/clothing/mask/gas/sechailer/swat,
/obj/item/clothing/mask/gas/sechailer/swat,
/turf/open/floor/mineral/titanium,
/area/station/security)
"ka" = (
/obj/machinery/vending/security,
/obj/effect/turf_decal/tile/red/mono,
/turf/open/floor/mineral/titanium,
/area/station/ai_monitored/security/armory)
"kE" = (
/obj/structure/cable,
/obj/machinery/atmospherics/pipe/smart/manifold4w/scrubbers/hidden/layer2,
/turf/open/floor/mineral/titanium,
/area/station/security)
"kW" = (
/obj/machinery/computer/crew{
	dir = 8
	},
/obj/effect/turf_decal/tile/blue,
/turf/open/floor/mineral/titanium,
/area/station/command/bridge)
"lk" = (
/obj/effect/turf_decal/tile/yellow/mono,
/obj/structure/cable,
/obj/machinery/atmospherics/pipe/smart/manifold4w/supply/hidden/layer4,
/obj/machinery/atmospherics/pipe/smart/manifold4w/scrubbers/hidden/layer2,
/turf/open/floor/mineral/titanium,
/area/station/cargo)
"lN" = (
/obj/structure/table/optable,
/obj/effect/turf_decal/tile/blue,
/turf/open/floor/mineral/titanium,
/area/station/commons/dorms)
"me" = (
/obj/machinery/atmospherics/components/unary/vent_pump/on/layer4,
/turf/open/floor/mineral/titanium,
/area/station/security)
"mR" = (
/obj/effect/turf_decal/tile/blue,
/obj/machinery/airalarm/directional/south,
/obj/machinery/atmospherics/components/unary/vent_scrubber/on/layer2{
	dir = 1
	},
/turf/open/floor/mineral/titanium,
/area/station/command/bridge)
"nC" = (
/turf/closed/wall/mineral/titanium,
/area/station/ai_monitored/security/armory)
"nD" = (
/obj/effect/turf_decal/tile/yellow/mono,
/obj/machinery/mineral/equipment_vendor,
/obj/machinery/light{
	dir = 8
	},
/turf/open/floor/mineral/titanium,
/area/station/cargo)
"nV" = (
/obj/machinery/atmospherics/pipe/smart/manifold4w/scrubbers/hidden/layer2,
/turf/open/floor/mineral/titanium,
/area/station/cargo)
"ov" = (
/obj/structure/table/reinforced,
/obj/machinery/microwave{
	desc = "Cooks and boils stuff, somehow.";
	pixel_x = -3;
	pixel_y = 5
	},
/obj/effect/turf_decal/tile/lime/mono,
/obj/structure/window/reinforced/spawner,
/obj/effect/spawner/random/food_or_drink/donkpockets,
/obj/effect/spawner/random/food_or_drink/donkpockets,
/obj/effect/spawner/random/food_or_drink/donkpockets,
/obj/machinery/light{
	dir = 8
	},
/turf/open/floor/mineral/titanium,
/area/station/commons/dorms)
"oy" = (
/turf/closed/wall/mineral/titanium,
/area/station/maintenance/aft)
"oO" = (
/obj/structure/fans/tiny,
/obj/machinery/door/airlock/external,
/obj/docking_port/mobile{
	can_move_docking_ports = 1;
	dir = 2;
	launch_status = 0;
	name = "mining ship";
	port_direction = 8;
	preferred_direction = 4
	},
/turf/open/floor/iron,
/area/station/commons/dorms)
"oU" = (
/obj/effect/turf_decal/tile/red/mono,
/obj/machinery/atmospherics/pipe/smart/manifold4w/scrubbers/hidden/layer2,
/obj/machinery/suit_storage_unit/security,
/turf/open/floor/mineral/titanium,
/area/station/security)
"po" = (
/obj/structure/cable,
/obj/machinery/atmospherics/pipe/smart/manifold4w/supply/hidden/layer4,
/obj/machinery/atmospherics/pipe/smart/manifold4w/scrubbers/hidden/layer2,
/turf/open/floor/mineral/titanium,
/area/station/hallway/primary/central)
"pq" = (
/obj/machinery/computer/operating,
/obj/effect/turf_decal/tile/blue,
/turf/open/floor/mineral/titanium,
/area/station/commons/dorms)
"pG" = (
/turf/closed/wall/mineral/titanium,
/area/station/command/bridge)
"pO" = (
/obj/effect/turf_decal/tile/blue,
/obj/machinery/suit_storage_unit/captain,
/turf/open/floor/mineral/titanium,
/area/station/command/bridge)
"pR" = (
/obj/effect/turf_decal/tile/red/mono,
/obj/structure/cable,
/obj/machinery/atmospherics/pipe/smart/manifold4w/supply/hidden/layer4,
/obj/machinery/atmospherics/pipe/smart/manifold4w/scrubbers/hidden/layer2,
/obj/machinery/light{
	dir = 4
	},
/turf/open/floor/mineral/titanium,
/area/station/ai_monitored/security/armory)
"qj" = (
/obj/machinery/atmospherics/components/unary/vent_pump/on/layer4{
	dir = 4
	},
/turf/open/floor/mineral/titanium,
/area/station/ai_monitored/security/armory)
"qu" = (
/obj/machinery/power/terminal{
	dir = 8
	},
/obj/structure/cable,
/obj/item/tank/jetpack/suit,
/obj/structure/rack,
/turf/open/floor/plating,
/area/station/maintenance/aft)
"qJ" = (
/obj/effect/turf_decal/tile/red/mono,
/obj/machinery/light{
	dir = 4
	},
/obj/machinery/portable_atmospherics/canister/oxygen,
/turf/open/floor/mineral/titanium,
/area/station/security)
"su" = (
/obj/structure/closet/secure_closet/lethalshots{
	req_access = null
	},
/obj/effect/turf_decal/tile/red/mono,
/turf/open/floor/mineral/titanium,
/area/station/security)
"sZ" = (
/obj/effect/turf_decal/tile/bottlegreen/mono,
/obj/machinery/atmospherics/components/unary/vent_scrubber/on/layer2,
/turf/open/floor/mineral/titanium,
/area/station/hallway/primary/central)
"tj" = (
/obj/item/food/canned/beans{
	pixel_x = -5;
	pixel_y = 3
	},
/obj/item/food/canned/beans{
	pixel_x = 2;
	pixel_y = 3
	},
/obj/item/food/canned/beans{
	pixel_x = -2
	},
/obj/item/reagent_containers/cup/glass/waterbottle/large{
	pixel_x = 5
	},
/obj/item/reagent_containers/cup/glass/waterbottle/large{
	pixel_x = 1;
	pixel_y = -3
	},
/obj/item/reagent_containers/cup/glass/waterbottle/large{
	pixel_x = 8;
	pixel_y = -3
	},
/obj/structure/closet/crate{
	name = "food crate"
	},
/obj/item/storage/cans/sixbeer,
/obj/item/food/rationpack,
/obj/item/food/rationpack,
/obj/item/food/rationpack,
/obj/item/food/rationpack,
/obj/item/food/rationpack,
/obj/item/food/rationpack,
/obj/effect/turf_decal/tile/lime/mono,
/turf/open/floor/mineral/titanium,
/area/station/commons/dorms)
"tp" = (
/turf/closed/wall/mineral/titanium,
/area/station/cargo)
"tr" = (
/obj/effect/turf_decal/tile/lime/mono,
/turf/open/floor/mineral/titanium,
/area/station/commons/dorms)
"tQ" = (
/obj/machinery/atmospherics/pipe/smart/manifold4w/scrubbers/hidden/layer2,
/obj/effect/turf_decal/tile/red/mono,
/obj/machinery/suit_storage_unit/security,
/turf/open/floor/mineral/titanium,
/area/station/security)
"uj" = (
/obj/machinery/atmospherics/pipe/smart/manifold4w/supply/hidden/layer4,
/obj/machinery/atmospherics/pipe/smart/manifold4w/scrubbers/hidden/layer2,
/turf/open/floor/mineral/titanium,
/area/station/cargo)
"ur" = (
/obj/machinery/door/airlock/maintenance_hatch,
/obj/structure/cable,
/turf/open/floor/plating,
/area/station/maintenance/aft)
"uD" = (
/obj/machinery/stasis,
/obj/effect/turf_decal/tile/blue,
/obj/machinery/light{
	dir = 1
	},
/turf/open/floor/mineral/titanium,
/area/station/commons/dorms)
"uF" = (
/turf/closed/wall/mineral/titanium,
/area/station/commons/dorms)
"vq" = (
/obj/machinery/power/terminal{
	dir = 8
	},
/obj/structure/cable,
/obj/machinery/atmospherics/pipe/smart/manifold4w/orange/visible,
/turf/open/floor/plating,
/area/station/maintenance/aft)
"vN" = (
/obj/machinery/atmospherics/pipe/smart/manifold4w/supply/hidden/layer4,
/turf/open/floor/mineral/titanium,
/area/station/ai_monitored/security/armory)
"wd" = (
/obj/effect/turf_decal/tile/red/mono,
/obj/structure/cable,
/obj/machinery/atmospherics/pipe/smart/manifold4w/supply/hidden/layer4,
/obj/machinery/atmospherics/pipe/smart/manifold4w/scrubbers/hidden/layer2,
/turf/open/floor/mineral/titanium,
/area/station/security)
"wl" = (
/obj/machinery/power/smes/engineering,
/obj/structure/cable,
/turf/open/floor/plating,
/area/station/maintenance/aft)
"ww" = (
/obj/effect/turf_decal/tile/lime/mono,
/obj/structure/table/reinforced,
/obj/item/knife/plastic,
/obj/item/storage/cans/sixbeer,
/obj/machinery/airalarm/directional/south,
/turf/open/floor/mineral/titanium,
/area/station/commons/dorms)
"ya" = (
/obj/machinery/power/terminal{
	dir = 8
	},
/obj/structure/cable,
/obj/machinery/suit_storage_unit/engineering,
/turf/open/floor/plating,
/area/station/maintenance/aft)
"ym" = (
/obj/machinery/atmospherics/components/unary/vent_scrubber/on/layer2,
/turf/open/floor/mineral/titanium,
/area/station/cargo)
"zq" = (
/turf/template_noop,
/area/template_noop)
"zv" = (
/obj/structure/table/reinforced,
/obj/machinery/recharger,
/obj/effect/turf_decal/tile/blue,
/obj/machinery/light{
	dir = 8
	},
/obj/item/gun/energy/laser/captain,
/obj/item/radio/intercom{
	pixel_x = -26
	},
/turf/open/floor/mineral/titanium,
/area/station/command/bridge)
"zL" = (
/obj/machinery/power/terminal{
	dir = 8
	},
/obj/structure/cable,
/turf/open/floor/plating,
/area/station/maintenance/aft)
"zQ" = (
/obj/effect/turf_decal/tile/red/mono,
/obj/machinery/light{
	dir = 8
	},
/turf/open/floor/mineral/titanium,
/area/station/ai_monitored/security/armory)
"Aa" = (
/obj/machinery/cryopod{
	dir = 4
	},
/obj/effect/turf_decal/tile/lime/mono,
/turf/open/floor/mineral/titanium,
/area/station/commons/dorms)
"AA" = (
/obj/machinery/atmospherics/pipe/smart/manifold4w/supply/hidden/layer4,
/turf/open/floor/mineral/titanium,
/area/station/security)
"BS" = (
/obj/machinery/power/terminal{
	dir = 8
	},
/obj/structure/cable,
/obj/machinery/power/port_gen/pacman,
/turf/open/floor/plating,
/area/station/maintenance/aft)
"Cj" = (
/obj/effect/turf_decal/tile/yellow/mono,
/obj/structure/rack,
/obj/item/t_scanner/adv_mining_scanner/lesser,
/obj/item/t_scanner/adv_mining_scanner/lesser,
/obj/item/t_scanner/adv_mining_scanner/lesser,
/obj/item/t_scanner/adv_mining_scanner/lesser,
/turf/open/floor/mineral/titanium,
/area/station/cargo)
"Cu" = (
/obj/machinery/atmospherics/pipe/smart/manifold4w/supply/hidden/layer4,
/obj/effect/turf_decal/tile/red/mono,
/obj/structure/tank_dispenser/oxygen,
/turf/open/floor/mineral/titanium,
/area/station/security)
"Cv" = (
/obj/effect/turf_decal/tile/yellow/mono,
/obj/machinery/airalarm/directional/west,
/turf/open/floor/mineral/titanium,
/area/station/cargo)
"Dd" = (
/obj/structure/cable,
/obj/machinery/atmospherics/pipe/smart/manifold4w/supply/hidden/layer4,
/obj/machinery/atmospherics/pipe/smart/manifold4w/scrubbers/hidden/layer2,
/turf/open/floor/mineral/titanium,
/area/station/commons/dorms)
"Dk" = (
/obj/structure/table/reinforced,
/obj/machinery/recharger,
/obj/effect/turf_decal/tile/red/mono,
/turf/open/floor/mineral/titanium,
/area/station/security)
"Dy" = (
/obj/machinery/atmospherics/pipe/smart/manifold4w/supply/hidden/layer4,
/obj/machinery/atmospherics/pipe/smart/manifold4w/scrubbers/hidden/layer2,
/turf/open/floor/mineral/titanium,
/area/station/security)
"Ei" = (
/obj/structure/rack,
/obj/item/storage/medkit/brute,
/obj/item/storage/medkit/fire,
/obj/item/storage/medkit/toxin,
/obj/item/storage/medkit/advanced,
/obj/effect/turf_decal/tile/blue,
/obj/item/defibrillator/loaded,
/turf/open/floor/mineral/titanium,
/area/station/commons/dorms)
"EN" = (
/obj/effect/turf_decal/tile/red/mono,
/obj/machinery/light{
	dir = 8
	},
/turf/open/floor/mineral/titanium,
/area/station/security)
"Fc" = (
/obj/structure/table/reinforced,
/obj/item/storage/backpack/duffelbag/med/surgery,
/obj/effect/turf_decal/tile/blue,
/turf/open/floor/mineral/titanium,
/area/station/commons/dorms)
"Ff" = (
/obj/effect/turf_decal/tile/yellow/mono,
/obj/machinery/mech_bay_recharge_port{
	dir = 2
	},
/turf/open/floor/mineral/titanium,
/area/station/cargo)
"Gm" = (
/obj/machinery/power/apc/auto_name/directional/north,
/obj/structure/cable,
/obj/machinery/holopad,
/turf/open/floor/mineral/titanium,
/area/station/command/bridge)
"Gw" = (
/obj/effect/turf_decal/tile/red/mono,
/obj/machinery/suit_storage_unit/security,
/turf/open/floor/mineral/titanium,
/area/station/security)
"Gy" = (
/obj/structure/cable,
/turf/open/floor/mineral/titanium,
/area/station/commons/dorms)
"GG" = (
/obj/effect/turf_decal/tile/blue,
/obj/structure/cable,
/obj/machinery/atmospherics/pipe/smart/manifold4w/supply/hidden/layer4,
/obj/machinery/atmospherics/pipe/smart/manifold4w/scrubbers/hidden/layer2,
/turf/open/floor/mineral/titanium,
/area/station/command/bridge)
"HM" = (
/obj/effect/turf_decal/tile/red/mono,
/obj/machinery/airalarm/directional/south,
/obj/structure/rack,
/obj/item/tank/jetpack/oxygen/security,
/obj/item/tank/jetpack/oxygen/security,
/obj/item/tank/jetpack/oxygen/security,
/obj/item/tank/jetpack/oxygen/security,
/obj/item/tank/jetpack/oxygen/security,
/turf/open/floor/mineral/titanium,
/area/station/security)
"Ij" = (
/obj/structure/cable,
/turf/open/floor/plating,
/area/station/maintenance/aft)
"Im" = (
/obj/structure/cable,
/obj/structure/closet/crate,
/obj/item/am_containment,
/obj/item/am_containment,
/obj/item/am_containment,
/obj/item/am_containment,
/obj/item/am_containment,
/obj/item/am_containment,
/obj/item/am_containment,
/obj/item/am_containment,
/obj/item/stack/sheet/mineral/plasma/thirty,
/turf/open/floor/plating,
/area/station/maintenance/aft)
"Iv" = (
/turf/open/floor/mineral/titanium,
/area/station/commons/dorms)
"IW" = (
/obj/machinery/power/smes/engineering{
	dir = 4
	},
/obj/structure/window/reinforced/spawner/west,
/obj/machinery/door/window/left/directional/east,
/obj/structure/cable,
/turf/open/floor/plating,
/area/station/maintenance/aft)
"Km" = (
/obj/structure/rack,
/obj/effect/turf_decal/tile/red/mono,
/turf/open/floor/mineral/titanium,
/area/station/ai_monitored/security/armory)
"KW" = (
/obj/machinery/atmospherics/components/unary/vent_scrubber/on/layer2{
	dir = 1
	},
/obj/structure/chair/sofa/corner,
/turf/open/floor/mineral/titanium,
/area/station/commons/dorms)
"KX" = (
/obj/effect/turf_decal/tile/bottlegreen/mono,
/obj/machinery/atmospherics/pipe/smart/manifold4w/supply/hidden/layer4,
/obj/machinery/atmospherics/pipe/smart/manifold4w/scrubbers/hidden/layer2,
/obj/structure/cable,
/turf/open/floor/mineral/titanium,
/area/station/hallway/primary/central)
"LK" = (
/obj/machinery/power/am_control_unit,
/obj/structure/cable,
/turf/open/floor/plating,
/area/station/maintenance/aft)
"LT" = (
/obj/structure/cable,
/obj/machinery/atmospherics/components/unary/vent_pump/on/layer4{
	dir = 8
	},
/turf/open/floor/mineral/titanium,
/area/station/commons/dorms)
"MH" = (
/obj/machinery/atmospherics/components/unary/outlet_injector/on/layer2,
/turf/open/floor/plating,
/area/station/security)
"MQ" = (
/obj/machinery/power/shuttle/engine/fueled/plasma{
	dir = 4
	},
/turf/open/floor/plating,
/area/station/external)
"Ns" = (
/obj/effect/turf_decal/tile/red/mono,
/turf/open/floor/mineral/titanium,
/area/station/ai_monitored/security/armory)
"NT" = (
/obj/effect/turf_decal/tile/bottlegreen/mono,
/obj/structure/cable,
/obj/machinery/atmospherics/pipe/smart/manifold4w/supply/hidden/layer4,
/obj/machinery/atmospherics/pipe/smart/manifold4w/scrubbers/hidden/layer2,
/turf/open/floor/mineral/titanium,
/area/station/hallway/primary/central)
"Oa" = (
/obj/machinery/power/shuttle/engine/electric{
	dir = 4
	},
/obj/structure/cable,
/turf/open/floor/plating,
/area/station/external)
"OI" = (
/obj/effect/turf_decal/tile/lime/mono,
/obj/structure/cable,
/obj/machinery/atmospherics/pipe/smart/manifold4w/supply/hidden/layer4,
/obj/machinery/atmospherics/pipe/smart/manifold4w/scrubbers/hidden/layer2,
/turf/open/floor/mineral/titanium,
/area/station/commons/dorms)
"OQ" = (
/obj/machinery/atmospherics/components/unary/vent_scrubber/on/layer2{
	dir = 1
	},
/turf/open/floor/mineral/titanium,
/area/station/security)
"OZ" = (
/obj/structure/cable,
/obj/machinery/atmospherics/pipe/smart/manifold4w/supply/hidden/layer4,
/obj/machinery/atmospherics/pipe/smart/manifold4w/scrubbers/hidden/layer2,
/obj/machinery/door/airlock/mining/glass,
/obj/effect/turf_decal/tile/yellow/mono,
/turf/open/floor/mineral/titanium,
/area/station/cargo)
"Pc" = (
/obj/effect/turf_decal/tile/bottlegreen/mono,
/turf/open/floor/mineral/titanium,
/area/station/hallway/primary/central)
"PN" = (
/obj/effect/turf_decal/tile/bottlegreen/mono,
/obj/machinery/airalarm/directional/north,
/turf/open/floor/mineral/titanium,
/area/station/hallway/primary/central)
"Qb" = (
/obj/structure/cable,
/obj/structure/rack,
/obj/item/storage/belt/utility/full/engi,
/obj/item/storage/belt/utility/full/engi,
/obj/item/storage/belt/utility/full/engi,
/obj/item/clothing/gloves/color/yellow,
/obj/item/clothing/gloves/color/yellow,
/obj/item/clothing/gloves/color/yellow,
/turf/open/floor/plating,
/area/station/maintenance/aft)
"Ss" = (
/obj/effect/turf_decal/tile/yellow/mono,
/obj/machinery/power/apc/auto_name/directional/south,
/obj/structure/cable,
/turf/open/floor/mineral/titanium,
/area/station/cargo)
"SC" = (
/obj/effect/turf_decal/tile/lime/mono,
/obj/machinery/computer/cryopod{
	pixel_y = 32
	},
/turf/open/floor/mineral/titanium,
/area/station/commons/dorms)
"SG" = (
/turf/closed/wall/mineral/titanium/nodiagonal,
/area/station/cargo)
"SQ" = (
/obj/machinery/atmospherics/components/tank/air{
	dir = 1;
	piping_layer = 4
	},
/obj/effect/turf_decal/tile/red/mono,
/turf/open/floor/mineral/titanium,
/area/station/security)
"SS" = (
/turf/open/floor/mineral/titanium,
/area/station/security)
"Tj" = (
/obj/structure/cable,
/obj/machinery/atmospherics/pipe/smart/manifold4w/supply/hidden/layer4,
/obj/machinery/atmospherics/pipe/smart/manifold4w/scrubbers/hidden/layer2,
/obj/effect/turf_decal/tile/blue,
/obj/machinery/door/airlock/command/glass,
/turf/open/floor/mineral/titanium,
/area/station/command/bridge)
"TK" = (
/turf/closed/wall/mineral/titanium/nodiagonal,
/area/station/maintenance/aft)
"Vc" = (
/obj/effect/turf_decal/tile/red/mono,
/obj/machinery/power/apc/auto_name/directional/east,
/obj/structure/cable,
/turf/open/floor/mineral/titanium,
/area/station/security)
"Vg" = (
/obj/effect/turf_decal/tile/red/mono,
/obj/structure/table/reinforced,
/obj/machinery/recharger,
/turf/open/floor/mineral/titanium,
/area/station/ai_monitored/security/armory)
"Vi" = (
/obj/effect/turf_decal/tile/yellow/mono,
/obj/machinery/ore_silo,
/turf/open/floor/mineral/titanium,
/area/station/cargo)
"Vl" = (
/turf/open/floor/mineral/titanium,
/area/station/cargo)
"Vs" = (
/obj/effect/turf_decal/tile/blue,
/obj/structure/closet/crate/freezer/blood,
/turf/open/floor/mineral/titanium,
/area/station/commons/dorms)
"Vx" = (
/obj/effect/turf_decal/tile/bottlegreen/mono,
/obj/machinery/light,
/turf/open/floor/mineral/titanium,
/area/station/hallway/primary/central)
"VV" = (
/turf/open/floor/mineral/titanium,
/area/station/ai_monitored/security/armory)
"Ww" = (
/obj/machinery/am_shielding,
/turf/open/floor/plating,
/area/station/maintenance/aft)
"WR" = (
/obj/machinery/atmospherics/components/tank/plasma{
	dir = 8
	},
/turf/open/floor/plating,
/area/station/maintenance/aft)
"WY" = (
/obj/effect/turf_decal/tile/yellow/mono,
/obj/structure/rack,
/obj/item/pickaxe/silver,
/obj/item/pickaxe/silver,
/obj/item/pickaxe/silver,
/obj/item/pickaxe/silver,
/obj/item/storage/bag/ore,
/obj/item/storage/bag/ore,
/obj/item/storage/bag/ore,
/obj/item/storage/bag/ore,
/obj/machinery/light{
	dir = 4
	},
/turf/open/floor/mineral/titanium,
/area/station/cargo)
"Xc" = (
/obj/effect/turf_decal/tile/lime/mono,
/obj/structure/chair/sofa/corner{
	dir = 4
	},
/turf/open/floor/mineral/titanium,
/area/station/commons/dorms)
"Xr" = (
/obj/structure/rack,
/obj/effect/turf_decal/tile/red/mono,
/obj/item/gun/energy/e_gun,
/obj/item/gun/energy/e_gun,
/turf/open/floor/mineral/titanium,
/area/station/ai_monitored/security/armory)
"Xz" = (
/obj/machinery/atmospherics/pipe/smart/manifold4w/orange/visible,
/obj/machinery/power/apc/auto_name/directional/south,
/obj/structure/cable,
/obj/machinery/light{
	dir = 4
	},
/turf/open/floor/plating,
/area/station/maintenance/aft)
"XM" = (
/obj/effect/turf_decal/tile/red/mono,
/obj/machinery/power/apc/auto_name/directional/east,
/obj/structure/cable,
/obj/machinery/atmospherics/components/unary/vent_scrubber/on/layer2{
	dir = 1
	},
/turf/open/floor/mineral/titanium,
/area/station/ai_monitored/security/armory)
"Yh" = (
/obj/machinery/mineral/ore_redemption,
/turf/open/floor/mineral/titanium,
/area/station/cargo)
"Yp" = (
/obj/effect/turf_decal/tile/bottlegreen/mono,
/obj/machinery/light{
	dir = 1
	},
/turf/open/floor/mineral/titanium,
/area/station/hallway/primary/central)
"Yv" = (
/obj/effect/turf_decal/tile/blue,
/obj/machinery/suit_storage_unit/medical,
/turf/open/floor/mineral/titanium,
/area/station/commons/dorms)
"YX" = (
/obj/machinery/computer/helm{
	dir = 8
	},
/obj/effect/turf_decal/tile/blue,
/turf/open/floor/mineral/titanium,
/area/station/command/bridge)
"YY" = (
/obj/machinery/atmospherics/components/unary/vent_pump/on/layer4{
	dir = 8
	},
/turf/open/floor/mineral/titanium,
/area/station/cargo)
"Zd" = (
/obj/effect/turf_decal/tile/yellow/mono,
/obj/structure/cable,
/turf/open/floor/mineral/titanium,
/area/station/cargo)
"Zg" = (
/obj/effect/turf_decal/tile/yellow/mono,
/obj/machinery/autolathe,
/obj/item/stack/sheet/glass/fifty,
/obj/item/stack/sheet/iron/fifty,
/turf/open/floor/mineral/titanium,
/area/station/cargo)
"Zp" = (
/obj/structure/cable,
/obj/machinery/atmospherics/pipe/smart/manifold4w/supply/hidden/layer4,
/obj/machinery/atmospherics/pipe/smart/manifold4w/scrubbers/hidden/layer2,
/obj/effect/turf_decal/tile/red/mono,
/obj/machinery/door/airlock/security/glass,
/turf/open/floor/mineral/titanium,
/area/station/ai_monitored/security/armory)
"Zy" = (
/obj/structure/grille,
/obj/structure/window/reinforced/shuttle,
/turf/open/floor/plating,
/area/station/maintenance/aft)
"ZX" = (
/obj/structure/rack,
/obj/item/gun/energy/beam_rifle{
	pin = /obj/item/firing_pin
	},
/obj/item/gun/energy/beam_rifle{
	pin = /obj/item/firing_pin
	},
/obj/effect/turf_decal/tile/red/mono,
/turf/open/floor/mineral/titanium,
/area/station/ai_monitored/security/armory)

(1,1,1) = {"
zq
zq
zq
zq
zq
oy
Oa
Oa
oy
oy
oy
Oa
Oa
oy
zq
zq
zq
zq
zq
"}
(2,1,1) = {"
zq
zq
oy
Oa
MQ
TK
IW
IW
Ww
Ww
Ww
IW
IW
TK
MQ
Oa
oy
zq
zq
"}
(3,1,1) = {"
zq
zq
oy
IW
eO
oy
ya
qu
Ww
Ww
Ww
BS
BS
oy
eO
IW
oy
zq
zq
"}
(4,1,1) = {"
zq
zq
Zy
zL
dJ
dJ
iO
dJ
Ww
Ww
Ww
dJ
dJ
iO
dJ
zL
Zy
zq
zq
"}
(5,1,1) = {"
zq
oy
TK
oy
oy
oy
TK
dJ
wl
LK
Im
dJ
TK
TK
oy
oy
TK
oy
zq
"}
(6,1,1) = {"
zq
hx
Gw
EN
Cu
SQ
oy
bi
vq
dJ
dJ
Xz
oy
cJ
Ns
zQ
dy
nC
zq
"}
(7,1,1) = {"
zq
hx
Gw
me
AA
Dk
TK
TK
WR
Ij
Qb
TK
TK
ka
qj
VV
ZX
nC
zq
"}
(8,1,1) = {"
zq
hx
Gw
SS
Dy
OQ
su
TK
oy
ur
oy
TK
Vg
VV
vN
VV
Km
nC
zq
"}
(9,1,1) = {"
MH
gJ
oU
kE
bk
bk
wd
in
NT
dN
KX
Zp
hU
hU
pR
XM
Xr
nC
zq
"}
(10,1,1) = {"
zq
gJ
tQ
Vc
qJ
jc
HM
hx
Pc
po
Vx
aJ
uF
uF
uF
uF
uF
aJ
uF
"}
(11,1,1) = {"
tp
SG
tp
tp
tp
tp
tp
SG
PN
po
gp
uF
Aa
Aa
ov
tj
Xc
ww
uF
"}
(12,1,1) = {"
hc
hm
hm
nD
Ff
Cv
dH
tp
Yp
po
dK
uF
SC
Iv
Iv
dB
KW
cM
dS
"}
(13,1,1) = {"
hc
hm
Vl
Vl
nV
uj
lk
OZ
NT
po
NT
fy
OI
Dd
dB
dB
Iv
tr
oO
"}
(14,1,1) = {"
hc
hm
Vl
ym
nV
hJ
Zd
Yh
Pc
po
Vx
uF
bL
LT
Iv
Iv
Iv
Ei
dS
"}
(15,1,1) = {"
hc
hm
fC
Vl
Vl
YY
Ss
tp
sZ
NT
Pc
uF
uD
Gy
Iv
Iv
iY
Vs
uF
"}
(16,1,1) = {"
tp
tp
SG
WY
Cj
Vl
hm
SG
pG
Tj
pG
aJ
pq
Gy
Fc
Yv
aJ
uF
uF
"}
(17,1,1) = {"
zq
zq
tp
tp
SG
Zg
Vi
tp
pO
GG
zv
uF
lN
dm
aJ
uF
uF
zq
zq
"}
(18,1,1) = {"
zq
zq
zq
zq
tp
tp
SG
SG
Gm
eW
mR
aJ
aJ
uF
uF
zq
zq
zq
zq
"}
(19,1,1) = {"
zq
zq
zq
zq
zq
zq
tp
SG
iK
kW
YX
aJ
uF
zq
zq
zq
zq
zq
zq
"}
(20,1,1) = {"
zq
zq
zq
zq
zq
zq
zq
SG
dh
dh
dh
aJ
zq
zq
zq
zq
zq
zq
zq
"}
