//MAP CONVERTED BY dmm2tgm.py THIS HEADER COMMENT PREVENTS RECONVERSION, DO NOT REMOVE
"au" = (
/obj/machinery/computer/autopilot,
/turf/open/floor/plating,
/area/station/maintenance/fore)
"aM" = (
/obj/structure/cable,
/obj/effect/decal/cleanable/oil,
/obj/machinery/atmospherics/pipe/manifold/scrubbers/hidden/layer2{
	dir = 4
	},
/obj/effect/decal/cleanable/glass,
/turf/open/floor/plating,
/area/station/maintenance/central)
"aZ" = (
/obj/effect/decal/cleanable/greenglow,
/turf/open/floor/plating,
/area/station/maintenance/starboard)
"cd" = (
/obj/structure/window/fulltile,
/obj/structure/grille,
/turf/open/floor/plating,
/area/station/maintenance/port)
"ch" = (
/obj/structure/falsewall,
/turf/open/floor/plating,
/area/station/maintenance/starboard)
"cm" = (
/obj/machinery/computer/cryopod{
	pixel_x = 1;
	pixel_y = -6
	},
/turf/closed/wall,
/area/station/maintenance/port)
"ea" = (
/obj/structure/cable,
/obj/effect/decal/cleanable/oil,
/obj/machinery/atmospherics/pipe/smart/simple/scrubbers/hidden/layer2{
	dir = 9
	},
/obj/item/shard{
	pixel_x = -6;
	pixel_y = 4
	},
/obj/item/wirerod{
	pixel_y = -4
	},
/turf/open/floor/plating,
/area/station/maintenance/starboard)
"eq" = (
/obj/machinery/power/apc/auto_name/directional/north,
/obj/structure/cable,
/obj/effect/decal/cleanable/cobweb,
/obj/effect/decal/cleanable/robot_debris,
/obj/structure/light_construct{
	dir = 1
	},
/obj/effect/decal/cleanable/dirt,
/obj/item/cigbutt,
/turf/open/floor/plating,
/area/station/cargo)
"eC" = (
/obj/structure/cable,
/obj/item/screwdriver/old,
/obj/item/multitool/old,
/obj/item/crowbar/old,
/obj/machinery/atmospherics/pipe/smart/simple/scrubbers/hidden/layer2{
	dir = 5
	},
/obj/item/clothing/gloves/color/fyellow,
/turf/open/floor/plating,
/area/station/maintenance/starboard)
"eR" = (
/obj/machinery/autolathe/hacked,
/obj/machinery/light/broken,
/turf/open/floor/plating,
/area/station/maintenance/aft)
"gy" = (
/obj/machinery/atmospherics/components/unary/outlet_injector/on/layer2{
	dir = 1
	},
/turf/open/floor/plating,
/area/station/maintenance/central)
"gS" = (
/turf/open/floor/plating,
/area/station/external)
"hb" = (
/obj/structure/cable,
/obj/effect/decal/cleanable/dirt/dust,
/obj/machinery/airalarm/directional/west,
/obj/machinery/atmospherics/components/unary/vent_scrubber/on/layer2,
/turf/open/floor/plating,
/area/station/cargo)
"hr" = (
/obj/effect/landmark/start/assistant,
/mob/living/simple_animal/hostile/cockroach,
/obj/structure/safe/floor{
	desc = "A huge chunk of metal with a dial embedded in it. Fine print on the dial reads \"Scarborough Arms - 2 tumbler safe, guaranteed thermite resistant, explosion resistant, and assistant resistant.\" Contains the spare ID.";
	name = "Spare ID Safe";
	number_of_tumblers = 4
	},
/obj/item/card/id/captains_spare{
	desc = "The spare ID of the Grand Tider himself."
	},
/turf/open/floor/plating,
/area/station/maintenance/port)
"hQ" = (
/obj/structure/cable,
/obj/machinery/door/airlock/maintenance_hatch,
/obj/effect/decal/cleanable/blood/footprints,
/obj/effect/decal/cleanable/blood/tracks,
/obj/machinery/atmospherics/pipe/smart/simple/scrubbers/hidden/layer2,
/turf/open/floor/plating,
/area/station/maintenance/fore)
"hU" = (
/obj/machinery/mineral/ore_redemption,
/turf/open/floor/plating,
/area/station/cargo)
"ih" = (
/obj/structure/fans/tiny,
/obj/machinery/door/poddoor{
	id = "tidedoors";
	name = "cargo bay blast door"
	},
/turf/open/floor/plating,
/area/station/cargo)
"iF" = (
/obj/structure/window/fulltile,
/obj/structure/grille,
/turf/open/floor/plating,
/area/station/maintenance/starboard)
"iW" = (
/obj/machinery/atmospherics/pipe/smart/simple/scrubbers/hidden/layer2,
/turf/closed/wall/rust,
/area/station/maintenance/central)
"jd" = (
/obj/machinery/ore_silo,
/obj/effect/decal/cleanable/dirt,
/turf/open/floor/plating,
/area/station/cargo)
"le" = (
/obj/structure/cable,
/obj/effect/spawner/random/trash/grille_or_waste,
/obj/machinery/atmospherics/pipe/smart/simple/scrubbers/hidden/layer2,
/turf/open/floor/plating,
/area/station/maintenance/central)
"ln" = (
/turf/closed/wall,
/area/station/maintenance/starboard)
"mc" = (
/obj/effect/landmark/start/assistant,
/obj/effect/decal/cleanable/dirt,
/turf/open/floor/plating,
/area/station/cargo)
"mB" = (
/obj/structure/cable,
/obj/item/reagent_containers/food/snacks/deadmouse{
	pixel_y = 14
	},
/obj/item/stack/cable_coil/cut/red,
/obj/machinery/atmospherics/pipe/smart/simple/scrubbers/hidden/layer2,
/obj/effect/decal/cleanable/ash,
/turf/open/floor/plating,
/area/station/maintenance/starboard)
"mN" = (
/obj/effect/decal/cleanable/oil/streak,
/obj/effect/decal/cleanable/cobweb/cobweb2,
/obj/effect/decal/cleanable/glass,
/obj/item/pipe_dispenser,
/obj/item/construction/rcd,
/obj/item/trash/syndi_cakes,
/obj/machinery/airalarm/directional/north,
/obj/effect/spawner/random/maintenance/eight,
/obj/item/reagent_containers/food/snacks/canned/peaches/maint,
/obj/structure/closet/secure_closet/engineering_personal,
/mob/living/simple_animal/hostile/cockroach/glockroach,
/turf/open/floor/plating,
/area/station/maintenance/starboard)
"nh" = (
/obj/machinery/door/window/right/directional/north{
	dir = 2
	},
/obj/effect/decal/cleanable/glass,
/turf/open/floor/plating,
/area/station/maintenance/central)
"nq" = (
/turf/closed/wall/rust,
/area/station/cargo)
"nt" = (
/obj/effect/decal/cleanable/dirt/dust,
/turf/open/floor/plating,
/area/station/cargo)
"nv" = (
/obj/structure/chair/comfy/shuttle{
	dir = 1;
	name = "Helm"
	},
/obj/effect/decal/cleanable/blood/splatter,
/obj/machinery/light/broken,
/obj/effect/landmark/start/assistant,
/obj/item/radio/intercom{
	pixel_x = -26
	},
/turf/open/floor/plating,
/area/station/maintenance/fore)
"oq" = (
/obj/structure/cable,
/obj/machinery/door/airlock/maintenance_hatch,
/obj/machinery/atmospherics/pipe/smart/simple/scrubbers/hidden/layer2{
	dir = 4
	},
/turf/open/floor/plating,
/area/station/maintenance/port)
"oC" = (
/turf/closed/wall,
/area/station/cargo)
"pH" = (
/turf/closed/wall,
/area/station/maintenance/aft)
"pI" = (
/obj/effect/decal/cleanable/cobweb,
/obj/effect/decal/cleanable/cobweb/cobweb2,
/obj/effect/decal/cleanable/glass,
/obj/structure/reagent_dispensers/cooking_oil{
	desc = "A huge metal vat with a tap on the front. Contains your backup fuel.";
	name = "vat of engine oil";
	reagent_id = /datum/reagent/fuel/oil;
	tank_volume = 3000
	},
/obj/item/reagent_containers/cup/bucket{
	desc = "Better get scoopin'."
	},
/turf/open/floor/plating,
/area/station/maintenance/central)
"pU" = (
/turf/closed/wall/rust,
/area/station/maintenance/aft)
"qB" = (
/obj/machinery/door/window/right/directional/north,
/obj/structure/cable,
/obj/machinery/power/smes/engineering{
	dir = 1
	},
/obj/structure/window,
/turf/open/floor/plating,
/area/station/maintenance/central)
"sw" = (
/obj/machinery/power/apc/auto_name/directional/east,
/obj/structure/cable,
/obj/effect/decal/cleanable/insectguts,
/obj/machinery/atmospherics/pipe/smart/simple/scrubbers/hidden/layer2,
/turf/open/floor/plating,
/area/station/maintenance/central)
"tr" = (
/obj/structure/frame/computer,
/turf/open/floor/plating,
/area/station/maintenance/fore)
"uy" = (
/obj/machinery/light{
	dir = 1
	},
/obj/machinery/power/apc/auto_name/directional/north,
/obj/structure/cable,
/obj/structure/tank_dispenser/oxygen,
/turf/open/floor/plating,
/area/station/maintenance/starboard)
"uW" = (
/obj/effect/decal/cleanable/glass,
/turf/open/floor/plating,
/area/station/external)
"vb" = (
/obj/structure/cable,
/obj/effect/decal/cleanable/oil/streak,
/obj/item/trash/can/food/beans,
/obj/machinery/atmospherics/pipe/smart/simple/scrubbers/hidden/layer2{
	dir = 9
	},
/obj/effect/decal/cleanable/glass,
/turf/open/floor/plating,
/area/station/cargo)
"vf" = (
/obj/machinery/suit_storage_unit/independent/mining/eva,
/turf/open/floor/plating,
/area/station/cargo)
"vj" = (
/obj/machinery/power/apc/auto_name/directional/north,
/obj/structure/cable,
/obj/effect/decal/cleanable/oil,
/obj/structure/frame/machine,
/obj/effect/decal/cleanable/glass,
/turf/open/floor/plating,
/area/station/maintenance/aft)
"vk" = (
/obj/effect/landmark/start/assistant,
/obj/effect/decal/cleanable/glass,
/turf/open/floor/plating,
/area/station/maintenance/aft)
"vs" = (
/obj/machinery/power/terminal{
	dir = 4
	},
/obj/structure/cable,
/obj/effect/spawner/random/trash/grille_or_waste,
/turf/open/floor/plating,
/area/station/maintenance/starboard)
"wk" = (
/obj/effect/decal/cleanable/oil,
/obj/effect/decal/cleanable/oil/streak,
/obj/effect/decal/cleanable/dirt,
/obj/effect/decal/cleanable/glass,
/mob/living/simple_animal/hostile/cockroach,
/obj/structure/cable,
/mob/living/simple_animal/hostile/retaliate/goose/vomit,
/turf/open/floor/plating,
/area/station/maintenance/central)
"wR" = (
/obj/item/storage/box/rndboards{
	desc = "Smells feighntly of plastic.";
	name = "research equipment"
	},
/obj/effect/spawner/random/maintenance,
/obj/effect/decal/cleanable/dirt,
/obj/item/trash/sosjerky,
/obj/item/cigbutt,
/obj/item/circuitboard/machine/rdserver,
/obj/structure/closet/secure_closet{
	req_access = list(11)
	},
/turf/open/floor/plating,
/area/station/maintenance/aft)
"xa" = (
/obj/item/pickaxe/emergency,
/obj/structure/closet/crate,
/obj/item/storage/bag/ore,
/obj/item/mining_scanner,
/obj/item/shovel/spoon,
/obj/machinery/light,
/obj/item/shovel/spoon,
/obj/item/mining_scanner,
/obj/item/storage/bag/ore,
/obj/item/pickaxe/emergency,
/obj/effect/spawner/random/maintenance/eight,
/turf/open/floor/plating,
/area/station/cargo)
"xk" = (
/obj/machinery/power/port_gen/pacman,
/obj/item/stack/sheet/mineral/plasma/five,
/obj/structure/cable,
/turf/open/floor/plating,
/area/station/maintenance/starboard)
"yZ" = (
/obj/structure/cable,
/obj/machinery/power/smes,
/turf/open/floor/plating,
/area/station/maintenance/starboard)
"zc" = (
/obj/machinery/power/apc/auto_name/directional/north,
/obj/structure/cable,
/obj/machinery/atmospherics/pipe/smart/simple/scrubbers/hidden/layer2{
	dir = 6
	},
/turf/open/floor/plating,
/area/station/maintenance/port)
"zm" = (
/obj/machinery/power/shuttle/engine/electric{
	dir = 1
	},
/obj/structure/cable,
/turf/open/floor/plating,
/area/station/external)
"zr" = (
/turf/closed/wall,
/area/station/maintenance/central)
"zX" = (
/obj/machinery/atmospherics/pipe/smart/simple/scrubbers/hidden/layer2{
	dir = 6
	},
/turf/closed/wall/rust,
/area/station/maintenance/central)
"Ab" = (
/obj/effect/decal/cleanable/cobweb,
/obj/effect/decal/cleanable/generic,
/turf/open/floor/plating,
/area/station/maintenance/aft)
"AU" = (
/obj/structure/cable,
/obj/effect/decal/cleanable/oil/streak,
/obj/item/trash/semki,
/obj/machinery/atmospherics/pipe/smart/simple/scrubbers/hidden/layer2{
	dir = 4
	},
/turf/open/floor/plating,
/area/station/maintenance/starboard)
"Bs" = (
/obj/machinery/door/window/right/directional/north,
/obj/machinery/power/smes/engineering{
	dir = 1
	},
/obj/structure/window,
/obj/structure/cable,
/turf/open/floor/plating,
/area/station/maintenance/central)
"BZ" = (
/obj/structure/cable,
/obj/machinery/door/airlock/maintenance_hatch,
/obj/machinery/atmospherics/pipe/smart/simple/scrubbers/hidden/layer2{
	dir = 4
	},
/turf/open/floor/plating,
/area/station/cargo)
"Ck" = (
/turf/template_noop,
/area/space)
"CD" = (
/obj/structure/cable,
/obj/machinery/door/airlock/maintenance_hatch,
/turf/open/floor/plating,
/area/station/maintenance/central)
"CS" = (
/obj/effect/decal/cleanable/dirt,
/obj/effect/decal/cleanable/glass,
/obj/machinery/power/terminal,
/obj/structure/cable,
/obj/item/trash/tray,
/turf/open/floor/plating,
/area/station/maintenance/central)
"Ed" = (
/obj/effect/decal/cleanable/oil,
/turf/open/floor/plating,
/area/station/cargo)
"Ef" = (
/obj/effect/decal/cleanable/oil/streak,
/obj/item/trash/boritos,
/obj/effect/decal/cleanable/dirt/dust,
/obj/effect/decal/cleanable/glass,
/obj/machinery/airalarm/directional/east,
/obj/machinery/atmospherics/components/unary/vent_scrubber/on/layer2{
	dir = 1
	},
/obj/effect/landmark/start/assistant,
/turf/open/floor/plating,
/area/station/maintenance/port)
"Fg" = (
/obj/structure/cable,
/obj/machinery/door/airlock/engineering{
	req_access = list(11)
	},
/obj/machinery/atmospherics/pipe/smart/simple/scrubbers/hidden/layer2{
	dir = 4
	},
/turf/open/floor/plating,
/area/station/maintenance/starboard)
"FA" = (
/obj/structure/cable,
/obj/item/storage/firstaid/fire,
/obj/effect/decal/cleanable/dirt,
/obj/structure/light_construct{
	dir = 1
	},
/obj/machinery/atmospherics/pipe/smart/simple/scrubbers/hidden/layer2{
	dir = 10
	},
/obj/effect/landmark/start/assistant,
/turf/open/floor/plating,
/area/station/maintenance/starboard)
"FC" = (
/obj/effect/spawner/random/maintenance/four,
/obj/structure/light_construct/small{
	dir = 8
	},
/obj/machinery/power/terminal,
/obj/structure/cable,
/mob/living/simple_animal/hostile/cockroach/glockroach,
/turf/open/floor/plating,
/area/station/maintenance/central)
"FQ" = (
/obj/structure/cable,
/obj/effect/decal/cleanable/blood/footprints,
/obj/machinery/light/broken{
	dir = 4
	},
/obj/machinery/atmospherics/pipe/smart/simple/scrubbers/hidden/layer2,
/turf/open/floor/plating,
/area/station/maintenance/central)
"GE" = (
/turf/closed/wall/rust,
/area/station/maintenance/starboard)
"Ha" = (
/obj/structure/cable,
/obj/machinery/door/airlock/maintenance_hatch,
/obj/machinery/atmospherics/pipe/smart/simple/scrubbers/hidden/layer2{
	dir = 4
	},
/turf/open/floor/plating,
/area/station/maintenance/aft)
"Hj" = (
/obj/structure/window/fulltile,
/obj/structure/grille,
/turf/open/floor/plating,
/area/station/maintenance/fore)
"HQ" = (
/obj/machinery/power/shuttle/engine/liquid/oil{
	dir = 1
	},
/turf/open/floor/plating,
/area/station/external)
"Il" = (
/obj/structure/cable,
/obj/effect/decal/cleanable/dirt,
/obj/structure/light_construct{
	dir = 1
	},
/obj/machinery/atmospherics/pipe/smart/simple/scrubbers/hidden/layer2{
	dir = 6
	},
/turf/open/floor/plating,
/area/station/maintenance/aft)
"IX" = (
/obj/structure/fans/tiny,
/obj/machinery/door/airlock/maintenance_hatch,
/obj/docking_port/mobile{
	dir = 4;
	launch_status = 0;
	port_direction = 8
	},
/turf/open/floor/plating,
/area/station/maintenance/aft)
"KK" = (
/obj/effect/decal/cleanable/dirt,
/obj/machinery/light/broken,
/obj/item/bedsheet/random,
/obj/structure/bed,
/obj/structure/curtain/bounty,
/turf/open/floor/plating,
/area/station/maintenance/port)
"KS" = (
/obj/effect/spawner/random/medical/memeorgans,
/obj/structure/closet/crate/freezer,
/obj/item/reagent_containers/blood/AMinus,
/obj/item/reagent_containers/blood/BPlus,
/obj/item/reagent_containers/blood/random,
/obj/item/organ/ears/cat,
/obj/item/organ/tail/cat,
/turf/open/floor/plating,
/area/station/maintenance/starboard)
"Lh" = (
/obj/effect/decal/cleanable/dirt,
/obj/machinery/cryopod{
	close_state = "crate";
	dir = 8;
	icon = 'goon/icons/obj/crates.dmi';
	icon_state = "crateopen";
	open_state = "crateopen"
	},
/turf/open/floor/plating,
/area/station/maintenance/port)
"LK" = (
/obj/structure/cable,
/obj/machinery/door/airlock/maintenance_hatch,
/obj/machinery/atmospherics/pipe/smart/simple/scrubbers/hidden/layer2{
	dir = 4
	},
/turf/open/floor/plating,
/area/station/maintenance/starboard)
"LP" = (
/obj/structure/cable,
/obj/effect/decal/cleanable/dirt,
/obj/machinery/airalarm/directional/east,
/obj/machinery/atmospherics/pipe/smart/simple/scrubbers/hidden/layer2,
/obj/effect/decal/cleanable/glass,
/turf/open/floor/plating,
/area/station/maintenance/central)
"LR" = (
/obj/item/storage/backpack/duffelbag/med/surgery,
/obj/structure/closet/secure_closet/medical2,
/obj/effect/decal/cleanable/dirt,
/obj/machinery/light/broken,
/obj/item/defibrillator/loaded,
/obj/effect/spawner/random/maintenance/eight,
/turf/open/floor/plating,
/area/station/maintenance/starboard)
"Mk" = (
/obj/effect/decal/cleanable/oil/streak,
/obj/machinery/airalarm/directional/east,
/obj/machinery/atmospherics/components/unary/vent_scrubber/on/layer2{
	dir = 1
	},
/turf/open/floor/plating,
/area/station/maintenance/aft)
"MM" = (
/obj/structure/fans/tiny,
/obj/machinery/door/poddoor{
	id = "tidedoors";
	name = "cargo bay blast door"
	},
/obj/effect/decal/cleanable/glass,
/turf/open/floor/plating,
/area/station/cargo)
"Ns" = (
/turf/closed/wall,
/area/station/maintenance/port)
"Od" = (
/obj/structure/window/fulltile,
/obj/structure/grille,
/turf/closed/wall/material,
/area/station/maintenance/starboard)
"Oy" = (
/turf/closed/wall,
/area/station/maintenance/fore)
"OK" = (
/obj/structure/cable,
/obj/item/storage/toolbox/mechanical/old,
/obj/effect/decal/cleanable/blood/old,
/obj/effect/decal/cleanable/blood/drip,
/obj/effect/decal/cleanable/blood/footprints,
/obj/effect/decal/cleanable/blood/gibs/down,
/obj/effect/decal/cleanable/blood/gibs/limb,
/obj/machinery/atmospherics/pipe/smart/simple/scrubbers/hidden/layer2{
	dir = 6
	},
/obj/item/areaeditor,
/obj/machinery/holopad/emergency/command,
/turf/open/floor/plating,
/area/station/maintenance/fore)
"Po" = (
/turf/closed/wall/rust,
/area/station/maintenance/central)
"Px" = (
/obj/structure/cable,
/obj/effect/decal/cleanable/dirt,
/obj/effect/decal/cleanable/glass,
/obj/effect/spawner/random/trash/grille_or_waste,
/obj/structure/cable,
/turf/open/floor/plating,
/area/station/maintenance/starboard)
"RK" = (
/obj/machinery/power/apc/auto_name/directional/south,
/obj/structure/cable,
/obj/effect/decal/cleanable/dirt/dust,
/obj/effect/decal/cleanable/blood/gibs/limb,
/obj/machinery/light,
/obj/machinery/airalarm/directional/east,
/obj/machinery/atmospherics/components/unary/vent_scrubber/on/layer2{
	dir = 8
	},
/obj/item/cigbutt/cigarbutt,
/obj/effect/decal/cleanable/ash,
/turf/open/floor/plating,
/area/station/maintenance/fore)
"Sf" = (
/obj/structure/cable,
/obj/effect/decal/cleanable/dirt/dust,
/obj/machinery/atmospherics/pipe/manifold/scrubbers/hidden/layer2{
	dir = 8
	},
/turf/open/floor/plating,
/area/station/maintenance/central)
"SI" = (
/obj/effect/decal/cleanable/glass,
/obj/machinery/portable_atmospherics/canister/oxygen,
/turf/open/floor/plating,
/area/station/maintenance/starboard)
"Ti" = (
/turf/open/floor/plating,
/area/station/maintenance/starboard)
"Tp" = (
/turf/closed/wall/rust,
/area/station/maintenance/fore)
"TN" = (
/obj/machinery/button/door{
	id = "tidedoors";
	name = "Blast Door Control";
	pixel_y = -24
	},
/obj/machinery/suit_storage_unit/independent/mining/eva,
/turf/open/floor/plating,
/area/station/cargo)
"Ub" = (
/obj/structure/cable,
/obj/effect/decal/cleanable/dirt/dust,
/obj/machinery/atmospherics/pipe/smart/simple/scrubbers/hidden/layer2,
/obj/item/trash/can/food/peaches/maint,
/turf/open/floor/plating,
/area/station/maintenance/central)
"Vl" = (
/obj/machinery/computer/helm,
/turf/open/floor/plating,
/area/station/maintenance/fore)
"VL" = (
/obj/effect/spawner/random/maintenance,
/obj/structure/closet/crate,
/obj/effect/decal/cleanable/glass,
/obj/item/storage/toolbox/mechanical/old,
/obj/item/reagent_containers/food/snacks/canned/beans,
/turf/open/floor/plating,
/area/station/maintenance/aft)
"We" = (
/obj/structure/table/optable,
/obj/effect/decal/cleanable/blood/old,
/turf/open/floor/plating,
/area/station/maintenance/starboard)
"Xg" = (
/obj/structure/cable,
/obj/effect/decal/cleanable/oil/slippery,
/obj/effect/decal/cleanable/blood/footprints,
/obj/effect/decal/cleanable/blood/tracks,
/obj/machinery/atmospherics/pipe/manifold/scrubbers/hidden/layer2{
	dir = 4
	},
/obj/item/trash/semki,
/turf/open/floor/plating,
/area/station/maintenance/central)
"Ye" = (
/obj/structure/cable,
/obj/effect/decal/cleanable/dirt/dust,
/obj/machinery/light{
	dir = 4
	},
/obj/machinery/atmospherics/pipe/smart/simple/scrubbers/hidden/layer2,
/turf/open/floor/plating,
/area/station/maintenance/central)
"Yo" = (
/turf/closed/wall/rust,
/area/station/maintenance/port)
"Yq" = (
/obj/structure/cable,
/obj/effect/decal/cleanable/oil/streak,
/obj/item/trash/can/food,
/obj/machinery/light/broken,
/obj/machinery/atmospherics/pipe/manifold/scrubbers/hidden/layer2,
/turf/open/floor/plating,
/area/station/maintenance/central)
"YV" = (
/obj/structure/table,
/obj/item/trash/cheesie,
/obj/item/reagent_containers/food/snacks/kebab/rat{
	pixel_y = -6
	},
/obj/item/reagent_containers/food/snacks/kebab/rat/double{
	pixel_x = 2;
	pixel_y = 6
	},
/obj/item/reagent_containers/food/snacks/burger/rat,
/obj/item/cigbutt,
/obj/item/reagent_containers/cup/glass/sillycup/smallcarton{
	list_reagents = list(/datum/reagent/consumable/ethanol/vodka = 100)
	},
/turf/open/floor/plating,
/area/station/maintenance/port)
"Zj" = (
/obj/effect/decal/cleanable/dirt,
/obj/machinery/atmospherics/components/unary/vent_scrubber/on/layer2,
/obj/structure/cable,
/mob/living/simple_animal/hostile/cockroach,
/turf/open/floor/plating,
/area/station/maintenance/starboard)
"Zo" = (
/obj/structure/cable,
/obj/effect/decal/cleanable/oil,
/obj/effect/spawner/random/trash/grille_or_waste,
/obj/machinery/atmospherics/components/unary/vent_scrubber/on/layer2{
	dir = 8
	},
/obj/machinery/power/terminal,
/obj/structure/cable,
/obj/item/cigbutt,
/turf/open/floor/plating,
/area/station/maintenance/central)

(1,1,1) = {"
Ck
Ck
Ck
Ck
Ck
Ck
Ck
Ck
pH
IX
pU
pH
Ck
Ck
Ck
Ck
Ck
"}
(2,1,1) = {"
Ck
Ck
Ck
cd
Ns
cd
Yo
pH
pH
Ab
eR
pH
Po
Po
zr
zr
Ck
"}
(3,1,1) = {"
Ck
Ck
Ck
cm
YV
hr
KK
pH
vj
vk
wR
pH
zr
FC
qB
zm
Ck
"}
(4,1,1) = {"
Hj
Tp
Oy
Ns
zc
Ef
Lh
pU
Il
Mk
VL
pU
pI
wk
nh
HQ
Ck
"}
(5,1,1) = {"
Hj
au
nv
Oy
oq
Ns
Ns
pH
Ha
pH
pH
pH
zr
CD
zX
iW
gy
"}
(6,1,1) = {"
Hj
Vl
OK
hQ
Xg
FQ
Sf
Ub
aM
le
Ye
Sf
LP
sw
Yq
zr
Po
"}
(7,1,1) = {"
Hj
tr
RK
Oy
nq
oC
BZ
oC
GE
ch
ln
LK
GE
zr
Zo
Bs
zm
"}
(8,1,1) = {"
Hj
Oy
Oy
oC
eq
hb
vb
xa
ln
xk
ln
AU
SI
ln
CS
Bs
zm
"}
(9,1,1) = {"
Ck
Ck
Ck
nq
hU
mc
nt
vf
ln
vs
ln
FA
eC
ln
Po
Po
zr
"}
(10,1,1) = {"
Ck
Ck
Ck
oC
jd
Ed
nt
TN
ln
yZ
Px
GE
Fg
ln
ln
Ck
Ck
"}
(11,1,1) = {"
Ck
Ck
Ck
oC
ih
ih
MM
MM
ln
uy
Zj
mB
ea
LR
ln
Ck
Ck
"}
(12,1,1) = {"
Ck
Ck
Ck
Ck
gS
gS
gS
uW
GE
mN
KS
Ti
aZ
We
GE
Ck
Ck
"}
(13,1,1) = {"
Ck
Ck
Ck
Ck
Ck
Ck
Ck
Ck
GE
ln
Od
iF
iF
ln
GE
Ck
Ck
"}
