//MAP CONVERTED BY dmm2tgm.py THIS HEADER COMMENT PREVENTS RECONVERSION, DO NOT REMOVE
"cK" = (
/obj/effect/turf_decal/siding/yellow{
	dir = 8
	},
/obj/effect/spawner/lootdrop/crate_spawner,
/turf/open/indestructible,
/area/tdome/arena)
"cM" = (
/obj/effect/turf_decal/siding/yellow{
	dir = 4
	},
/obj/effect/spawner/lootdrop/crate_spawner,
/obj/effect/decal/cleanable/dirt/dust,
/turf/open/indestructible,
/area/tdome/arena)
"fy" = (
/obj/machinery/door/airlock/mining/glass,
/turf/open/indestructible/airblock,
/area/tdome/arena)
"hm" = (
/obj/effect/turf_decal/siding/yellow{
	dir = 8
	},
/obj/effect/decal/cleanable/dirt/dust,
/turf/open/indestructible,
/area/tdome/arena)
"is" = (
/obj/effect/turf_decal/siding/yellow{
	dir = 8
	},
/turf/open/indestructible,
/area/tdome/arena)
"iy" = (
/obj/effect/spawner/lootdrop/crate_spawner,
/obj/effect/decal/cleanable/dirt/dust,
/turf/open/indestructible,
/area/tdome/arena)
"kf" = (
/turf/closed/indestructible/opshuttle,
/area/tdome/arena)
"kg" = (
/turf/open/floor/iron/smooth_half{
	dir = 4
	},
/area/tdome/arena)
"nm" = (
/turf/open/floor/iron/smooth_half{
	dir = 1
	},
/area/tdome/arena)
"oS" = (
/obj/effect/turf_decal/arrows/white{
	dir = 8
	},
/turf/open/floor/iron/smooth_large,
/area/tdome/arena)
"pd" = (
/obj/effect/turf_decal/stripes{
	dir = 1
	},
/turf/open/indestructible,
/area/tdome/arena)
"py" = (
/obj/effect/turf_decal/siding/yellow{
	dir = 4
	},
/obj/machinery/arena_spawn/red,
/turf/open/indestructible,
/area/tdome/arena)
"qy" = (
/turf/closed/indestructible/riveted,
/area/tdome/arena)
"qN" = (
/turf/open/floor/iron/smooth,
/area/tdome/arena)
"qS" = (
/obj/effect/turf_decal/arrows/white,
/turf/open/floor/iron/smooth_large,
/area/tdome/arena)
"ru" = (
/turf/closed/indestructible/opshuttle{
	dir = 1
	},
/area/tdome/arena)
"sz" = (
/turf/open/floor/iron/smooth_edge{
	dir = 8
	},
/area/tdome/arena)
"tW" = (
/obj/effect/turf_decal/bot,
/turf/open/floor/iron/smooth_large,
/area/tdome/arena)
"wf" = (
/turf/open/floor/iron/smooth_corner,
/area/tdome/arena)
"wy" = (
/obj/effect/turf_decal/arrows/white{
	dir = 4
	},
/turf/open/floor/iron/smooth_large,
/area/tdome/arena)
"yz" = (
/obj/machinery/button,
/turf/closed/indestructible/riveted,
/area/tdome/arena)
"yW" = (
/obj/effect/turf_decal/siding/yellow{
	dir = 8
	},
/obj/machinery/arena_spawn/green,
/turf/open/indestructible,
/area/tdome/arena)
"zc" = (
/obj/effect/turf_decal/siding/yellow{
	dir = 4
	},
/obj/effect/spawner/lootdrop/crate_spawner,
/turf/open/indestructible,
/area/tdome/arena)
"zs" = (
/obj/effect/turf_decal/delivery/white,
/turf/open/floor/iron/smooth_edge{
	dir = 4
	},
/area/tdome/arena)
"AI" = (
/turf/open/floor/iron/smooth_corner{
	dir = 4
	},
/area/tdome/arena)
"Cd" = (
/obj/structure/shuttle/engine/router,
/turf/closed/indestructible/opshuttle,
/area/tdome/arena)
"Ch" = (
/obj/effect/turf_decal/arrows{
	dir = 8;
	pixel_x = 7
	},
/turf/open/floor/iron/smooth_edge{
	dir = 8
	},
/area/tdome/arena)
"CF" = (
/turf/open/floor/iron/smooth_corner{
	dir = 1
	},
/area/tdome/arena)
"CM" = (
/obj/structure/shuttle/engine/propulsion/right{
	dir = 8
	},
/turf/open/space/basic,
/area/tdome/arena)
"DA" = (
/turf/open/floor/iron/smooth_corner{
	dir = 8
	},
/area/tdome/arena)
"DE" = (
/obj/effect/decal/cleanable/dirt/dust,
/obj/effect/decal/cleanable/dirt/dust,
/turf/open/indestructible,
/area/tdome/arena)
"Ev" = (
/obj/effect/turf_decal/delivery/white,
/turf/open/floor/iron/smooth_edge,
/area/tdome/arena)
"GB" = (
/obj/effect/turf_decal/siding/yellow{
	dir = 8
	},
/obj/effect/spawner/lootdrop/crate_spawner,
/obj/effect/decal/cleanable/dirt/dust,
/turf/open/indestructible,
/area/tdome/arena)
"GD" = (
/turf/open/floor/iron/smooth_edge{
	dir = 1
	},
/area/tdome/arena)
"GR" = (
/obj/effect/spawner/structure/window/reinforced/indestructable,
/turf/open/indestructible/white,
/area/tdome/arena)
"GX" = (
/obj/structure/shuttle/engine/propulsion/left{
	dir = 8
	},
/turf/open/space/basic,
/area/tdome/arena)
"HJ" = (
/obj/effect/turf_decal/siding/yellow{
	dir = 4
	},
/obj/effect/decal/cleanable/dirt/dust,
/turf/open/indestructible,
/area/tdome/arena)
"HK" = (
/obj/effect/turf_decal/arrows/white{
	dir = 1
	},
/turf/open/floor/iron/smooth_large,
/area/tdome/arena)
"IV" = (
/obj/effect/turf_decal/delivery/white,
/turf/open/floor/iron/smooth_edge{
	dir = 1
	},
/area/tdome/arena)
"IY" = (
/obj/effect/spawner/lootdrop/crate_spawner,
/turf/open/indestructible,
/area/tdome/arena)
"KF" = (
/turf/open/floor/iron/smooth_half,
/area/tdome/arena)
"Ld" = (
/obj/effect/turf_decal/bot_white,
/turf/open/floor/iron/smooth_half{
	dir = 1
	},
/area/tdome/arena)
"Li" = (
/obj/effect/turf_decal/loading_area/white{
	dir = 8
	},
/turf/open/floor/iron/smooth,
/area/tdome/arena)
"Ms" = (
/obj/effect/turf_decal/box/white,
/obj/effect/turf_decal/arrows{
	dir = 8;
	pixel_x = 7
	},
/turf/open/floor/iron/smooth_edge{
	dir = 8
	},
/area/tdome/arena)
"Qe" = (
/obj/structure/shuttle/engine/propulsion/left{
	dir = 4
	},
/turf/open/space/basic,
/area/tdome/arena)
"Qh" = (
/obj/effect/turf_decal/bot_white,
/turf/open/floor/iron/smooth_half,
/area/tdome/arena)
"QQ" = (
/turf/open/floor/iron/smooth_large,
/area/tdome/arena)
"Rs" = (
/obj/effect/turf_decal/delivery,
/turf/open/floor/iron/smooth_large,
/area/tdome/arena)
"Se" = (
/obj/structure/shuttle/engine/propulsion/burst{
	dir = 4
	},
/turf/open/space/basic,
/area/tdome/arena)
"Sn" = (
/obj/effect/turf_decal/delivery/white,
/turf/open/floor/iron/smooth,
/area/tdome/arena)
"SR" = (
/obj/structure/shuttle/engine/propulsion/right{
	dir = 4
	},
/turf/open/space/basic,
/area/tdome/arena)
"Tj" = (
/turf/open/floor/iron/smooth_edge{
	dir = 4
	},
/area/tdome/arena)
"Ut" = (
/obj/structure/shuttle/engine/router,
/obj/structure/shuttle/engine/router{
	dir = 1
	},
/turf/closed/indestructible/opshuttle{
	dir = 1
	},
/area/tdome/arena)
"UL" = (
/obj/machinery/door/poddoor/shutters,
/turf/open/indestructible,
/area/tdome/arena)
"UY" = (
/obj/effect/decal/cleanable/dirt/dust,
/turf/open/indestructible,
/area/tdome/arena)
"VI" = (
/turf/open/floor/iron/smooth_edge,
/area/tdome/arena)
"VP" = (
/obj/effect/turf_decal/siding/yellow{
	dir = 4
	},
/turf/open/indestructible,
/area/tdome/arena)
"WG" = (
/turf/open/indestructible,
/area/tdome/arena)
"WV" = (
/obj/effect/spawner/lootdrop/crate_spawner,
/obj/effect/decal/cleanable/oil/slippery,
/turf/open/indestructible,
/area/tdome/arena)
"WX" = (
/turf/open/space/basic,
/area/tdome/arena)
"Yc" = (
/obj/effect/turf_decal/stripes,
/turf/open/indestructible,
/area/tdome/arena)
"YR" = (
/obj/structure/shuttle/engine/propulsion/burst{
	dir = 8
	},
/turf/open/space/basic,
/area/tdome/arena)

(1,1,1) = {"
qN
qN
qN
qN
qN
qN
qN
qN
qN
qN
qN
qN
qN
qN
qN
qN
qN
qN
qN
qN
qN
qN
qN
qN
qN
qN
qN
qN
qN
qN
qN
qN
qN
qN
qN
qN
qN
qN
qN
qN
qN
qN
qN
qN
qN
qN
qN
qN
qN
qN
qN
qN
qN
qN
qN
qN
qN
qN
qN
qN
qN
qN
qN
qN
"}
(2,1,1) = {"
qN
Sn
Tj
Tj
Tj
Tj
Tj
Tj
Tj
Tj
Tj
Tj
Tj
Tj
Tj
Tj
Tj
Tj
Tj
Tj
Tj
Tj
Tj
Tj
Tj
Tj
Tj
Tj
Tj
zs
Tj
Tj
Tj
Tj
zs
Tj
Tj
Tj
Tj
Tj
Tj
Tj
Tj
Tj
Tj
Tj
Tj
Tj
Tj
Tj
Tj
Tj
Tj
Tj
Tj
Tj
Tj
Tj
Tj
Tj
Tj
Tj
Sn
qN
"}
(3,1,1) = {"
qN
VI
wf
nm
nm
nm
nm
nm
nm
nm
nm
nm
nm
nm
nm
Ld
nm
nm
nm
nm
nm
nm
nm
nm
nm
nm
nm
nm
nm
nm
nm
nm
nm
nm
nm
nm
nm
nm
nm
nm
nm
nm
nm
nm
nm
nm
nm
nm
Ld
nm
nm
nm
nm
nm
nm
nm
nm
nm
nm
nm
nm
AI
GD
qN
"}
(4,1,1) = {"
qN
VI
KF
wf
nm
nm
nm
nm
nm
nm
nm
nm
nm
nm
nm
nm
nm
nm
nm
nm
nm
nm
nm
nm
nm
nm
nm
nm
nm
nm
nm
nm
nm
nm
nm
nm
nm
nm
nm
nm
nm
nm
nm
nm
nm
nm
nm
nm
nm
nm
nm
nm
nm
nm
nm
nm
nm
nm
nm
nm
AI
KF
GD
qN
"}
(5,1,1) = {"
qN
VI
KF
KF
wf
nm
nm
nm
nm
nm
nm
nm
nm
nm
nm
nm
nm
nm
nm
nm
nm
nm
nm
nm
nm
nm
nm
nm
nm
nm
nm
nm
nm
nm
nm
nm
nm
nm
nm
nm
nm
nm
nm
nm
nm
nm
nm
nm
nm
nm
nm
nm
nm
nm
nm
nm
nm
nm
nm
AI
kg
KF
GD
qN
"}
(6,1,1) = {"
qN
VI
KF
KF
kg
wf
nm
nm
nm
nm
nm
nm
nm
nm
nm
nm
nm
nm
nm
nm
nm
nm
nm
nm
nm
nm
nm
nm
nm
nm
nm
nm
nm
nm
nm
nm
nm
nm
nm
nm
nm
nm
nm
nm
nm
nm
nm
nm
nm
nm
nm
nm
nm
nm
nm
nm
nm
nm
AI
kg
kg
KF
GD
qN
"}
(7,1,1) = {"
qN
VI
KF
KF
kg
KF
wf
nm
nm
nm
nm
nm
nm
nm
nm
nm
nm
nm
nm
nm
nm
nm
nm
nm
nm
nm
nm
nm
nm
nm
nm
nm
nm
nm
nm
nm
nm
nm
nm
nm
nm
nm
nm
nm
nm
nm
nm
nm
nm
nm
nm
nm
nm
nm
nm
nm
nm
AI
KF
kg
kg
KF
GD
qN
"}
(8,1,1) = {"
qN
VI
KF
KF
kg
KF
KF
wf
nm
nm
nm
nm
nm
nm
nm
nm
nm
nm
nm
nm
nm
nm
nm
nm
nm
nm
nm
nm
nm
nm
nm
nm
nm
nm
nm
nm
nm
nm
nm
nm
nm
nm
nm
nm
nm
nm
nm
nm
nm
nm
nm
nm
nm
nm
nm
nm
AI
KF
KF
kg
kg
KF
GD
qN
"}
(9,1,1) = {"
qN
VI
KF
KF
kg
KF
KF
KF
wf
nm
nm
nm
nm
nm
nm
nm
nm
nm
nm
nm
nm
nm
nm
nm
nm
nm
nm
nm
nm
nm
nm
nm
nm
nm
nm
nm
nm
nm
nm
nm
nm
nm
nm
nm
nm
nm
nm
nm
nm
nm
nm
nm
nm
nm
nm
AI
KF
KF
KF
kg
kg
KF
GD
qN
"}
(10,1,1) = {"
qN
VI
KF
KF
kg
KF
KF
KF
KF
wf
nm
nm
nm
nm
nm
nm
nm
nm
nm
nm
nm
nm
nm
nm
nm
nm
nm
nm
nm
nm
nm
nm
nm
nm
nm
nm
nm
nm
nm
nm
nm
nm
nm
nm
nm
nm
nm
nm
nm
nm
nm
nm
nm
nm
AI
KF
KF
KF
KF
kg
kg
KF
GD
qN
"}
(11,1,1) = {"
qN
VI
KF
KF
kg
KF
KF
KF
KF
KF
Rs
QQ
QQ
QQ
QQ
QQ
QQ
QQ
QQ
QQ
tW
QQ
QQ
QQ
QQ
QQ
QQ
QQ
QQ
QQ
QQ
QQ
QQ
QQ
QQ
QQ
QQ
QQ
QQ
QQ
QQ
QQ
QQ
tW
QQ
QQ
QQ
QQ
QQ
QQ
QQ
QQ
QQ
Rs
KF
KF
KF
KF
KF
kg
kg
KF
GD
qN
"}
(12,1,1) = {"
qN
VI
KF
KF
kg
KF
KF
KF
KF
KF
QQ
QQ
QQ
QQ
QQ
QQ
QQ
QQ
QQ
QQ
QQ
QQ
QQ
QQ
QQ
QQ
QQ
QQ
QQ
QQ
QQ
QQ
QQ
QQ
QQ
QQ
QQ
QQ
QQ
QQ
QQ
QQ
QQ
QQ
QQ
QQ
QQ
QQ
QQ
QQ
QQ
QQ
QQ
QQ
KF
KF
KF
KF
KF
kg
kg
KF
GD
qN
"}
(13,1,1) = {"
qN
VI
KF
KF
kg
KF
KF
KF
KF
KF
QQ
QQ
QQ
QQ
QQ
QQ
QQ
QQ
QQ
QQ
QQ
QQ
QQ
QQ
QQ
QQ
QQ
QQ
QQ
QQ
QQ
QQ
QQ
QQ
QQ
QQ
QQ
QQ
QQ
QQ
QQ
QQ
QQ
QQ
QQ
QQ
QQ
QQ
QQ
QQ
QQ
QQ
QQ
QQ
KF
KF
KF
KF
KF
kg
kg
KF
GD
qN
"}
(14,1,1) = {"
qN
VI
KF
KF
kg
KF
KF
KF
KF
KF
QQ
QQ
QQ
QQ
QQ
QQ
QQ
QQ
QQ
QQ
QQ
QQ
QQ
QQ
QQ
QQ
QQ
QQ
QQ
QQ
QQ
wy
wy
QQ
QQ
QQ
QQ
QQ
QQ
QQ
QQ
QQ
QQ
QQ
QQ
QQ
QQ
QQ
QQ
QQ
QQ
QQ
QQ
QQ
KF
KF
KF
KF
KF
kg
kg
KF
GD
qN
"}
(15,1,1) = {"
qN
VI
KF
KF
kg
KF
KF
KF
KF
KF
QQ
QQ
QQ
QQ
QQ
QQ
QQ
QQ
QQ
QQ
QQ
QQ
QQ
QQ
QQ
QQ
QQ
QQ
QQ
QQ
QQ
QQ
QQ
QQ
QQ
QQ
QQ
QQ
QQ
QQ
QQ
QQ
QQ
QQ
QQ
QQ
QQ
QQ
QQ
QQ
QQ
QQ
QQ
QQ
KF
KF
KF
KF
KF
kg
kg
KF
GD
qN
"}
(16,1,1) = {"
qN
VI
Qh
KF
kg
KF
KF
KF
KF
KF
QQ
QQ
QQ
QQ
QQ
QQ
QQ
QQ
QQ
QQ
QQ
QQ
QQ
QQ
QQ
QQ
QQ
QQ
QQ
QQ
QQ
QQ
QQ
QQ
QQ
QQ
QQ
QQ
QQ
QQ
QQ
QQ
QQ
QQ
QQ
QQ
QQ
QQ
QQ
QQ
QQ
QQ
QQ
QQ
KF
KF
KF
KF
KF
kg
kg
Qh
GD
qN
"}
(17,1,1) = {"
qN
VI
KF
KF
kg
KF
KF
KF
KF
KF
QQ
QQ
QQ
QQ
QQ
QQ
QQ
QQ
QQ
QQ
QQ
QQ
QQ
QQ
QQ
QQ
QQ
QQ
QQ
QQ
QQ
QQ
QQ
QQ
QQ
QQ
QQ
QQ
QQ
QQ
QQ
QQ
QQ
QQ
QQ
QQ
QQ
QQ
QQ
QQ
QQ
QQ
QQ
QQ
KF
KF
KF
KF
KF
kg
kg
KF
GD
qN
"}
(18,1,1) = {"
qN
VI
KF
KF
kg
KF
KF
KF
KF
KF
QQ
QQ
QQ
QQ
QQ
QQ
QQ
QQ
QQ
QQ
QQ
QQ
QQ
QQ
QQ
QQ
QQ
QQ
QQ
QQ
QQ
QQ
QQ
QQ
QQ
QQ
QQ
QQ
QQ
QQ
QQ
QQ
QQ
QQ
QQ
QQ
QQ
QQ
QQ
QQ
QQ
QQ
QQ
QQ
KF
KF
KF
KF
KF
kg
kg
KF
GD
qN
"}
(19,1,1) = {"
qN
VI
KF
KF
kg
KF
KF
KF
KF
KF
QQ
QQ
QQ
QQ
QQ
QQ
QQ
QQ
QQ
QQ
QQ
QQ
QQ
QQ
QQ
QQ
QQ
QQ
qy
qy
qy
qy
qy
qy
qy
qy
qy
qy
qy
qy
QQ
QQ
QQ
QQ
QQ
QQ
QQ
QQ
QQ
QQ
QQ
QQ
QQ
QQ
KF
KF
KF
KF
KF
kg
kg
KF
GD
qN
"}
(20,1,1) = {"
qN
VI
KF
KF
kg
KF
KF
KF
KF
KF
QQ
QQ
QQ
QQ
QQ
QQ
QQ
QQ
QQ
QQ
QQ
QQ
QQ
QQ
QQ
QQ
QQ
QQ
qy
GB
is
GB
is
cK
is
qy
is
is
yW
qy
QQ
QQ
QQ
QQ
QQ
QQ
QQ
QQ
QQ
QQ
QQ
QQ
QQ
QQ
KF
KF
KF
KF
KF
kg
kg
KF
GD
qN
"}
(21,1,1) = {"
qN
VI
KF
KF
kg
KF
KF
KF
KF
KF
tW
QQ
QQ
QQ
QQ
QQ
QQ
QQ
QQ
QQ
QQ
QQ
QQ
QQ
QQ
QQ
QQ
QQ
qy
WG
UY
IY
iy
DE
IY
qy
WG
UY
WG
qy
QQ
QQ
QQ
QQ
QQ
QQ
QQ
QQ
QQ
QQ
QQ
QQ
QQ
tW
KF
KF
KF
KF
KF
kg
kg
KF
GD
qN
"}
(22,1,1) = {"
qN
VI
KF
KF
kg
KF
KF
KF
KF
KF
QQ
QQ
QQ
QQ
QQ
QQ
QQ
QQ
QQ
QQ
QQ
QQ
QQ
QQ
QQ
QQ
QQ
QQ
qy
UY
IY
UY
UY
IY
UY
UL
UY
WG
WG
qy
QQ
QQ
QQ
QQ
QQ
QQ
QQ
QQ
QQ
QQ
QQ
QQ
QQ
QQ
KF
KF
KF
KF
KF
kg
kg
KF
GD
qN
"}
(23,1,1) = {"
qN
VI
KF
KF
kg
KF
KF
KF
KF
KF
QQ
QQ
QQ
QQ
QQ
QQ
QQ
QQ
QQ
QQ
QQ
QQ
QQ
QQ
QQ
QQ
QQ
QQ
qy
IY
UY
IY
WV
WG
IY
UL
WG
WG
WG
qy
QQ
QQ
QQ
QQ
QQ
QQ
QQ
QQ
QQ
QQ
QQ
QQ
QQ
QQ
KF
KF
KF
KF
KF
kg
kg
KF
GD
qN
"}
(24,1,1) = {"
qN
VI
KF
KF
kg
KF
KF
KF
KF
KF
QQ
QQ
QQ
QQ
QQ
QQ
QQ
QQ
QQ
QQ
QQ
QQ
QQ
QQ
QQ
QQ
QQ
QQ
qy
UY
iy
IY
iy
UY
UY
yz
UY
WG
WG
qy
QQ
QQ
QQ
QQ
QQ
QQ
QQ
QQ
QQ
QQ
QQ
QQ
QQ
QQ
KF
KF
KF
KF
KF
kg
kg
KF
GD
qN
"}
(25,1,1) = {"
qN
VI
KF
KF
kg
KF
KF
KF
KF
KF
QQ
QQ
QQ
QQ
QQ
QQ
QQ
QQ
QQ
QQ
QQ
QQ
QQ
QQ
QQ
QQ
QQ
QQ
qy
zc
VP
cM
VP
zc
HJ
qy
VP
VP
HJ
qy
QQ
QQ
QQ
QQ
QQ
QQ
QQ
QQ
QQ
QQ
QQ
QQ
QQ
QQ
KF
KF
KF
KF
KF
kg
kg
KF
GD
qN
"}
(26,1,1) = {"
qN
VI
KF
KF
kg
KF
KF
KF
KF
KF
QQ
QQ
QQ
QQ
QQ
QQ
QQ
QQ
QQ
QQ
QQ
QQ
QQ
QQ
QQ
QQ
QQ
QQ
qy
GR
GR
GR
GR
GR
GR
qy
fy
GR
GR
qy
QQ
QQ
QQ
QQ
QQ
QQ
QQ
QQ
QQ
QQ
QQ
QQ
QQ
QQ
KF
KF
KF
KF
KF
kg
kg
KF
GD
qN
"}
(27,1,1) = {"
qN
VI
KF
KF
kg
KF
KF
KF
KF
KF
QQ
QQ
QQ
QQ
QQ
QQ
QQ
QQ
QQ
QQ
QQ
QQ
QQ
QQ
QQ
QQ
QQ
QQ
qy
WX
GX
YR
CM
WX
kf
kf
fy
kf
kf
qy
QQ
QQ
QQ
QQ
QQ
QQ
QQ
QQ
QQ
QQ
QQ
QQ
QQ
QQ
KF
KF
KF
KF
KF
kg
kg
KF
GD
qN
"}
(28,1,1) = {"
qN
VI
KF
KF
kg
KF
KF
KF
KF
KF
QQ
QQ
QQ
QQ
QQ
QQ
QQ
QQ
QQ
QQ
QQ
QQ
QQ
QQ
QQ
QQ
QQ
QQ
qy
ru
ru
Ut
ru
ru
kf
pd
WG
Yc
kf
qy
QQ
QQ
QQ
QQ
QQ
QQ
QQ
QQ
QQ
QQ
QQ
QQ
QQ
QQ
KF
KF
KF
KF
KF
kg
kg
KF
GD
qN
"}
(29,1,1) = {"
qN
VI
KF
KF
kg
KF
KF
KF
KF
KF
QQ
QQ
QQ
QQ
QQ
QQ
QQ
QQ
QQ
QQ
QQ
QQ
QQ
QQ
QQ
QQ
QQ
QQ
qy
ru
pd
WG
Yc
ru
kf
pd
WG
Yc
kf
qy
QQ
QQ
QQ
QQ
QQ
QQ
QQ
QQ
QQ
QQ
QQ
QQ
QQ
QQ
KF
KF
KF
KF
KF
kg
kg
KF
GD
qN
"}
(30,1,1) = {"
qN
Ev
KF
KF
kg
KF
KF
KF
KF
KF
QQ
QQ
QQ
QQ
QQ
QQ
QQ
QQ
QQ
QQ
QQ
QQ
QQ
QQ
QQ
QQ
QQ
QQ
qy
ru
pd
WG
Yc
ru
kf
pd
WG
Yc
kf
qy
QQ
QQ
QQ
QQ
QQ
QQ
QQ
QQ
QQ
QQ
QQ
QQ
QQ
QQ
KF
KF
KF
KF
KF
kg
kg
KF
IV
qN
"}
(31,1,1) = {"
qN
VI
KF
KF
kg
KF
KF
KF
KF
KF
QQ
QQ
QQ
QQ
QQ
QQ
QQ
QQ
QQ
QQ
QQ
QQ
QQ
QQ
QQ
QQ
QQ
QQ
qy
ru
pd
WG
Yc
ru
kf
pd
WG
Yc
kf
qy
QQ
QQ
QQ
QQ
QQ
QQ
QQ
QQ
QQ
QQ
QQ
QQ
QQ
QQ
KF
KF
KF
KF
KF
kg
kg
KF
GD
qN
"}
(32,1,1) = {"
qN
VI
KF
KF
kg
KF
KF
KF
KF
KF
QQ
QQ
QQ
qS
QQ
QQ
QQ
QQ
QQ
QQ
QQ
QQ
QQ
QQ
QQ
QQ
QQ
QQ
qy
ru
pd
WG
Yc
ru
kf
pd
WG
Yc
kf
qy
QQ
QQ
QQ
QQ
QQ
QQ
QQ
QQ
QQ
QQ
HK
QQ
QQ
QQ
KF
KF
KF
KF
KF
kg
kg
KF
GD
qN
"}
(33,1,1) = {"
qN
VI
KF
KF
kg
KF
KF
KF
KF
KF
QQ
QQ
QQ
qS
QQ
QQ
QQ
QQ
QQ
QQ
QQ
QQ
QQ
QQ
QQ
QQ
QQ
QQ
qy
ru
pd
WG
Yc
ru
kf
pd
WG
Yc
kf
qy
QQ
QQ
QQ
QQ
QQ
QQ
QQ
QQ
QQ
QQ
HK
QQ
QQ
QQ
KF
KF
KF
KF
KF
kg
kg
KF
GD
qN
"}
(34,1,1) = {"
qN
VI
KF
KF
kg
KF
KF
KF
KF
KF
QQ
QQ
QQ
QQ
QQ
QQ
QQ
QQ
QQ
QQ
QQ
QQ
QQ
QQ
QQ
QQ
QQ
QQ
qy
ru
pd
WG
Yc
ru
kf
kf
Cd
kf
kf
qy
QQ
QQ
QQ
QQ
QQ
QQ
QQ
QQ
QQ
QQ
QQ
QQ
QQ
QQ
KF
KF
KF
KF
KF
kg
kg
KF
GD
qN
"}
(35,1,1) = {"
qN
Ev
KF
KF
kg
KF
KF
KF
KF
KF
QQ
QQ
QQ
QQ
QQ
QQ
QQ
QQ
QQ
QQ
QQ
QQ
QQ
QQ
QQ
QQ
QQ
QQ
qy
ru
ru
fy
ru
ru
WX
SR
Se
Qe
WX
qy
QQ
QQ
QQ
QQ
QQ
QQ
QQ
QQ
QQ
QQ
QQ
QQ
QQ
QQ
KF
KF
KF
KF
KF
kg
kg
KF
IV
qN
"}
(36,1,1) = {"
qN
VI
KF
KF
kg
KF
KF
KF
KF
KF
QQ
QQ
QQ
QQ
QQ
QQ
QQ
QQ
QQ
QQ
QQ
QQ
QQ
QQ
QQ
QQ
QQ
QQ
qy
GR
GR
fy
qy
GR
GR
GR
GR
GR
GR
qy
QQ
QQ
QQ
QQ
QQ
QQ
QQ
QQ
QQ
QQ
QQ
QQ
QQ
QQ
KF
KF
KF
KF
KF
kg
kg
KF
GD
qN
"}
(37,1,1) = {"
qN
VI
KF
KF
kg
KF
KF
KF
KF
KF
QQ
QQ
QQ
QQ
QQ
QQ
QQ
QQ
QQ
QQ
QQ
QQ
QQ
QQ
QQ
QQ
QQ
QQ
qy
hm
is
is
qy
is
GB
is
GB
is
cK
qy
QQ
QQ
QQ
QQ
QQ
QQ
QQ
QQ
QQ
QQ
QQ
QQ
QQ
QQ
KF
KF
KF
KF
KF
kg
kg
KF
GD
qN
"}
(38,1,1) = {"
qN
VI
KF
KF
kg
KF
KF
KF
KF
KF
QQ
QQ
QQ
QQ
QQ
QQ
QQ
QQ
QQ
QQ
QQ
QQ
QQ
QQ
QQ
QQ
QQ
QQ
qy
WG
WG
UY
yz
WG
WG
iy
IY
iy
UY
qy
QQ
QQ
QQ
QQ
QQ
QQ
QQ
QQ
QQ
QQ
QQ
QQ
QQ
QQ
KF
KF
KF
KF
KF
kg
kg
KF
GD
qN
"}
(39,1,1) = {"
qN
VI
KF
KF
kg
KF
KF
KF
KF
KF
QQ
QQ
QQ
QQ
QQ
QQ
QQ
QQ
QQ
QQ
QQ
QQ
QQ
QQ
QQ
QQ
QQ
QQ
qy
WG
WG
WG
UL
IY
UY
IY
WV
WG
IY
qy
QQ
QQ
QQ
QQ
QQ
QQ
QQ
QQ
QQ
QQ
QQ
QQ
QQ
QQ
KF
KF
KF
KF
KF
kg
kg
KF
GD
qN
"}
(40,1,1) = {"
qN
VI
KF
KF
kg
KF
KF
KF
KF
KF
QQ
QQ
QQ
QQ
QQ
QQ
QQ
QQ
QQ
QQ
QQ
QQ
QQ
QQ
QQ
QQ
QQ
QQ
qy
WG
WG
UY
UL
UY
IY
WG
UY
IY
WG
qy
QQ
QQ
QQ
QQ
QQ
QQ
QQ
QQ
QQ
QQ
QQ
QQ
QQ
QQ
KF
KF
KF
KF
KF
kg
kg
KF
GD
qN
"}
(41,1,1) = {"
qN
VI
KF
KF
kg
KF
KF
KF
KF
KF
QQ
QQ
QQ
QQ
QQ
QQ
QQ
QQ
QQ
QQ
QQ
QQ
QQ
QQ
QQ
QQ
QQ
QQ
qy
WG
UY
WG
qy
IY
WG
IY
IY
WG
UY
qy
QQ
QQ
QQ
QQ
QQ
QQ
QQ
QQ
QQ
QQ
QQ
QQ
QQ
QQ
KF
KF
KF
KF
KF
kg
kg
KF
GD
qN
"}
(42,1,1) = {"
qN
VI
KF
KF
kg
KF
KF
KF
KF
KF
QQ
QQ
QQ
QQ
QQ
QQ
QQ
QQ
QQ
QQ
QQ
QQ
QQ
QQ
QQ
QQ
QQ
QQ
qy
py
VP
VP
qy
HJ
zc
HJ
zc
VP
zc
qy
QQ
QQ
QQ
QQ
QQ
QQ
QQ
QQ
QQ
QQ
QQ
QQ
QQ
QQ
KF
KF
KF
KF
KF
kg
kg
KF
GD
qN
"}
(43,1,1) = {"
qN
VI
KF
KF
kg
KF
KF
KF
KF
KF
QQ
QQ
QQ
QQ
QQ
QQ
QQ
QQ
QQ
QQ
QQ
QQ
QQ
QQ
QQ
QQ
QQ
QQ
qy
qy
qy
qy
qy
qy
qy
qy
qy
qy
qy
qy
QQ
QQ
QQ
QQ
QQ
QQ
QQ
QQ
QQ
QQ
QQ
QQ
QQ
QQ
KF
KF
KF
KF
KF
kg
kg
KF
GD
qN
"}
(44,1,1) = {"
qN
VI
KF
KF
kg
KF
KF
KF
KF
KF
tW
QQ
QQ
QQ
QQ
QQ
QQ
QQ
QQ
QQ
QQ
QQ
QQ
QQ
QQ
QQ
QQ
QQ
QQ
QQ
QQ
QQ
QQ
QQ
QQ
QQ
QQ
QQ
QQ
QQ
QQ
QQ
QQ
QQ
QQ
QQ
QQ
QQ
QQ
QQ
QQ
QQ
QQ
tW
KF
KF
KF
KF
KF
kg
kg
KF
GD
qN
"}
(45,1,1) = {"
qN
VI
KF
KF
kg
KF
KF
KF
KF
KF
QQ
QQ
QQ
QQ
QQ
QQ
QQ
QQ
QQ
QQ
QQ
QQ
QQ
QQ
QQ
QQ
QQ
QQ
QQ
QQ
QQ
QQ
QQ
QQ
QQ
QQ
QQ
QQ
QQ
QQ
QQ
QQ
QQ
QQ
QQ
QQ
QQ
QQ
QQ
QQ
QQ
QQ
QQ
QQ
KF
KF
KF
KF
KF
kg
kg
KF
GD
qN
"}
(46,1,1) = {"
qN
VI
KF
KF
kg
KF
KF
KF
KF
KF
QQ
QQ
QQ
QQ
QQ
QQ
QQ
QQ
QQ
QQ
QQ
QQ
QQ
QQ
QQ
QQ
QQ
QQ
QQ
QQ
QQ
QQ
QQ
QQ
QQ
QQ
QQ
QQ
QQ
QQ
QQ
QQ
QQ
QQ
QQ
QQ
QQ
QQ
QQ
QQ
QQ
QQ
QQ
QQ
KF
KF
KF
KF
KF
kg
kg
KF
GD
qN
"}
(47,1,1) = {"
qN
VI
KF
KF
kg
KF
KF
KF
KF
KF
QQ
QQ
QQ
QQ
QQ
QQ
QQ
QQ
QQ
QQ
QQ
QQ
QQ
QQ
QQ
QQ
QQ
QQ
QQ
QQ
QQ
QQ
QQ
QQ
QQ
QQ
QQ
QQ
QQ
QQ
QQ
QQ
QQ
QQ
QQ
QQ
QQ
QQ
QQ
QQ
QQ
QQ
QQ
QQ
KF
KF
KF
KF
KF
kg
kg
KF
GD
qN
"}
(48,1,1) = {"
qN
VI
KF
KF
kg
KF
KF
KF
KF
KF
QQ
QQ
QQ
QQ
QQ
QQ
QQ
QQ
QQ
QQ
QQ
QQ
QQ
QQ
QQ
QQ
QQ
QQ
QQ
QQ
QQ
QQ
QQ
QQ
QQ
QQ
QQ
QQ
QQ
QQ
QQ
QQ
QQ
QQ
QQ
QQ
QQ
QQ
QQ
QQ
QQ
QQ
QQ
QQ
KF
KF
KF
KF
KF
kg
kg
KF
GD
qN
"}
(49,1,1) = {"
qN
VI
Qh
KF
kg
KF
KF
KF
KF
KF
QQ
QQ
QQ
QQ
QQ
QQ
QQ
QQ
QQ
QQ
QQ
QQ
QQ
QQ
QQ
QQ
QQ
QQ
QQ
QQ
QQ
QQ
QQ
QQ
QQ
QQ
QQ
QQ
QQ
QQ
QQ
QQ
QQ
QQ
QQ
QQ
QQ
QQ
QQ
QQ
QQ
QQ
QQ
QQ
KF
KF
KF
KF
KF
kg
kg
Qh
GD
qN
"}
(50,1,1) = {"
qN
VI
KF
KF
kg
KF
KF
KF
KF
KF
QQ
QQ
QQ
QQ
QQ
QQ
QQ
QQ
QQ
QQ
QQ
QQ
QQ
QQ
QQ
QQ
QQ
QQ
QQ
QQ
QQ
QQ
QQ
QQ
QQ
QQ
QQ
QQ
QQ
QQ
QQ
QQ
QQ
QQ
QQ
QQ
QQ
QQ
QQ
QQ
QQ
QQ
QQ
QQ
KF
KF
KF
KF
KF
kg
kg
KF
GD
qN
"}
(51,1,1) = {"
qN
VI
KF
KF
kg
KF
KF
KF
KF
KF
QQ
QQ
QQ
QQ
QQ
QQ
QQ
QQ
QQ
QQ
QQ
QQ
QQ
QQ
QQ
QQ
QQ
QQ
QQ
QQ
QQ
oS
oS
QQ
QQ
QQ
QQ
QQ
QQ
QQ
QQ
QQ
QQ
QQ
QQ
QQ
QQ
QQ
QQ
QQ
QQ
QQ
QQ
QQ
KF
KF
KF
KF
KF
kg
kg
KF
GD
qN
"}
(52,1,1) = {"
qN
VI
KF
KF
kg
KF
KF
KF
KF
KF
QQ
QQ
QQ
QQ
QQ
QQ
QQ
QQ
QQ
QQ
QQ
QQ
QQ
QQ
QQ
QQ
QQ
QQ
QQ
QQ
QQ
QQ
QQ
QQ
QQ
QQ
QQ
QQ
QQ
QQ
QQ
QQ
QQ
QQ
QQ
QQ
QQ
QQ
QQ
QQ
QQ
QQ
QQ
QQ
KF
KF
KF
KF
KF
kg
kg
KF
GD
qN
"}
(53,1,1) = {"
qN
VI
KF
KF
kg
KF
KF
KF
KF
KF
QQ
QQ
QQ
QQ
QQ
QQ
QQ
QQ
QQ
QQ
QQ
QQ
QQ
QQ
QQ
QQ
QQ
QQ
QQ
QQ
QQ
QQ
QQ
QQ
QQ
QQ
QQ
QQ
QQ
QQ
QQ
QQ
QQ
QQ
QQ
QQ
QQ
QQ
QQ
QQ
QQ
QQ
QQ
QQ
KF
KF
KF
KF
KF
kg
kg
KF
GD
qN
"}
(54,1,1) = {"
qN
VI
KF
KF
kg
KF
KF
KF
KF
KF
Rs
QQ
QQ
QQ
QQ
QQ
QQ
QQ
QQ
QQ
tW
QQ
QQ
QQ
QQ
QQ
QQ
QQ
QQ
QQ
QQ
QQ
QQ
QQ
QQ
QQ
QQ
QQ
QQ
QQ
QQ
QQ
QQ
tW
QQ
QQ
QQ
QQ
QQ
QQ
QQ
QQ
QQ
Rs
KF
KF
KF
KF
KF
kg
kg
KF
GD
qN
"}
(55,1,1) = {"
qN
VI
KF
KF
kg
KF
KF
KF
KF
DA
nm
nm
nm
nm
nm
nm
nm
nm
nm
nm
nm
nm
nm
nm
nm
nm
nm
nm
nm
nm
nm
nm
nm
nm
nm
nm
nm
nm
nm
nm
nm
nm
nm
nm
nm
nm
nm
nm
nm
nm
nm
nm
nm
nm
CF
KF
KF
KF
KF
kg
kg
KF
GD
qN
"}
(56,1,1) = {"
qN
VI
KF
KF
kg
KF
KF
KF
DA
nm
nm
nm
nm
nm
nm
nm
nm
nm
nm
nm
nm
nm
nm
nm
nm
nm
nm
nm
nm
nm
nm
nm
nm
nm
nm
nm
nm
nm
nm
nm
nm
nm
nm
nm
nm
nm
nm
nm
nm
nm
nm
nm
nm
nm
nm
CF
KF
KF
KF
kg
kg
KF
GD
qN
"}
(57,1,1) = {"
qN
VI
KF
KF
kg
KF
KF
DA
nm
nm
nm
nm
nm
nm
nm
nm
nm
nm
nm
nm
nm
nm
nm
nm
nm
nm
nm
nm
nm
nm
nm
nm
nm
nm
nm
nm
nm
nm
nm
nm
nm
nm
nm
nm
nm
nm
nm
nm
nm
nm
nm
nm
nm
nm
nm
nm
CF
KF
KF
kg
kg
KF
GD
qN
"}
(58,1,1) = {"
qN
VI
KF
KF
kg
KF
DA
nm
nm
nm
nm
nm
nm
nm
nm
nm
nm
nm
nm
nm
nm
nm
nm
nm
nm
nm
nm
nm
nm
nm
nm
nm
nm
nm
nm
nm
nm
nm
nm
nm
nm
nm
nm
nm
nm
nm
nm
nm
nm
nm
nm
nm
nm
nm
nm
nm
nm
CF
KF
kg
kg
KF
GD
qN
"}
(59,1,1) = {"
qN
VI
KF
KF
kg
DA
nm
nm
nm
nm
nm
nm
nm
nm
nm
nm
nm
nm
nm
nm
nm
nm
nm
nm
nm
nm
nm
nm
nm
nm
nm
nm
nm
nm
nm
nm
nm
nm
nm
nm
nm
nm
nm
nm
nm
nm
nm
nm
nm
nm
nm
nm
nm
nm
nm
nm
nm
nm
CF
kg
kg
KF
GD
qN
"}
(60,1,1) = {"
qN
VI
KF
KF
DA
nm
nm
nm
nm
nm
nm
nm
nm
nm
nm
nm
nm
nm
nm
nm
nm
nm
nm
nm
nm
nm
nm
nm
nm
nm
nm
nm
nm
nm
nm
nm
nm
nm
nm
nm
nm
nm
nm
nm
nm
nm
nm
nm
nm
nm
nm
nm
nm
nm
nm
nm
nm
nm
nm
CF
kg
KF
GD
qN
"}
(61,1,1) = {"
qN
VI
KF
DA
nm
nm
nm
nm
nm
nm
nm
nm
nm
nm
nm
nm
nm
nm
nm
nm
nm
nm
nm
nm
nm
nm
nm
nm
nm
nm
nm
nm
nm
nm
nm
nm
nm
nm
nm
nm
nm
nm
nm
nm
nm
nm
nm
nm
nm
nm
nm
nm
nm
nm
nm
nm
nm
nm
nm
nm
CF
KF
GD
qN
"}
(62,1,1) = {"
qN
VI
DA
nm
nm
nm
nm
nm
nm
nm
nm
nm
nm
nm
nm
Ld
nm
nm
nm
nm
nm
nm
nm
nm
nm
nm
nm
nm
nm
nm
nm
nm
nm
nm
nm
nm
nm
nm
nm
nm
nm
nm
nm
nm
nm
nm
nm
nm
Ld
nm
nm
nm
nm
nm
nm
nm
nm
nm
nm
nm
nm
CF
GD
qN
"}
(63,1,1) = {"
qN
Sn
sz
sz
sz
sz
sz
sz
sz
sz
sz
sz
sz
sz
sz
sz
sz
sz
sz
sz
sz
sz
sz
sz
sz
sz
sz
sz
Ch
Ms
sz
sz
sz
sz
Ms
Ch
sz
sz
sz
sz
sz
sz
sz
sz
sz
sz
sz
sz
sz
sz
sz
sz
sz
sz
sz
sz
sz
sz
sz
sz
sz
sz
Sn
qN
"}
(64,1,1) = {"
qN
qN
qN
qN
qN
qN
qN
qN
qN
qN
qN
qN
qN
qN
qN
qN
qN
qN
qN
qN
qN
qN
qN
qN
qN
qN
qN
qN
Li
Li
qN
qN
qN
qN
Li
Li
qN
qN
qN
qN
qN
qN
qN
qN
qN
qN
qN
qN
qN
qN
qN
qN
qN
qN
qN
qN
qN
qN
qN
qN
qN
qN
qN
qN
"}
