//MAP CONVERTED BY dmm2tgm.py THIS HEADER COMMENT PREVENTS RECONVERSION, DO NOT REMOVE
"at" = (
/obj/structure/stairs/west,
/obj/structure/sign/poster/random/directional/north,
/turf/open/floor/iron,
/area/centcom/basketball)
"aw" = (
/obj/structure/table,
/obj/item/ammo_box/strilka310,
/obj/item/ammo_box/strilka310,
/obj/item/ammo_box/strilka310,
/obj/effect/turf_decal/stripes/line{
	dir = 8
	},
/turf/open/floor/iron/dark,
/area/centcom/basketball)
"aE" = (
/obj/effect/turf_decal/plaque{
	icon_state = "derelict6"
	},
/turf/open/floor/iron/dark/small,
/area/centcom/basketball)
"be" = (
/obj/machinery/power/shuttle_engine/heater,
/obj/effect/turf_decal/stripes/full,
/turf/open/floor/plating,
/area/centcom/basketball)
"bA" = (
/obj/effect/turf_decal/stripes/line{
	dir = 4
	},
/obj/effect/decal/cleanable/blood/oil,
/obj/item/lead_pipe,
/turf/open/floor/plating,
/area/centcom/basketball)
"cz" = (
/obj/structure/chair/stool/directional/east,
/obj/effect/decal/cleanable/dirt,
/turf/open/floor/plating,
/area/centcom/basketball)
"dg" = (
/obj/machinery/vending/sovietsoda,
/turf/open/floor/iron,
/area/centcom/basketball)
"dr" = (
/obj/effect/turf_decal/stripes/line{
	dir = 9
	},
/turf/open/floor/engine,
/area/centcom/basketball)
"dC" = (
/obj/effect/turf_decal/plaque{
	icon_state = "derelict7"
	},
/turf/open/floor/iron/dark/small,
/area/centcom/basketball)
"dJ" = (
/obj/structure/training_machine,
/obj/item/target/syndicate,
/obj/effect/turf_decal/stripes/box,
/turf/open/floor/engine,
/area/centcom/basketball)
"dM" = (
/obj/structure/table,
/obj/item/reagent_containers/cup/glass/bottle/vodka,
/obj/item/reagent_containers/cup/glass/drinkingglass/shotglass{
	pixel_x = -10;
	pixel_y = 3
	},
/obj/item/reagent_containers/cup/glass/drinkingglass/shotglass{
	pixel_x = 8
	},
/turf/open/floor/iron/dark,
/area/centcom/basketball)
"dS" = (
/obj/effect/turf_decal/plaque{
	icon_state = "derelict9"
	},
/turf/open/floor/iron/dark/small,
/area/centcom/basketball)
"eS" = (
/turf/open/floor/catwalk_floor,
/area/centcom/basketball)
"eU" = (
/turf/open/floor/iron/dark/small,
/area/centcom/basketball)
"fi" = (
/obj/machinery/vending/cigarette,
/turf/open/floor/iron,
/area/centcom/basketball)
"fj" = (
/obj/effect/turf_decal/stripes/line{
	dir = 1
	},
/turf/open/floor/plating,
/area/centcom/basketball)
"fu" = (
/obj/structure/table/reinforced/titaniumglass,
/obj/effect/decal/cleanable/dirt,
/obj/item/pipe_dispenser,
/turf/open/floor/plating,
/area/centcom/basketball)
"fB" = (
/obj/structure/sign/poster/contraband/communist_state,
/turf/closed/indestructible/fakeglass,
/area/centcom/basketball)
"gk" = (
/obj/structure/sign/warning/firing_range,
/turf/closed/indestructible/riveted/plastinum,
/area/centcom/basketball)
"gq" = (
/obj/effect/turf_decal/stripes/line{
	dir = 4
	},
/turf/open/floor/iron/dark,
/area/centcom/basketball)
"hf" = (
/obj/effect/turf_decal/plaque{
	icon_state = "derelict15"
	},
/turf/open/floor/iron/dark/small,
/area/centcom/basketball)
"hB" = (
/obj/effect/decal/cleanable/blood/oil/slippery,
/turf/open/floor/plating,
/area/centcom/basketball)
"jj" = (
/obj/machinery/computer/security/telescreen/entertainment/directional/east,
/turf/open/floor/iron,
/area/centcom/basketball)
"jr" = (
/obj/effect/turf_decal/tile/dark_red/full,
/obj/effect/landmark/basketball/team_spawn/away,
/turf/open/floor/iron/large,
/area/centcom/basketball)
"kc" = (
/turf/open/floor/engine,
/area/centcom/basketball)
"kp" = (
/obj/effect/turf_decal/plaque{
	icon_state = "derelict5"
	},
/turf/open/floor/iron/dark/small,
/area/centcom/basketball)
"ku" = (
/obj/effect/turf_decal/stripes/corner{
	dir = 8
	},
/turf/open/floor/iron/dark/small,
/area/centcom/basketball)
"kF" = (
/obj/structure/stairs/east,
/obj/structure/sign/poster/random/directional/south,
/turf/open/floor/iron/dark/small,
/area/centcom/basketball)
"kT" = (
/obj/item/kirbyplants/organic/plant22,
/turf/open/floor/iron/dark,
/area/centcom/basketball)
"ly" = (
/obj/structure/table/reinforced,
/obj/machinery/door/window/right/directional/east{
	name = "Shooting Range"
	},
/obj/item/gun/ballistic/rifle/boltaction{
	pixel_y = 10
	},
/obj/item/gun/ballistic/rifle/boltaction,
/turf/open/floor/iron/dark,
/area/centcom/basketball)
"lD" = (
/obj/structure/stairs/east,
/obj/structure/sign/poster/random/directional/north,
/turf/open/floor/iron,
/area/centcom/basketball)
"lR" = (
/obj/structure/training_machine,
/obj/item/target/clown,
/obj/effect/turf_decal/stripes/box,
/turf/open/floor/engine,
/area/centcom/basketball)
"mp" = (
/obj/effect/turf_decal/tile/dark_red/full,
/turf/open/floor/iron/large,
/area/centcom/basketball)
"my" = (
/obj/effect/turf_decal/stripes/corner{
	dir = 1
	},
/obj/effect/decal/cleanable/glass,
/turf/open/floor/plating,
/area/centcom/basketball)
"mV" = (
/obj/effect/decal/cleanable/blood/oil/slippery,
/obj/effect/decal/cleanable/dirt,
/turf/open/floor/plating,
/area/centcom/basketball)
"nE" = (
/obj/effect/turf_decal/box,
/turf/open/floor/iron/dark,
/area/centcom/basketball)
"nW" = (
/obj/effect/turf_decal/stripes/line,
/turf/open/floor/iron/dark/small,
/area/centcom/basketball)
"oh" = (
/obj/effect/turf_decal/plaque{
	icon_state = "derelict14"
	},
/turf/open/floor/iron/dark/small,
/area/centcom/basketball)
"oR" = (
/obj/item/weldingtool,
/obj/effect/decal/cleanable/dirt,
/turf/open/floor/plating,
/area/centcom/basketball)
"pn" = (
/obj/structure/stairs/west,
/turf/open/floor/iron,
/area/centcom/basketball)
"pu" = (
/obj/effect/turf_decal/stripes/line{
	dir = 8
	},
/turf/open/floor/iron/dark,
/area/centcom/basketball)
"qU" = (
/obj/effect/turf_decal/plaque{
	icon_state = "derelict10"
	},
/turf/open/floor/iron/dark/small,
/area/centcom/basketball)
"rS" = (
/obj/structure/stairs/east,
/turf/open/floor/iron/dark/small,
/area/centcom/basketball)
"rU" = (
/obj/item/crowbar,
/turf/open/floor/catwalk_floor,
/area/centcom/basketball)
"sb" = (
/obj/structure/table/reinforced,
/obj/item/gun/ballistic/rifle/boltaction{
	pixel_y = 5
	},
/obj/item/gun/ballistic/rifle/boltaction,
/obj/machinery/door/window/right/directional/west{
	name = "Shooting Range"
	},
/turf/open/floor/iron/dark,
/area/centcom/basketball)
"su" = (
/obj/item/pushbroom,
/turf/open/floor/plating,
/area/centcom/basketball)
"tO" = (
/turf/open/floor/plating,
/area/centcom/basketball)
"tU" = (
/obj/effect/decal/cleanable/blood/splatter/oil,
/turf/open/floor/plating,
/area/centcom/basketball)
"tX" = (
/turf/open/floor/iron,
/area/centcom/basketball)
"uH" = (
/obj/effect/turf_decal/plaque{
	icon_state = "derelict16"
	},
/turf/open/floor/iron/dark/small,
/area/centcom/basketball)
"uR" = (
/obj/structure/chair/stool/directional/south,
/turf/open/floor/plating,
/area/centcom/basketball)
"uW" = (
/obj/effect/turf_decal/plaque{
	icon_state = "derelict4"
	},
/turf/open/floor/iron/dark/small,
/area/centcom/basketball)
"vo" = (
/obj/effect/turf_decal/stripes/line{
	dir = 8
	},
/obj/effect/decal/cleanable/blood/splatter/oil,
/obj/effect/decal/cleanable/dirt,
/obj/item/shard,
/turf/open/floor/plating,
/area/centcom/basketball)
"wt" = (
/obj/effect/turf_decal/stripes/line{
	dir = 10
	},
/turf/open/floor/engine,
/area/centcom/basketball)
"wZ" = (
/obj/machinery/pipedispenser,
/turf/open/floor/catwalk_floor,
/area/centcom/basketball)
"xP" = (
/obj/effect/turf_decal/tile/dark_red/full,
/obj/effect/decal/hammerandsickle{
	pixel_y = -42
	},
/turf/open/floor/iron/large,
/area/centcom/basketball)
"zr" = (
/obj/effect/turf_decal/plaque{
	icon_state = "derelict13"
	},
/obj/effect/landmark/basketball/team_spawn/referee,
/turf/open/floor/iron/dark/small,
/area/centcom/basketball)
"zy" = (
/obj/effect/turf_decal/stripes/line{
	dir = 6
	},
/turf/open/floor/engine,
/area/centcom/basketball)
"zZ" = (
/obj/effect/turf_decal/stripes/corner{
	dir = 4
	},
/obj/effect/decal/cleanable/dirt,
/turf/open/floor/plating,
/area/centcom/basketball)
"Ax" = (
/obj/structure/rack,
/obj/item/storage/toolbox/mechanical,
/turf/open/floor/catwalk_floor,
/area/centcom/basketball)
"AC" = (
/obj/effect/turf_decal/stripes/corner{
	dir = 1
	},
/obj/item/clothing/head/utility/hardhat/orange,
/turf/open/floor/plating,
/area/centcom/basketball)
"AI" = (
/obj/machinery/status_display,
/turf/closed/indestructible/fakeglass,
/area/centcom/basketball)
"AU" = (
/obj/structure/table/reinforced/titaniumglass,
/obj/item/clothing/head/utility/welding,
/turf/open/floor/plating,
/area/centcom/basketball)
"Bd" = (
/obj/structure/table,
/obj/item/ammo_box/strilka310,
/obj/item/ammo_box/strilka310,
/obj/item/ammo_box/strilka310,
/turf/open/floor/iron/dark,
/area/centcom/basketball)
"BJ" = (
/obj/machinery/power/shuttle_engine/large{
	dir = 4
	},
/turf/open/floor/plating,
/area/centcom/basketball)
"Cv" = (
/obj/effect/landmark/basketball/team_spawn/home_hoop,
/obj/structure/hoop/minigame{
	dir = 4
	},
/obj/effect/turf_decal/tile/dark_red/full,
/turf/open/floor/iron/large,
/area/centcom/basketball)
"Cw" = (
/turf/closed/indestructible/fakeglass,
/area/centcom/basketball)
"CD" = (
/obj/effect/turf_decal/stripes/line{
	dir = 8
	},
/obj/effect/decal/cleanable/dirt,
/turf/open/floor/plating,
/area/centcom/basketball)
"CV" = (
/obj/effect/turf_decal/stripes/line{
	dir = 4
	},
/obj/effect/decal/cleanable/dirt,
/turf/open/floor/plating,
/area/centcom/basketball)
"Dt" = (
/obj/effect/turf_decal/stripes/line{
	dir = 8
	},
/turf/open/floor/engine,
/area/centcom/basketball)
"DP" = (
/obj/effect/landmark/basketball/team_spawn/away_hoop,
/obj/structure/hoop/minigame{
	dir = 8
	},
/obj/effect/turf_decal/tile/dark_red/full,
/turf/open/floor/iron/large,
/area/centcom/basketball)
"Ev" = (
/obj/effect/turf_decal/stripes/full,
/turf/open/floor/iron/dark,
/area/centcom/basketball)
"Gh" = (
/obj/effect/turf_decal/stripes/line{
	dir = 8
	},
/obj/machinery/mech_bay_recharge_port{
	dir = 8
	},
/obj/effect/turf_decal/stripes/full,
/turf/open/floor/plating,
/area/centcom/basketball)
"Gi" = (
/obj/effect/turf_decal/stripes/line{
	dir = 4
	},
/turf/open/floor/engine,
/area/centcom/basketball)
"Hu" = (
/turf/closed/indestructible/riveted,
/area/centcom/basketball)
"HH" = (
/obj/effect/turf_decal/plaque{
	icon_state = "derelict1"
	},
/obj/effect/turf_decal/stripes/line,
/turf/open/floor/iron/dark/small,
/area/centcom/basketball)
"Ic" = (
/obj/structure/stairs/east,
/turf/open/floor/iron,
/area/centcom/basketball)
"IA" = (
/obj/effect/turf_decal/tile/dark_red/full,
/obj/effect/landmark/basketball/team_spawn/home,
/turf/open/floor/iron/large,
/area/centcom/basketball)
"JM" = (
/obj/effect/turf_decal/stripes/line{
	dir = 5
	},
/turf/open/floor/engine,
/area/centcom/basketball)
"JW" = (
/obj/effect/turf_decal/stripes/line{
	dir = 1
	},
/obj/item/wrench,
/turf/open/floor/plating,
/area/centcom/basketball)
"KH" = (
/obj/effect/turf_decal/plaque{
	icon_state = "derelict3"
	},
/turf/open/floor/iron/dark/small,
/area/centcom/basketball)
"Lu" = (
/obj/structure/table/reinforced/titaniumglass,
/obj/item/stack/cable_coil{
	amount = 15;
	pixel_x = 5;
	pixel_y = 12
	},
/obj/machinery/computer/security/telescreen/entertainment/directional/south,
/obj/item/stack/cable_coil{
	amount = 15
	},
/turf/open/floor/plating,
/area/centcom/basketball)
"LI" = (
/obj/effect/decal/cleanable/dirt,
/obj/effect/decal/cleanable/dirt,
/obj/item/shard,
/turf/open/floor/plating,
/area/centcom/basketball)
"LS" = (
/obj/effect/decal/cleanable/dirt,
/obj/item/broken_bottle,
/turf/open/floor/plating,
/area/centcom/basketball)
"LU" = (
/obj/effect/turf_decal/plaque{
	icon_state = "derelict12"
	},
/turf/open/floor/iron/dark/small,
/area/centcom/basketball)
"LV" = (
/obj/item/kirbyplants/organic/plant22,
/obj/structure/sign/poster/random/directional/west,
/turf/open/floor/iron,
/area/centcom/basketball)
"Ma" = (
/obj/structure/table,
/obj/item/clothing/ears/earmuffs{
	pixel_y = 7
	},
/obj/item/clothing/glasses/sunglasses{
	pixel_x = 3;
	pixel_y = -3
	},
/turf/open/floor/iron/dark,
/area/centcom/basketball)
"MS" = (
/obj/effect/turf_decal/stripes/line,
/obj/structure/training_machine,
/obj/item/reagent_containers/cup/glass/trophy/silver_cup,
/turf/open/floor/engine,
/area/centcom/basketball)
"MW" = (
/obj/structure/chair/stool/directional/west,
/turf/open/floor/plating,
/area/centcom/basketball)
"Nt" = (
/obj/structure/table/reinforced,
/obj/item/gun/ballistic/rifle/boltaction{
	pixel_y = 10
	},
/obj/machinery/door/window/right/directional/west{
	name = "Shooting Range"
	},
/turf/open/floor/iron/dark,
/area/centcom/basketball)
"Oj" = (
/obj/structure/stairs/west,
/obj/structure/sign/poster/random/directional/south,
/turf/open/floor/iron/dark/small,
/area/centcom/basketball)
"Om" = (
/mob/living/basic/bear/fightpit,
/obj/effect/turf_decal/stripes/line{
	dir = 1
	},
/turf/open/floor/engine,
/area/centcom/basketball)
"OB" = (
/mob/living/basic/bear/fightpit,
/turf/open/floor/engine,
/area/centcom/basketball)
"PU" = (
/obj/structure/table,
/obj/item/reagent_containers/cup/glass/bottle/vodka{
	pixel_x = -8
	},
/obj/item/reagent_containers/cup/glass/bottle/vodka{
	pixel_x = 6;
	pixel_y = 7
	},
/obj/item/reagent_containers/cup/glass/drinkingglass/shotglass,
/obj/item/reagent_containers/cup/glass/drinkingglass/shotglass,
/turf/open/floor/iron/dark,
/area/centcom/basketball)
"PW" = (
/obj/effect/decal/cleanable/dirt,
/obj/effect/decal/cleanable/crayon{
	icon_state = "guy"
	},
/turf/open/floor/plating,
/area/centcom/basketball)
"Qa" = (
/obj/machinery/mech_bay_recharge_port,
/obj/effect/turf_decal/stripes/full,
/turf/open/floor/plating,
/area/centcom/basketball)
"Qh" = (
/obj/effect/turf_decal/plaque{
	icon_state = "derelict11"
	},
/turf/open/floor/iron/dark/small,
/area/centcom/basketball)
"Qi" = (
/obj/structure/sign/poster/contraband/soviet_propaganda,
/turf/closed/indestructible/fakeglass,
/area/centcom/basketball)
"Ql" = (
/obj/item/kirbyplants/organic/plant22,
/obj/structure/sign/poster/random/directional/east,
/turf/open/floor/iron,
/area/centcom/basketball)
"QR" = (
/obj/structure/stairs/west,
/turf/open/floor/iron/dark/small,
/area/centcom/basketball)
"Rl" = (
/obj/effect/turf_decal/stripes/line,
/obj/structure/training_machine,
/obj/item/reagent_containers/cup/glass/trophy/gold_cup{
	pixel_x = 0
	},
/turf/open/floor/engine,
/area/centcom/basketball)
"Se" = (
/obj/effect/turf_decal/stripes/line{
	dir = 1
	},
/turf/open/floor/engine,
/area/centcom/basketball)
"Tc" = (
/turf/closed/indestructible/riveted/plastinum,
/area/centcom/basketball)
"TV" = (
/obj/effect/turf_decal/stripes/line{
	dir = 1
	},
/obj/effect/decal/cleanable/crayon{
	icon_state = "cyka"
	},
/turf/open/floor/plating,
/area/centcom/basketball)
"Uq" = (
/obj/effect/turf_decal/plaque{
	icon_state = "derelict2"
	},
/obj/effect/turf_decal/stripes/corner{
	dir = 8
	},
/turf/open/floor/iron/dark/small,
/area/centcom/basketball)
"Uv" = (
/obj/effect/turf_decal/stripes/corner,
/turf/open/floor/iron/dark/small,
/area/centcom/basketball)
"Uy" = (
/obj/effect/turf_decal/stripes/line,
/obj/structure/training_machine,
/obj/item/reagent_containers/cup/glass/trophy/bronze_cup,
/turf/open/floor/engine,
/area/centcom/basketball)
"Vr" = (
/turf/open/floor/iron/dark,
/area/centcom/basketball)
"WB" = (
/obj/machinery/computer/security/telescreen/entertainment/directional/west,
/turf/open/floor/iron,
/area/centcom/basketball)
"WK" = (
/obj/effect/turf_decal/stripes/line{
	dir = 4
	},
/obj/machinery/power/shuttle_engine/heater,
/obj/effect/turf_decal/stripes/full,
/turf/open/floor/plating,
/area/centcom/basketball)
"WM" = (
/obj/structure/sign/poster/contraband/kss13,
/turf/closed/indestructible/riveted/plastinum,
/area/centcom/basketball)
"Xm" = (
/obj/structure/table,
/obj/item/clothing/glasses/sunglasses{
	pixel_x = 3;
	pixel_y = -3
	},
/obj/item/clothing/ears/earmuffs{
	pixel_y = 7
	},
/turf/open/floor/iron/dark,
/area/centcom/basketball)
"Xn" = (
/obj/machinery/power/shuttle_engine/propulsion{
	dir = 8
	},
/turf/open/floor/plating,
/area/centcom/basketball)
"Xo" = (
/obj/structure/table/reinforced/titaniumglass,
/obj/item/storage/belt,
/obj/effect/decal/cleanable/dirt,
/obj/machinery/computer/security/telescreen/entertainment/directional/south,
/turf/open/floor/plating,
/area/centcom/basketball)
"YH" = (
/obj/effect/turf_decal/plaque{
	icon_state = "derelict8"
	},
/obj/effect/turf_decal/stripes/corner,
/turf/open/floor/iron/dark/small,
/area/centcom/basketball)
"YX" = (
/obj/effect/turf_decal/tile/dark_red/full,
/obj/item/toy/basketball,
/turf/open/floor/iron/large,
/area/centcom/basketball)
"ZM" = (
/obj/structure/table/reinforced,
/obj/machinery/door/window/right/directional/east{
	name = "Shooting Range"
	},
/obj/item/gun/ballistic/rifle/boltaction{
	pixel_y = 5
	},
/turf/open/floor/iron/dark,
/area/centcom/basketball)

(1,1,1) = {"
Hu
Hu
Hu
Hu
Hu
Hu
Hu
Hu
Hu
Hu
Hu
Hu
Hu
Hu
Hu
Hu
Hu
Hu
Hu
Hu
Hu
Hu
Hu
Hu
Hu
"}
(2,1,1) = {"
Hu
tO
tO
tO
tO
Tc
Tc
WM
Tc
Tc
Tc
Tc
Tc
Tc
Tc
Tc
Tc
WM
Tc
Tc
tO
tO
tO
tO
Hu
"}
(3,1,1) = {"
Hu
tO
tO
tO
tO
Tc
dg
tX
tX
WB
tX
tX
LV
tX
tX
WB
tX
tX
fi
Tc
tO
tO
tO
tO
Hu
"}
(4,1,1) = {"
Hu
tO
tO
tO
tO
Tc
tX
tX
tX
tX
tX
tX
tX
tX
tX
tX
tX
tX
tX
Tc
tO
tO
tO
tO
Hu
"}
(5,1,1) = {"
Hu
tO
Tc
Tc
Tc
Tc
lD
Ic
AI
Cw
Cw
Cw
Cw
Cw
Cw
Cw
AI
rS
kF
Tc
Tc
Tc
Tc
tO
Hu
"}
(6,1,1) = {"
Hu
tO
Tc
Ma
PU
kT
Vr
Vr
Cw
mp
mp
mp
Cv
mp
mp
mp
Cw
eU
Uv
CV
bA
zZ
Tc
tO
Hu
"}
(7,1,1) = {"
Hu
tO
Tc
Bd
gq
Vr
gq
Vr
Cw
mp
IA
mp
mp
mp
IA
mp
Cw
eU
nW
tO
BJ
TV
Tc
tO
Hu
"}
(8,1,1) = {"
Hu
Tc
Tc
nE
Ev
nE
Ev
nE
Cw
mp
xP
IA
IA
IA
mp
mp
Cw
dS
HH
tO
tO
JW
Tc
Tc
Hu
"}
(9,1,1) = {"
Hu
Tc
Tc
ly
Cw
ZM
Cw
ly
Qi
mp
mp
mp
mp
mp
mp
mp
fB
qU
Uq
Gh
Gh
my
cz
Tc
Hu
"}
(10,1,1) = {"
Hu
Tc
dr
Dt
Dt
Dt
Dt
wt
Cw
mp
mp
mp
mp
mp
mp
mp
Cw
Qh
KH
be
be
uR
Xo
Tc
Hu
"}
(11,1,1) = {"
Hu
gk
Om
kc
kc
kc
kc
Uy
Cw
mp
mp
mp
mp
mp
mp
mp
Cw
LU
uW
mV
LI
tU
fu
Tc
Hu
"}
(12,1,1) = {"
Hu
Tc
Se
lR
kc
dJ
OB
Rl
Cw
mp
mp
mp
YX
mp
mp
mp
Cw
zr
kp
rU
wZ
eS
Ax
Tc
Hu
"}
(13,1,1) = {"
Hu
gk
Se
kc
OB
kc
kc
MS
Cw
mp
mp
mp
mp
mp
mp
mp
Cw
oh
aE
PW
LS
su
AU
Tc
Hu
"}
(14,1,1) = {"
Hu
Tc
JM
Gi
Gi
Gi
Gi
zy
Cw
mp
mp
mp
mp
mp
mp
mp
Cw
hf
dC
oR
hB
uR
Lu
Tc
Hu
"}
(15,1,1) = {"
Hu
Tc
Tc
Cw
sb
Cw
Nt
Cw
Qi
mp
mp
mp
mp
mp
mp
mp
fB
uH
YH
WK
WK
zZ
MW
Tc
Hu
"}
(16,1,1) = {"
Hu
Tc
Tc
Ev
nE
Ev
nE
Ev
Cw
mp
mp
jr
jr
jr
mp
mp
Cw
eU
nW
Qa
Qa
fj
Tc
Tc
Hu
"}
(17,1,1) = {"
Hu
tO
Tc
aw
Vr
pu
Vr
pu
Cw
mp
jr
mp
mp
mp
jr
mp
Cw
eU
nW
Xn
Xn
fj
Tc
tO
Hu
"}
(18,1,1) = {"
Hu
tO
Tc
Xm
dM
kT
Vr
Vr
Cw
mp
mp
mp
DP
mp
mp
mp
Cw
eU
ku
vo
CD
AC
Tc
tO
Hu
"}
(19,1,1) = {"
Hu
tO
Tc
Tc
Tc
Tc
at
pn
AI
Cw
Cw
Cw
Cw
Cw
Cw
Cw
AI
QR
Oj
Tc
Tc
Tc
Tc
tO
Hu
"}
(20,1,1) = {"
Hu
tO
tO
tO
tO
Tc
tX
tX
tX
tX
tX
tX
tX
tX
tX
tX
tX
tX
tX
Tc
tO
tO
tO
tO
Hu
"}
(21,1,1) = {"
Hu
tO
tO
tO
tO
Tc
fi
tX
tX
jj
tX
tX
Ql
tX
tX
jj
tX
tX
dg
Tc
tO
tO
tO
tO
Hu
"}
(22,1,1) = {"
Hu
tO
tO
tO
tO
Tc
Tc
WM
Tc
Tc
Tc
Tc
Tc
Tc
Tc
Tc
Tc
WM
Tc
Tc
tO
tO
tO
tO
Hu
"}
(23,1,1) = {"
Hu
Hu
Hu
Hu
Hu
Hu
Hu
Hu
Hu
Hu
Hu
Hu
Hu
Hu
Hu
Hu
Hu
Hu
Hu
Hu
Hu
Hu
Hu
Hu
Hu
"}
