//MAP CONVERTED BY dmm2tgm.py THIS HEADER COMMENT PREVENTS RECONVERSION, DO NOT REMOVE
"aD" = (
/turf/closed/indestructible/reinforced,
/area/deathmatch)
"aP" = (
/obj/machinery/door/airlock/centcom,
/turf/open/space/basic,
/area/deathmatch)
"bI" = (
/obj/machinery/light/no_nightlight/directional/north,
/turf/open/indestructible,
/area/deathmatch)
"cn" = (
/turf/open/indestructible,
/area/deathmatch)
"cx" = (
/obj/machinery/vending/wallmed/directional/north,
/turf/open/indestructible,
/area/deathmatch)
"cy" = (
/obj/structure/table/reinforced/ctf,
/obj/item/gun/ballistic/shotgun/riot,
/turf/open/indestructible,
/area/deathmatch)
"eX" = (
/obj/item/ammo_casing/shotgun/frag12,
/turf/open/indestructible,
/area/deathmatch)
"fh" = (
/obj/structure/table/reinforced/ctf,
/obj/item/storage/backpack/duffelbag/syndie/ammo,
/turf/open/indestructible,
/area/deathmatch)
"ga" = (
/obj/structure/lattice,
/turf/open/space/basic,
/area/template_noop)
"gJ" = (
/obj/item/ammo_casing/shotgun/stunslug,
/turf/open/indestructible,
/area/deathmatch)
"ho" = (
/obj/effect/spawner/structure/window/reinforced/indestructible,
/turf/open/floor/plating,
/area/deathmatch)
"hB" = (
/turf/closed/indestructible/fakedoor,
/area/deathmatch)
"ih" = (
/obj/item/reagent_containers/applicator/pill/maintenance,
/turf/open/indestructible,
/area/deathmatch)
"iC" = (
/obj/machinery/light/small/directional/south,
/obj/structure/table/reinforced,
/turf/open/indestructible,
/area/deathmatch)
"jc" = (
/obj/effect/decal/cleanable/dirt/dust,
/turf/open/indestructible,
/area/deathmatch)
"jX" = (
/obj/machinery/light/small/directional/north,
/turf/open/indestructible,
/area/deathmatch)
"jY" = (
/obj/item/stack/medical/gauze{
	amount = 1
	},
/turf/open/indestructible,
/area/deathmatch)
"ka" = (
/obj/effect/decal/cleanable/blood/old,
/turf/open/indestructible,
/area/deathmatch)
"kp" = (
/obj/effect/turf_decal/stripes/corner{
	dir = 4
	},
/turf/open/indestructible,
/area/deathmatch)
"kx" = (
/obj/effect/decal/cleanable/dirt,
/obj/effect/turf_decal/stripes/line{
	dir = 1
	},
/obj/effect/landmark/deathmatch_player_spawn,
/turf/open/indestructible,
/area/deathmatch)
"lA" = (
/obj/effect/turf_decal/stripes/corner{
	dir = 1
	},
/turf/open/indestructible,
/area/deathmatch)
"lJ" = (
/obj/item/crowbar,
/obj/structure/table/reinforced,
/turf/open/indestructible,
/area/deathmatch)
"lN" = (
/obj/effect/decal/cleanable/dirt/dust,
/obj/effect/turf_decal/caution/stand_clear,
/turf/open/indestructible,
/area/deathmatch)
"mS" = (
/obj/effect/turf_decal/caution/stand_clear,
/turf/open/indestructible,
/area/deathmatch)
"mZ" = (
/obj/structure/grille,
/turf/open/indestructible,
/area/deathmatch)
"nQ" = (
/obj/effect/decal/cleanable/dirt,
/turf/open/indestructible,
/area/deathmatch)
"nS" = (
/obj/machinery/light/small/directional/north,
/obj/effect/decal/cleanable/dirt/dust,
/obj/effect/decal/cleanable/blood/gibs/old,
/turf/open/indestructible,
/area/deathmatch)
"pT" = (
/obj/structure/rack,
/obj/item/grenade/chem_grenade/cleaner,
/turf/open/indestructible,
/area/deathmatch)
"pZ" = (
/obj/structure/sign/poster/random/directional/west,
/turf/open/indestructible,
/area/deathmatch)
"qK" = (
/obj/effect/decal/cleanable/dirt,
/obj/item/reagent_containers/applicator/pill/maintenance,
/turf/open/indestructible,
/area/deathmatch)
"sk" = (
/obj/structure/sign/poster/random/directional/east,
/turf/open/indestructible,
/area/deathmatch)
"sl" = (
/obj/machinery/door/airlock/public/glass,
/obj/effect/mapping_helpers/airlock/abandoned,
/turf/open/indestructible,
/area/deathmatch)
"sF" = (
/obj/structure/extinguisher_cabinet/directional/east,
/obj/structure/closet/firecloset,
/obj/effect/turf_decal/delivery,
/turf/open/indestructible,
/area/deathmatch)
"sV" = (
/obj/structure/closet/emcloset,
/obj/effect/turf_decal/delivery,
/turf/open/indestructible,
/area/deathmatch)
"sX" = (
/obj/structure/rack,
/obj/machinery/light/small/directional/north,
/obj/item/reagent_containers/cup/soda_cans/lemon_lime,
/turf/open/indestructible,
/area/deathmatch)
"tT" = (
/obj/structure/rack,
/obj/item/stack/cable_coil,
/obj/item/assembly/igniter,
/turf/open/indestructible,
/area/deathmatch)
"ur" = (
/obj/structure/lattice,
/turf/template_noop,
/area/template_noop)
"vB" = (
/obj/machinery/light/small/directional/east,
/turf/open/indestructible,
/area/deathmatch)
"wi" = (
/obj/item/screwdriver,
/obj/structure/table/reinforced,
/turf/open/indestructible,
/area/deathmatch)
"wC" = (
/obj/item/weldingtool,
/obj/structure/rack,
/obj/item/flashlight/flare,
/turf/open/indestructible,
/area/deathmatch)
"zd" = (
/obj/machinery/vending/medical{
	desc = "Go on, smash this vending machine. You want free healing right? Do it."
	},
/turf/open/indestructible,
/area/deathmatch)
"zF" = (
/obj/effect/spawner/random/junk_shell,
/turf/open/indestructible,
/area/deathmatch)
"AG" = (
/obj/structure/lattice/catwalk,
/obj/item/storage/toolbox/mechanical/old/clean{
	desc = "An old, blue toolbox, it looks soulful."
	},
/turf/open/space/basic,
/area/template_noop)
"Bs" = (
/obj/machinery/light/small/directional/west,
/obj/effect/decal/cleanable/dirt,
/turf/open/indestructible,
/area/deathmatch)
"BU" = (
/obj/item/chainsaw,
/turf/open/indestructible,
/area/deathmatch)
"BV" = (
/obj/structure/table/reinforced,
/turf/open/indestructible,
/area/deathmatch)
"Dh" = (
/obj/structure/lattice/catwalk,
/obj/effect/mob_spawn/corpse/human/engineer/mod,
/turf/template_noop,
/area/template_noop)
"Dt" = (
/obj/effect/decal/cleanable/dirt,
/obj/effect/turf_decal/loading_area{
	dir = 4
	},
/turf/open/indestructible,
/area/deathmatch)
"Er" = (
/obj/item/clothing/head/utility/welding,
/obj/structure/table/reinforced,
/turf/open/indestructible,
/area/deathmatch)
"Ew" = (
/obj/effect/decal/cleanable/dirt/dust,
/obj/item/reagent_containers/applicator/pill/maintenance,
/turf/open/indestructible,
/area/deathmatch)
"EK" = (
/obj/machinery/light/small/directional/south,
/turf/open/indestructible,
/area/deathmatch)
"EN" = (
/obj/structure/reagent_dispensers/fueltank,
/obj/effect/turf_decal/bot,
/turf/open/indestructible,
/area/deathmatch)
"EW" = (
/obj/effect/decal/cleanable/blood/tracks,
/obj/effect/landmark/deathmatch_player_spawn,
/turf/open/indestructible,
/area/deathmatch)
"Fp" = (
/obj/structure/rack,
/obj/item/reagent_containers/applicator/pill/maintenance,
/obj/item/spear,
/turf/open/indestructible,
/area/deathmatch)
"FH" = (
/obj/effect/decal/cleanable/blood/oil/slippery,
/turf/open/indestructible,
/area/deathmatch)
"FL" = (
/turf/template_noop,
/area/template_noop)
"Gi" = (
/obj/effect/decal/cleanable/blood/gibs/limb,
/turf/open/indestructible,
/area/deathmatch)
"GA" = (
/obj/item/stack/medical/mesh{
	amount = 4
	},
/obj/item/spear,
/obj/structure/closet/emcloset,
/obj/effect/turf_decal/delivery,
/turf/open/indestructible,
/area/deathmatch)
"GF" = (
/obj/machinery/light/small/directional/west,
/turf/open/indestructible,
/area/deathmatch)
"Hd" = (
/obj/machinery/light/small/directional/north,
/obj/item/soap/nanotrasen,
/obj/structure/table/reinforced,
/turf/open/indestructible,
/area/deathmatch)
"Hp" = (
/obj/item/reagent_containers/applicator/pill/maintenance,
/obj/structure/sign/poster/random/directional/north,
/obj/structure/table/reinforced,
/turf/open/indestructible,
/area/deathmatch)
"HE" = (
/obj/structure/lattice/catwalk,
/obj/structure/statue/sandstone/assistant,
/turf/template_noop,
/area/template_noop)
"Ij" = (
/turf/open/space/basic,
/area/template_noop)
"It" = (
/obj/item/gun/ballistic/rifle/boltaction/pipegun/prime,
/obj/effect/turf_decal/box,
/turf/open/indestructible,
/area/deathmatch)
"Kt" = (
/obj/structure/table/reinforced/ctf,
/obj/item/weldingtool,
/turf/open/indestructible,
/area/deathmatch)
"KW" = (
/obj/machinery/space_heater,
/obj/effect/turf_decal/bot,
/turf/open/indestructible,
/area/deathmatch)
"La" = (
/obj/structure/sign/poster/random/directional/south,
/obj/item/flashlight/flare,
/obj/structure/table/reinforced,
/turf/open/indestructible,
/area/deathmatch)
"LJ" = (
/obj/structure/reagent_dispensers/watertank,
/obj/effect/turf_decal/bot,
/turf/open/indestructible,
/area/deathmatch)
"Mt" = (
/obj/effect/landmark/deathmatch_player_spawn,
/turf/open/indestructible,
/area/deathmatch)
"MC" = (
/obj/effect/mob_spawn/corpse/human/assistant,
/turf/template_noop,
/area/template_noop)
"Na" = (
/obj/structure/rack,
/obj/item/reagent_containers/cup/soda_cans/starkist,
/turf/open/indestructible,
/area/deathmatch)
"Ns" = (
/obj/item/stack/cable_coil,
/obj/structure/table/reinforced,
/turf/open/indestructible,
/area/deathmatch)
"NO" = (
/obj/structure/extinguisher_cabinet/directional/west,
/turf/open/indestructible,
/area/deathmatch)
"NU" = (
/obj/effect/decal/cleanable/blood,
/turf/open/indestructible,
/area/deathmatch)
"NY" = (
/obj/item/screwdriver,
/turf/open/indestructible,
/area/deathmatch)
"Ok" = (
/obj/structure/extinguisher_cabinet/directional/south,
/obj/machinery/light/small/directional/south,
/turf/open/indestructible,
/area/deathmatch)
"Om" = (
/obj/effect/decal/cleanable/dirt,
/obj/structure/sign/poster/random/directional/south,
/turf/open/indestructible,
/area/deathmatch)
"OA" = (
/obj/effect/decal/cleanable/blood/tracks,
/turf/open/indestructible,
/area/deathmatch)
"OO" = (
/obj/effect/decal/cleanable/dirt,
/obj/effect/decal/cleanable/blood/tracks,
/obj/structure/sign/poster/random/directional/east,
/turf/open/indestructible,
/area/deathmatch)
"OR" = (
/obj/item/stack/medical/suture{
	amount = 6
	},
/turf/open/indestructible,
/area/deathmatch)
"Pp" = (
/obj/machinery/light/small/directional/south,
/obj/effect/decal/cleanable/dirt,
/turf/open/indestructible,
/area/deathmatch)
"PW" = (
/obj/effect/decal/cleanable/blood/gibs/torso,
/turf/open/indestructible,
/area/deathmatch)
"Qr" = (
/obj/structure/closet/wardrobe,
/turf/open/floor/plating/airless,
/area/template_noop)
"QN" = (
/obj/item/razor,
/obj/structure/table/reinforced,
/turf/open/indestructible,
/area/deathmatch)
"QQ" = (
/obj/effect/decal/cleanable/blood/drip,
/obj/effect/turf_decal/box,
/turf/open/indestructible,
/area/deathmatch)
"Rm" = (
/obj/item/weldingtool,
/obj/structure/rack,
/turf/open/indestructible,
/area/deathmatch)
"Su" = (
/obj/effect/decal/cleanable/dirt/dust,
/obj/effect/turf_decal/box,
/obj/effect/landmark/deathmatch_player_spawn,
/turf/open/indestructible,
/area/deathmatch)
"SN" = (
/obj/effect/decal/cleanable/blood/tracks,
/obj/effect/turf_decal/caution/stand_clear,
/turf/open/indestructible,
/area/deathmatch)
"Tu" = (
/obj/machinery/light/small/directional/north,
/obj/structure/table/reinforced,
/turf/open/indestructible,
/area/deathmatch)
"TB" = (
/obj/structure/closet/firecloset,
/obj/effect/turf_decal/delivery,
/turf/open/indestructible,
/area/deathmatch)
"TP" = (
/obj/effect/mapping_helpers/airlock/abandoned,
/obj/machinery/door/airlock/public/glass,
/turf/open/indestructible,
/area/deathmatch)
"Un" = (
/obj/effect/decal/cleanable/dirt,
/obj/effect/decal/cleanable/blood/tracks{
	dir = 10
	},
/obj/effect/turf_decal/stripes/corner,
/turf/open/indestructible,
/area/deathmatch)
"Vb" = (
/obj/effect/decal/cleanable/blood/tracks{
	dir = 5
	},
/obj/effect/turf_decal/stripes/line,
/turf/open/indestructible,
/area/deathmatch)
"Xb" = (
/obj/effect/turf_decal/stripes/corner{
	dir = 8
	},
/turf/open/indestructible,
/area/deathmatch)
"XC" = (
/obj/item/assembly/igniter,
/turf/open/indestructible,
/area/deathmatch)
"XD" = (
/obj/item/holosign_creator/security,
/obj/machinery/light/small/directional/south,
/turf/open/indestructible,
/area/deathmatch)

(1,1,1) = {"
FL
FL
FL
FL
FL
ur
FL
FL
FL
FL
ur
FL
FL
FL
FL
FL
FL
FL
ur
FL
FL
FL
FL
FL
ur
FL
FL
FL
FL
"}
(2,1,1) = {"
FL
FL
FL
FL
ur
ur
ur
ur
ur
ur
ur
ur
ur
ur
HE
ur
ur
ur
ur
ur
ur
ur
ur
ur
ur
ur
FL
FL
FL
"}
(3,1,1) = {"
FL
FL
FL
FL
FL
ur
FL
FL
FL
FL
ur
FL
FL
FL
FL
FL
FL
FL
ur
FL
FL
FL
FL
FL
ur
FL
FL
FL
FL
"}
(4,1,1) = {"
FL
FL
FL
FL
FL
ur
FL
FL
FL
FL
ur
FL
FL
FL
FL
FL
FL
FL
ur
FL
FL
FL
FL
FL
ur
FL
FL
FL
FL
"}
(5,1,1) = {"
FL
FL
FL
FL
FL
aD
aD
aD
aD
aD
aD
ho
ho
ho
ho
ho
ho
ho
aD
aD
aD
aD
aD
aD
aD
FL
FL
FL
FL
"}
(6,1,1) = {"
FL
FL
FL
FL
FL
aD
cn
lN
cn
pZ
nQ
zF
zF
zF
It
zF
zF
zF
jc
cn
sk
nQ
mS
cn
aD
FL
FL
FL
FL
"}
(7,1,1) = {"
FL
FL
FL
FL
FL
aD
iC
aD
aD
aD
aD
aD
aD
BV
lJ
Ns
aD
aD
aD
aD
aD
aD
aD
Tu
aD
FL
FL
FL
FL
"}
(8,1,1) = {"
FL
FL
FL
FL
FL
aD
cn
mS
nQ
cn
cn
cn
cn
cn
jc
cn
NO
cn
cn
nQ
cn
ih
mS
cn
aD
FL
FL
FL
FL
"}
(9,1,1) = {"
FL
FL
FL
FL
FL
aD
ho
aD
aD
aD
sX
cn
EN
mZ
EN
cn
EK
aD
aD
mZ
aD
aD
aD
TP
aD
FL
FL
FL
FL
"}
(10,1,1) = {"
FL
FL
FL
FL
FL
aD
Ew
mS
Mt
nQ
sk
cn
mZ
GA
mZ
cn
NU
OA
OO
EW
OA
OA
SN
Un
aD
FL
FL
FL
FL
"}
(11,1,1) = {"
FL
FL
FL
FL
FL
aD
cn
aD
aD
aD
aD
aD
aD
aD
aD
aD
nQ
aD
aD
ho
ho
aD
aD
Vb
hB
ur
Dh
FL
FL
"}
(12,1,1) = {"
aD
aD
aD
aD
aD
aD
jX
aD
Ij
Ij
Ij
ga
Ij
Ij
Ij
aD
NY
aD
TB
cn
cn
Rm
aD
Xb
aD
FL
FL
FL
FL
"}
(13,1,1) = {"
aD
bI
cy
cy
cn
ho
jY
ho
Ij
Ij
Ij
AG
Ij
Ij
Ij
ho
Ok
aD
jX
jc
cn
EK
aD
jc
aD
FL
FL
FL
FL
"}
(14,1,1) = {"
aP
cn
cn
cn
gJ
ho
ka
aD
Ij
Ij
Ij
ga
Ij
Ij
Ij
aD
jc
aD
jY
PW
nQ
cn
aD
jX
aD
FL
FL
FL
FL
"}
(15,1,1) = {"
aD
cn
cn
cn
cn
aD
kp
aD
aD
aD
aD
aD
aD
aD
aD
aD
cn
aD
sl
aD
QN
BV
aD
ih
aD
FL
FL
FL
FL
"}
(16,1,1) = {"
aD
cx
cn
cn
cn
hB
kx
mZ
cn
sk
cn
Bs
cn
cn
cn
pZ
cn
cn
nQ
cn
QQ
Su
aD
cn
aD
FL
FL
ur
FL
"}
(17,1,1) = {"
aD
cn
eX
cn
cn
aD
lA
aD
ih
aD
tT
cn
EN
aD
aD
aD
cn
aD
EN
cn
cn
cn
cn
nQ
aD
ur
ur
ur
ur
"}
(18,1,1) = {"
aP
cn
cn
cn
cn
ho
cn
aD
cn
aD
aD
aD
aD
aD
sV
GF
cn
aD
aD
ho
ho
aD
aD
Mt
aD
FL
FL
ur
FL
"}
(19,1,1) = {"
aD
bI
fh
fh
cn
ho
cn
cn
cn
hB
vB
BU
Fp
aD
Kt
cn
Om
aD
Ij
ga
Ij
Ij
aD
mZ
aD
FL
FL
ur
FL
"}
(20,1,1) = {"
aD
aD
aD
aD
aD
aD
lJ
aD
nQ
aD
aD
BV
aD
aD
KW
cn
cn
ho
ga
Qr
ga
Ij
ho
cn
ho
FL
FL
ur
FL
"}
(21,1,1) = {"
FL
FL
FL
FL
FL
aD
aD
aD
cn
aD
Mt
Dt
cn
aD
aD
aD
cn
ho
Ij
Ij
ga
ga
ho
nQ
ho
FL
FL
ur
MC
"}
(22,1,1) = {"
FL
FL
FL
FL
FL
ur
FL
aD
cn
sl
cn
cn
FH
GF
La
aD
cn
aD
Ij
Ij
ga
Ij
aD
XC
aD
FL
FL
ur
FL
"}
(23,1,1) = {"
FL
FL
FL
FL
FL
ur
FL
aD
cn
aD
jX
cn
cn
nQ
LJ
mZ
Mt
aD
aD
ho
ho
aD
aD
cn
aD
FL
FL
ur
FL
"}
(24,1,1) = {"
FL
FL
FL
FL
FL
ur
FL
aD
nS
aD
wi
Er
Gi
cn
Na
aD
jX
jc
jc
cn
qK
cn
sk
XD
aD
ur
ur
ur
ur
"}
(25,1,1) = {"
FL
FL
FL
FL
ur
ur
ur
aD
cn
aD
aD
aD
aD
sl
aD
aD
cn
aD
sl
aD
aD
aD
aD
aD
aD
FL
FL
ur
FL
"}
(26,1,1) = {"
FL
FL
FL
FL
FL
ur
FL
ho
cn
cn
pZ
nQ
cn
cn
cn
cn
cn
aD
OR
aD
FL
FL
FL
ur
FL
FL
FL
ur
FL
"}
(27,1,1) = {"
FL
FL
FL
FL
FL
ur
FL
ho
pT
sF
Mt
mZ
aD
aD
mZ
aD
aD
aD
Pp
aD
FL
FL
FL
ur
FL
FL
FL
ur
FL
"}
(28,1,1) = {"
FL
FL
FL
FL
ur
ur
ur
aD
aD
aD
cn
cn
aD
Hd
nQ
cn
cn
cn
cn
ho
FL
FL
FL
ur
FL
FL
FL
ur
FL
"}
(29,1,1) = {"
FL
FL
FL
FL
FL
ur
FL
FL
FL
aD
wC
EK
aD
Hp
cn
aD
aD
ho
aD
aD
FL
FL
FL
ur
FL
FL
FL
ur
FL
"}
(30,1,1) = {"
FL
FL
FL
FL
FL
FL
FL
FL
FL
aD
zd
nQ
aD
EN
cn
ho
FL
FL
FL
ur
FL
FL
FL
ur
FL
FL
FL
ur
FL
"}
(31,1,1) = {"
FL
FL
FL
FL
FL
FL
FL
FL
FL
aD
mZ
cn
cn
jc
cn
aD
FL
FL
FL
ur
FL
FL
FL
ur
FL
FL
FL
ur
FL
"}
(32,1,1) = {"
FL
FL
FL
FL
FL
FL
FL
FL
FL
aD
aD
ho
ho
ho
aD
aD
ur
ur
ur
ur
ur
ur
ur
ur
ur
ur
ur
ur
ur
"}
(33,1,1) = {"
FL
FL
FL
FL
FL
FL
FL
FL
FL
FL
FL
FL
FL
FL
FL
FL
FL
FL
FL
ur
FL
FL
FL
ur
FL
FL
FL
ur
FL
"}
