//MAP CONVERTED BY dmm2tgm.py THIS HEADER COMMENT PREVENTS RECONVERSION, DO NOT REMOVE
"aa" = (
/turf/template_noop,
/area/template_noop)
"ab" = (
/obj/machinery/power/shuttle_engine/propulsion{
	dir = 1
	},
/obj/effect/turf_decal/stripes/line{
	dir = 1
	},
/turf/open/floor/plating/airless,
/area/shuttle/arrival)
"ac" = (
/obj/docking_port/mobile/arrivals{
	dir = 2;
	name = "delta arrivals shuttle"
	},
/turf/closed/wall/mineral/plastitanium,
/area/shuttle/arrival)
"ad" = (
/turf/closed/wall/mineral/plastitanium,
/area/shuttle/arrival)
"ae" = (
/obj/structure/window/reinforced/spawner/directional/south,
/obj/machinery/power/shuttle_engine/heater{
	dir = 1
	},
/obj/effect/turf_decal/stripes/line{
	dir = 1
	},
/turf/open/floor/plating/airless,
/area/shuttle/arrival)
"af" = (
/turf/closed/wall/mineral/titanium/nodiagonal,
/area/shuttle/arrival)
"ag" = (
/turf/closed/wall/mineral/titanium,
/area/shuttle/arrival)
"ah" = (
/obj/effect/spawner/structure/window/reinforced/shuttle,
/turf/open/floor/plating,
/area/shuttle/arrival)
"ai" = (
/obj/item/clothing/suit/hazardvest{
	desc = "A high-visibility lifejacket complete with whistle and slot for oxygen tanks.";
	name = "emergency lifejacket"
	},
/obj/item/clothing/suit/hazardvest{
	desc = "A high-visibility lifejacket complete with whistle and slot for oxygen tanks.";
	name = "emergency lifejacket"
	},
/obj/item/clothing/suit/hazardvest{
	desc = "A high-visibility lifejacket complete with whistle and slot for oxygen tanks.";
	name = "emergency lifejacket"
	},
/obj/item/clothing/suit/hazardvest{
	desc = "A high-visibility lifejacket complete with whistle and slot for oxygen tanks.";
	name = "emergency lifejacket"
	},
/obj/item/clothing/suit/hazardvest{
	desc = "A high-visibility lifejacket complete with whistle and slot for oxygen tanks.";
	name = "emergency lifejacket"
	},
/obj/item/tank/internals/emergency_oxygen{
	pixel_x = 3
	},
/obj/item/tank/internals/emergency_oxygen{
	pixel_x = 3
	},
/obj/item/tank/internals/emergency_oxygen{
	pixel_x = 3
	},
/obj/item/tank/internals/emergency_oxygen{
	pixel_x = 3
	},
/obj/item/tank/internals/emergency_oxygen{
	pixel_x = 3
	},
/obj/item/clothing/mask/breath{
	pixel_x = -3;
	pixel_y = -3
	},
/obj/item/clothing/mask/breath{
	pixel_x = -3;
	pixel_y = -3
	},
/obj/item/clothing/mask/breath{
	pixel_x = -3;
	pixel_y = -3
	},
/obj/item/clothing/mask/breath{
	pixel_x = -3;
	pixel_y = -3
	},
/obj/item/clothing/mask/breath{
	pixel_x = -3;
	pixel_y = -3
	},
/obj/item/clothing/head/utility/hardhat/orange{
	name = "protective hat";
	pixel_y = 9
	},
/obj/item/clothing/head/utility/hardhat/orange{
	name = "protective hat";
	pixel_y = 9
	},
/obj/item/clothing/head/utility/hardhat/orange{
	name = "protective hat";
	pixel_y = 9
	},
/obj/item/clothing/head/utility/hardhat/orange{
	name = "protective hat";
	pixel_y = 9
	},
/obj/item/clothing/head/utility/hardhat/orange{
	name = "protective hat";
	pixel_y = 9
	},
/obj/structure/closet/crate/internals,
/obj/effect/turf_decal/bot,
/turf/open/floor/iron,
/area/shuttle/arrival)
"aj" = (
/obj/effect/turf_decal/delivery,
/obj/structure/closet/wardrobe/mixed,
/turf/open/floor/iron,
/area/shuttle/arrival)
"ak" = (
/obj/structure/table/reinforced,
/obj/item/storage/toolbox/emergency,
/obj/effect/turf_decal/bot,
/turf/open/floor/iron,
/area/shuttle/arrival)
"al" = (
/obj/machinery/computer{
	dir = 1;
	name = "Shuttle computer"
	},
/obj/effect/turf_decal/tile/blue/half/contrasted,
/turf/open/floor/iron,
/area/shuttle/arrival)
"am" = (
/obj/structure/table/reinforced,
/obj/machinery/cell_charger,
/obj/effect/turf_decal/bot,
/turf/open/floor/iron,
/area/shuttle/arrival)
"an" = (
/obj/machinery/door/airlock/shuttle{
	name = "Arrival Shuttle Airlock"
	},
/obj/effect/turf_decal/stripes/line{
	dir = 8
	},
/obj/effect/turf_decal/stripes/line{
	dir = 4
	},
/turf/open/floor/iron/white,
/area/shuttle/arrival)
"ao" = (
/obj/effect/turf_decal/tile/neutral{
	dir = 1
	},
/obj/effect/turf_decal/tile/neutral{
	dir = 8
	},
/turf/open/floor/iron,
/area/shuttle/arrival)
"ap" = (
/obj/effect/turf_decal/tile/neutral/fourcorners,
/turf/open/floor/iron,
/area/shuttle/arrival)
"aq" = (
/obj/effect/turf_decal/tile/neutral,
/obj/effect/turf_decal/tile/neutral{
	dir = 4
	},
/turf/open/floor/iron,
/area/shuttle/arrival)
"ar" = (
/obj/machinery/status_display/evac{
	pixel_x = -32
	},
/obj/item/kirbyplants{
	icon_state = "plant-21"
	},
/obj/effect/turf_decal/tile/neutral{
	dir = 1
	},
/obj/effect/turf_decal/tile/neutral{
	dir = 8
	},
/turf/open/floor/iron,
/area/shuttle/arrival)
"as" = (
/obj/machinery/holopad,
/obj/effect/turf_decal/bot,
/obj/machinery/light/directional/south,
/turf/open/floor/iron,
/area/shuttle/arrival)
"at" = (
/obj/machinery/status_display/ai{
	pixel_x = 32
	},
/obj/item/kirbyplants{
	icon_state = "plant-21"
	},
/obj/effect/turf_decal/tile/neutral,
/obj/effect/turf_decal/tile/neutral{
	dir = 4
	},
/turf/open/floor/iron,
/area/shuttle/arrival)
"au" = (
/obj/structure/chair/comfy/shuttle{
	dir = 4
	},
/obj/effect/turf_decal/bot,
/turf/open/floor/iron,
/area/shuttle/arrival)
"av" = (
/obj/structure/chair/comfy/shuttle{
	dir = 8
	},
/obj/effect/turf_decal/bot,
/turf/open/floor/iron,
/area/shuttle/arrival)
"aw" = (
/obj/machinery/requests_console{
	department = "Arrival shuttle";
	name = "Arrivals Shuttle console"
	},
/turf/closed/wall/mineral/titanium/nodiagonal,
/area/shuttle/arrival)
"ax" = (
/obj/structure/flora/bush/grassy/style_random,
/obj/structure/flora/bush/lavendergrass/style_random,
/obj/structure/flora/bush/flowers_pp/style_random,
/obj/structure/flora/bush/sunny/style_random,
/obj/structure/window/reinforced/shuttle,
/turf/open/floor/grass,
/area/shuttle/arrival)
"ay" = (
/obj/structure/flora/bush/grassy/style_random,
/obj/structure/flora/bush/lavendergrass/style_random,
/obj/structure/flora/bush/flowers_yw/style_random,
/obj/structure/flora/bush/ferny/style_random,
/obj/structure/window/reinforced/shuttle,
/turf/open/floor/grass,
/area/shuttle/arrival)
"az" = (
/obj/structure/sign/nanotrasen,
/turf/closed/wall/mineral/titanium,
/area/shuttle/arrival)
"aA" = (
/obj/item/kirbyplants{
	icon_state = "plant-21"
	},
/obj/effect/turf_decal/tile/neutral{
	dir = 1
	},
/obj/effect/turf_decal/tile/neutral{
	dir = 8
	},
/turf/open/floor/iron,
/area/shuttle/arrival)
"aB" = (
/obj/structure/table/reinforced,
/obj/item/clipboard,
/obj/effect/turf_decal/delivery,
/turf/open/floor/iron,
/area/shuttle/arrival)
"aC" = (
/obj/machinery/computer{
	dir = 1;
	name = "Shuttle computer"
	},
/obj/effect/turf_decal/tile/blue/fourcorners,
/turf/open/floor/iron,
/area/shuttle/arrival)
"aD" = (
/obj/structure/table/reinforced,
/obj/item/folder,
/obj/item/storage/dice,
/obj/effect/turf_decal/delivery,
/turf/open/floor/iron,
/area/shuttle/arrival)
"aE" = (
/obj/item/kirbyplants{
	icon_state = "plant-21"
	},
/obj/effect/turf_decal/tile/neutral,
/obj/effect/turf_decal/tile/neutral{
	dir = 4
	},
/turf/open/floor/iron,
/area/shuttle/arrival)
"aF" = (
/obj/machinery/light/directional/north,
/obj/effect/turf_decal/tile/neutral/fourcorners,
/obj/machinery/vending/wallmed/directional/north{
	use_power = 0
	},
/turf/open/floor/iron,
/area/shuttle/arrival)
"aG" = (
/obj/structure/table/reinforced,
/obj/item/paper_bin,
/obj/item/pen,
/obj/effect/turf_decal/bot,
/obj/item/radio/intercom/directional/west,
/turf/open/floor/iron,
/area/shuttle/arrival)
"aH" = (
/obj/structure/closet/wardrobe/black,
/obj/effect/turf_decal/tile/neutral,
/obj/effect/turf_decal/tile/neutral{
	dir = 8
	},
/turf/open/floor/iron,
/area/shuttle/arrival)
"aI" = (
/obj/structure/closet/wardrobe/grey,
/obj/effect/turf_decal/tile/blue,
/turf/open/floor/iron,
/area/shuttle/arrival)
"aJ" = (
/obj/effect/turf_decal/tile/blue,
/obj/effect/turf_decal/tile/blue{
	dir = 8
	},
/turf/open/floor/iron,
/area/shuttle/arrival)
"aK" = (
/obj/structure/closet/wardrobe/yellow,
/obj/effect/turf_decal/tile/blue{
	dir = 8
	},
/turf/open/floor/iron,
/area/shuttle/arrival)
"aL" = (
/obj/structure/closet/wardrobe/grey,
/obj/effect/turf_decal/tile/neutral/fourcorners,
/turf/open/floor/iron,
/area/shuttle/arrival)
"aM" = (
/obj/structure/table/reinforced,
/obj/item/storage/briefcase{
	pixel_x = 3;
	pixel_y = 3
	},
/obj/item/storage/secure/briefcase,
/obj/effect/turf_decal/bot,
/turf/open/floor/iron,
/area/shuttle/arrival)
"aN" = (
/obj/machinery/status_display/evac,
/turf/closed/wall/mineral/titanium,
/area/shuttle/arrival)
"aO" = (
/obj/effect/turf_decal/stripes/line,
/obj/machinery/door/airlock/shuttle{
	name = "Arrival Shuttle Airlock"
	},
/obj/effect/turf_decal/stripes/line{
	dir = 1
	},
/turf/open/floor/iron,
/area/shuttle/arrival)
"aP" = (
/obj/machinery/status_display/ai,
/turf/closed/wall/mineral/titanium,
/area/shuttle/arrival)
"aQ" = (
/obj/machinery/light/small/directional/north,
/obj/effect/turf_decal/tile/blue{
	dir = 1
	},
/obj/effect/turf_decal/tile/blue{
	dir = 8
	},
/turf/open/floor/iron,
/area/shuttle/arrival)
"aR" = (
/obj/structure/chair/office,
/obj/effect/turf_decal/tile/blue{
	dir = 1
	},
/obj/effect/turf_decal/tile/blue{
	dir = 4
	},
/turf/open/floor/iron,
/area/shuttle/arrival)
"aS" = (
/obj/machinery/light/small/directional/north,
/obj/effect/turf_decal/tile/blue,
/obj/effect/turf_decal/tile/blue{
	dir = 4
	},
/turf/open/floor/iron,
/area/shuttle/arrival)
"aT" = (
/obj/structure/closet/wardrobe/black,
/obj/effect/turf_decal/tile/neutral/half/contrasted,
/turf/open/floor/iron,
/area/shuttle/arrival)
"aU" = (
/obj/machinery/light/small/directional/north,
/obj/effect/turf_decal/tile/blue/half/contrasted{
	dir = 4
	},
/turf/open/floor/iron,
/area/shuttle/arrival)
"aV" = (
/obj/machinery/computer{
	dir = 1;
	name = "Shuttle computer"
	},
/obj/effect/turf_decal/tile/blue,
/obj/effect/turf_decal/tile/blue{
	dir = 8
	},
/turf/open/floor/iron,
/area/shuttle/arrival)
"aW" = (
/obj/structure/table/reinforced,
/obj/structure/extinguisher_cabinet{
	pixel_y = 32
	},
/obj/item/storage/medkit/regular{
	pixel_x = 3;
	pixel_y = 3
	},
/obj/item/storage/medkit/regular,
/obj/effect/turf_decal/bot,
/turf/open/floor/iron,
/area/shuttle/arrival)
"aX" = (
/obj/effect/turf_decal/tile/blue/half/contrasted,
/turf/open/floor/iron,
/area/shuttle/arrival)
"aY" = (
/obj/machinery/light/small/directional/north,
/obj/effect/turf_decal/tile/blue/half/contrasted{
	dir = 8
	},
/turf/open/floor/iron,
/area/shuttle/arrival)
"aZ" = (
/obj/structure/chair/office,
/obj/effect/turf_decal/tile/blue/half/contrasted{
	dir = 1
	},
/turf/open/floor/iron,
/area/shuttle/arrival)
"he" = (
/obj/effect/turf_decal/tile/neutral/half/contrasted{
	dir = 4
	},
/turf/open/floor/iron,
/area/shuttle/arrival)
"hW" = (
/obj/effect/turf_decal/tile/neutral/half/contrasted{
	dir = 8
	},
/turf/open/floor/iron,
/area/shuttle/arrival)
"on" = (
/obj/machinery/status_display/evac{
	pixel_x = -32
	},
/obj/item/kirbyplants{
	icon_state = "plant-21"
	},
/obj/effect/turf_decal/tile/neutral/half/contrasted{
	dir = 8
	},
/turf/open/floor/iron,
/area/shuttle/arrival)
"uU" = (
/obj/machinery/light/directional/north,
/obj/machinery/vending/wallmed/directional/north{
	use_power = 0
	},
/obj/effect/turf_decal/tile/neutral/fourcorners,
/turf/open/floor/iron,
/area/shuttle/arrival)
"zb" = (
/obj/machinery/status_display/ai{
	pixel_x = 32
	},
/obj/item/kirbyplants{
	icon_state = "plant-21"
	},
/obj/effect/turf_decal/tile/neutral/half/contrasted{
	dir = 4
	},
/turf/open/floor/iron,
/area/shuttle/arrival)
"Ns" = (
/obj/item/kirbyplants{
	icon_state = "plant-21"
	},
/obj/effect/turf_decal/tile/neutral/half/contrasted{
	dir = 4
	},
/turf/open/floor/iron,
/area/shuttle/arrival)
"ZZ" = (
/obj/item/kirbyplants{
	icon_state = "plant-21"
	},
/obj/effect/turf_decal/tile/neutral/half/contrasted{
	dir = 8
	},
/turf/open/floor/iron,
/area/shuttle/arrival)

(1,1,1) = {"
aa
ad
af
ag
an
ag
ah
ah
ah
ah
az
an
ag
ag
aa
aa
aa
"}
(2,1,1) = {"
ab
ad
ag
ai
hW
on
au
au
au
au
ZZ
hW
aG
ag
aa
aa
aa
"}
(3,1,1) = {"
ab
ae
ah
aj
ap
ap
ap
ap
ap
ap
ap
ap
aT
ag
ag
ah
ag
"}
(4,1,1) = {"
ab
ae
ah
ak
ap
ap
av
av
av
av
aB
ap
aI
aN
aY
aC
ah
"}
(5,1,1) = {"
ac
ad
af
aW
ap
as
aw
ax
ay
ax
af
uU
aX
aO
aZ
al
ah
"}
(6,1,1) = {"
ab
ae
ah
am
ap
ap
au
au
au
au
aD
ap
aK
aP
aU
aC
ah
"}
(7,1,1) = {"
ab
ae
ah
aj
ap
ap
ap
ap
ap
ap
ap
ap
aL
ag
ag
ah
ag
"}
(8,1,1) = {"
ab
ad
ag
ai
he
zb
av
av
av
av
Ns
he
aM
ag
aa
aa
aa
"}
(9,1,1) = {"
aa
ad
af
ag
an
ag
ah
ah
ah
ah
az
an
ag
ag
aa
aa
aa
"}
