//MAP CONVERTED BY dmm2tgm.py THIS HEADER COMMENT PREVENTS RECONVERSION, DO NOT REMOVE
"a" = (
/turf/template_noop,
/area/template_noop)
"b" = (
/turf/closed/wall/mineral/titanium,
/area/shuttle/arrival)
"c" = (
/obj/basic/machinery/door/airlock/titanium{
	name = "Arrivals Shuttle Airlock"
	},
/turf/open/floor/plating,
/area/shuttle/arrival)
"d" = (
/obj/basic/effect/spawner/structure/window/shuttle,
/turf/open/floor/plating,
/area/shuttle/arrival)
"e" = (
/obj/basic/structure/table,
/obj/basic/item/storage/firstaid/regular,
/turf/open/floor/mineral/titanium/blue,
/area/shuttle/arrival)
"f" = (
/turf/open/floor/mineral/titanium/blue,
/area/shuttle/arrival)
"g" = (
/obj/basic/effect/spawner/randomarcade,
/obj/basic/machinery/light/directional/north,
/turf/open/floor/mineral/titanium/blue,
/area/shuttle/arrival)
"h" = (
/obj/basic/structure/closet/wardrobe/green,
/turf/open/floor/mineral/titanium/blue,
/area/shuttle/arrival)
"i" = (
/obj/basic/structure/closet/wardrobe/black,
/turf/open/floor/mineral/titanium/blue,
/area/shuttle/arrival)
"j" = (
/obj/basic/structure/closet/wardrobe/mixed,
/turf/open/floor/mineral/titanium/blue,
/area/shuttle/arrival)
"k" = (
/obj/basic/structure/closet/wardrobe/grey,
/turf/open/floor/mineral/titanium/blue,
/area/shuttle/arrival)
"l" = (
/obj/basic/machinery/requests_console/directional/north{
	department = "Arrival shuttle"
	},
/obj/basic/machinery/light/directional/north,
/turf/open/floor/mineral/titanium/blue,
/area/shuttle/arrival)
"m" = (
/obj/basic/structure/shuttle/engine/heater{
	dir = 4
	},
/obj/basic/structure/window/reinforced{
	dir = 8
	},
/turf/open/floor/plating/airless,
/area/shuttle/arrival)
"n" = (
/obj/basic/structure/shuttle/engine/propulsion/burst/right{
	dir = 4
	},
/turf/open/floor/plating/airless,
/area/shuttle/arrival)
"p" = (
/obj/basic/structure/chair/comfy/shuttle,
/turf/open/floor/mineral/titanium/blue,
/area/shuttle/arrival)
"q" = (
/obj/basic/structure/chair/comfy/shuttle,
/obj/basic/machinery/light/small/directional/east,
/turf/open/floor/mineral/titanium/blue,
/area/shuttle/arrival)
"r" = (
/obj/basic/structure/chair/comfy/shuttle{
	dir = 8
	},
/turf/open/floor/mineral/titanium,
/area/shuttle/arrival)
"s" = (
/obj/basic/structure/shuttle/engine/propulsion{
	dir = 4
	},
/turf/open/floor/plating/airless,
/area/shuttle/arrival)
"t" = (
/obj/basic/machinery/door/airlock/titanium{
	name = "Arrivals Shuttle Airlock"
	},
/turf/open/floor/mineral/titanium,
/area/shuttle/arrival)
"u" = (
/obj/basic/structure/shuttle/engine/propulsion{
	dir = 4
	},
/obj/basic/docking_port/mobile/arrivals,
/turf/open/floor/plating/airless,
/area/shuttle/arrival)
"v" = (
/obj/basic/structure/chair/comfy/shuttle{
	dir = 1
	},
/turf/open/floor/mineral/titanium/blue,
/area/shuttle/arrival)
"w" = (
/obj/basic/structure/chair/comfy/shuttle{
	dir = 1
	},
/obj/basic/machinery/light/small/directional/east,
/turf/open/floor/mineral/titanium/blue,
/area/shuttle/arrival)
"x" = (
/obj/basic/structure/closet/emcloset,
/turf/open/floor/mineral/titanium/blue,
/area/shuttle/arrival)
"y" = (
/obj/basic/machinery/light/directional/south,
/turf/open/floor/mineral/titanium/blue,
/area/shuttle/arrival)
"z" = (
/obj/basic/item/radio/intercom/directional/south,
/obj/basic/machinery/light/directional/south,
/turf/open/floor/mineral/titanium/blue,
/area/shuttle/arrival)
"A" = (
/obj/basic/structure/shuttle/engine/propulsion/burst/left{
	dir = 4
	},
/turf/open/floor/plating/airless,
/area/shuttle/arrival)
"S" = (
/turf/open/floor/mineral/titanium,
/area/shuttle/arrival)

(1,1,1) = {"
a
b
d
d
d
b
a
"}
(2,1,1) = {"
a
b
p
S
v
b
a
"}
(3,1,1) = {"
a
b
q
S
w
b
a
"}
(4,1,1) = {"
b
b
b
t
b
b
b
"}
(5,1,1) = {"
b
e
S
S
S
x
b
"}
(6,1,1) = {"
c
f
r
r
r
f
c
"}
(7,1,1) = {"
b
g
f
f
f
y
b
"}
(8,1,1) = {"
d
h
r
r
r
f
d
"}
(9,1,1) = {"
d
i
f
f
f
f
d
"}
(10,1,1) = {"
d
j
r
r
r
f
d
"}
(11,1,1) = {"
d
k
f
f
f
f
d
"}
(12,1,1) = {"
b
l
r
r
r
z
b
"}
(13,1,1) = {"
c
f
S
S
S
f
c
"}
(14,1,1) = {"
b
m
m
m
m
m
b
"}
(15,1,1) = {"
b
n
s
u
s
A
b
"}
