//MAP CONVERTED BY dmm2tgm.py THIS HEADER COMMENT PREVENTS RECONVERSION, DO NOT REMOVE
"a" = (
/obj/effect/turf_decal/trimline/yellow/arrow_ccw{
	dir = 6
	},
/turf/open/floor/pod/light,
/area/shuttle/supply)
"b" = (
/obj/machinery/power/shuttle_engine/propulsion/burst/right,
/turf/open/floor/plating/airless,
/area/shuttle/supply)
"f" = (
/obj/machinery/conveyor{
	dir = 5;
	id = "QMLoad"
	},
/turf/open/floor/catwalk_floor/iron,
/area/shuttle/supply)
"g" = (
/obj/machinery/conveyor{
	dir = 4;
	id = "QMLoad2"
	},
/obj/machinery/door/poddoor{
	id = "QMLoaddoor2";
	name = "Supply Dock Loading Door"
	},
/turf/open/floor/plating,
/area/shuttle/supply)
"h" = (
/turf/closed/wall/mineral/titanium/survival/nodiagonal,
/area/shuttle/supply)
"i" = (
/turf/closed/wall/mineral/titanium/survival,
/area/shuttle/supply)
"j" = (
/obj/effect/turf_decal/trimline/yellow/arrow_ccw{
	dir = 9
	},
/turf/open/floor/pod/light,
/area/shuttle/supply)
"k" = (
/obj/effect/turf_decal/trimline/yellow/arrow_ccw{
	dir = 8
	},
/turf/open/floor/pod/light,
/area/shuttle/supply)
"n" = (
/obj/effect/turf_decal/trimline/yellow/arrow_ccw{
	dir = 10
	},
/turf/open/floor/pod/light,
/area/shuttle/supply)
"o" = (
/obj/machinery/power/shuttle_engine/propulsion/burst/left,
/turf/open/floor/plating/airless,
/area/shuttle/supply)
"p" = (
/obj/machinery/button/door/directional/east{
	id = "QMLoaddoor";
	name = "Loading Doors";
	pixel_y = -8
	},
/obj/machinery/button/door/directional/east{
	id = "QMLoaddoor2";
	name = "Loading Doors";
	pixel_y = 8
	},
/turf/open/floor/catwalk_floor/iron,
/area/shuttle/supply)
"q" = (
/obj/machinery/power/shuttle_engine/heater{
	icon_state = "router"
	},
/turf/open/floor/plating/airless,
/area/shuttle/supply)
"s" = (
/turf/template_noop,
/area/template_noop)
"t" = (
/obj/effect/turf_decal/trimline/yellow/corner,
/obj/effect/turf_decal/trimline/yellow/arrow_ccw{
	dir = 1
	},
/turf/open/floor/pod/light,
/area/shuttle/supply)
"u" = (
/obj/machinery/power/shuttle_engine/propulsion,
/turf/open/floor/plating/airless,
/area/shuttle/supply)
"v" = (
/obj/machinery/conveyor{
	dir = 1;
	id = "QMLoad"
	},
/turf/open/floor/catwalk_floor/iron,
/area/shuttle/supply)
"w" = (
/obj/effect/spawner/structure/window/survival_pod,
/turf/open/floor/plating,
/area/shuttle/supply)
"x" = (
/turf/open/floor/catwalk_floor/iron,
/area/shuttle/supply)
"z" = (
/obj/machinery/conveyor{
	dir = 9;
	id = "QMLoad"
	},
/turf/open/floor/catwalk_floor/iron,
/area/shuttle/supply)
"C" = (
/obj/machinery/light/red/directional/west,
/turf/open/floor/catwalk_floor/iron,
/area/shuttle/supply)
"D" = (
/obj/machinery/power/shuttle_engine/heater,
/obj/structure/window/reinforced/survival_pod/spawner/directional/west,
/obj/structure/window/reinforced/survival_pod/spawner/directional/north,
/turf/open/floor/plating/airless,
/area/shuttle/supply)
"G" = (
/obj/effect/mapping_helpers/airlock/access/all/supply/general,
/obj/machinery/door/airlock/survival_pod/glass{
	name = "Supply Shuttle Airlock"
	},
/obj/docking_port/mobile/supply,
/turf/open/floor/pod/dark,
/area/shuttle/supply)
"I" = (
/obj/machinery/power/shuttle_engine/heater,
/obj/structure/window/reinforced/survival_pod/spawner/directional/north,
/turf/open/floor/plating/airless,
/area/shuttle/supply)
"M" = (
/obj/machinery/power/shuttle_engine/heater,
/obj/structure/window/reinforced/survival_pod/spawner/directional/east,
/obj/structure/window/reinforced/survival_pod/spawner/directional/north,
/turf/open/floor/plating/airless,
/area/shuttle/supply)
"N" = (
/obj/effect/turf_decal/trimline/yellow/arrow_ccw{
	dir = 4
	},
/turf/open/floor/pod/light,
/area/shuttle/supply)
"T" = (
/obj/machinery/conveyor{
	dir = 8;
	id = "QMLoad"
	},
/obj/machinery/door/poddoor{
	id = "QMLoaddoor";
	name = "Supply Dock Loading Door"
	},
/turf/open/floor/plating,
/area/shuttle/supply)

(1,1,1) = {"
i
h
i
i
i
i
i
i
i
i
s
"}
(2,1,1) = {"
h
x
C
x
x
x
x
C
x
I
o
"}
(3,1,1) = {"
w
x
j
k
k
k
k
n
D
q
u
"}
(4,1,1) = {"
w
x
t
N
N
N
N
a
M
q
u
"}
(5,1,1) = {"
h
f
v
z
p
x
x
x
x
I
b
"}
(6,1,1) = {"
i
g
h
T
h
G
h
h
h
i
s
"}
