//MAP CONVERTED BY dmm2tgm.py THIS HEADER COMMENT PREVENTS RECONVERSION, DO NOT REMOVE
"a" = (
/turf/open/floor/mineral/titanium/blue,
/area/shuttle/supply)
"d" = (
/obj/machinery/power/shuttle_engine/propulsion{
	icon_state = "propulsion";
	dir = 1
	},
/turf/open/floor/plating/airless,
/area/shuttle/supply)
"r" = (
/turf/closed/wall/mineral/titanium,
/area/shuttle/supply)
"u" = (
/obj/machinery/door/airlock/titanium{
	name = "Supply Shuttle Airlock"
	},
/obj/docking_port/mobile/supply,
/obj/effect/mapping_helpers/airlock/access/all/supply/general,
/turf/open/floor/plating,
/area/shuttle/supply)
"v" = (
/obj/machinery/power/shuttle_engine/heater{
	icon_state = "heater";
	dir = 1
	},
/obj/structure/window/reinforced,
/turf/open/floor/plating/airless,
/area/shuttle/supply)
"x" = (
/turf/template_noop,
/area/template_noop)
"J" = (
/obj/machinery/door/airlock/titanium{
	name = "Supply Shuttle Airlock"
	},
/obj/effect/mapping_helpers/airlock/access/all/supply/general,
/turf/open/floor/plating,
/area/shuttle/supply)
"X" = (
/obj/machinery/light/directional/east,
/turf/open/floor/mineral/titanium/blue,
/area/shuttle/supply)

(1,1,1) = {"
x
r
r
r
r
r
r
r
r
"}
(2,1,1) = {"
d
r
a
a
a
a
a
a
r
"}
(3,1,1) = {"
d
v
a
a
a
a
a
a
r
"}
(4,1,1) = {"
d
v
a
a
a
a
a
a
r
"}
(5,1,1) = {"
d
v
a
a
a
a
a
a
r
"}
(6,1,1) = {"
d
r
a
a
X
a
a
a
r
"}
(7,1,1) = {"
x
r
r
J
r
u
r
r
r
"}
