//MAP CONVERTED BY dmm2tgm.py THIS HEADER COMMENT PREVENTS RECONVERSION, DO NOT REMOVE
"a" = (
/turf/closed/wall/mineral/titanium,
/area/shuttle/supply)
"b" = (
/obj/basic/effect/turf_decal/tile/brown,
/obj/basic/effect/turf_decal/tile/brown{
	dir = 1
	},
/obj/basic/effect/turf_decal/stripes/line{
	dir = 9
	},
/turf/open/floor/mineral/titanium/yellow,
/area/shuttle/supply)
"c" = (
/obj/basic/effect/turf_decal/tile/brown,
/obj/basic/effect/turf_decal/tile/brown{
	dir = 1
	},
/obj/basic/effect/turf_decal/stripes/line{
	dir = 1
	},
/turf/open/floor/mineral/titanium/yellow,
/area/shuttle/supply)
"d" = (
/obj/basic/effect/turf_decal/tile/brown,
/obj/basic/effect/turf_decal/tile/brown{
	dir = 1
	},
/obj/basic/effect/turf_decal/stripes/line{
	dir = 5
	},
/turf/open/floor/mineral/titanium/yellow,
/area/shuttle/supply)
"e" = (
/obj/basic/effect/turf_decal/tile/brown,
/obj/basic/effect/turf_decal/tile/brown{
	dir = 1
	},
/obj/basic/effect/turf_decal/stripes/line{
	dir = 10
	},
/turf/open/floor/mineral/titanium/yellow,
/area/shuttle/supply)
"f" = (
/obj/basic/effect/turf_decal/tile/brown,
/obj/basic/effect/turf_decal/tile/brown{
	dir = 1
	},
/obj/basic/effect/turf_decal/stripes/corner{
	dir = 8
	},
/turf/open/floor/mineral/titanium/yellow,
/area/shuttle/supply)
"g" = (
/obj/basic/effect/turf_decal/tile/brown,
/obj/basic/effect/turf_decal/tile/brown{
	dir = 1
	},
/turf/open/floor/mineral/titanium/yellow,
/area/shuttle/supply)
"h" = (
/obj/basic/effect/turf_decal/tile/brown,
/obj/basic/effect/turf_decal/tile/brown{
	dir = 1
	},
/obj/basic/effect/turf_decal/stripes/line{
	dir = 4
	},
/turf/open/floor/mineral/titanium/yellow,
/area/shuttle/supply)
"i" = (
/obj/basic/machinery/door/poddoor{
	id = "QMLoaddoor";
	name = "Supply Dock Loading Door"
	},
/obj/basic/machinery/conveyor{
	dir = 8;
	id = "QMLoad";
	name = "off ramp"
	},
/turf/open/floor/plating,
/area/shuttle/supply)
"j" = (
/obj/basic/effect/turf_decal/loading_area{
	dir = 8
	},
/turf/open/floor/mineral/plastitanium,
/area/shuttle/supply)
"k" = (
/obj/basic/effect/turf_decal/tile/brown,
/obj/basic/effect/turf_decal/tile/brown{
	dir = 1
	},
/obj/basic/effect/turf_decal/stripes/corner{
	dir = 1
	},
/obj/basic/effect/turf_decal/stripes/corner{
	dir = 8
	},
/turf/open/floor/mineral/titanium/yellow,
/area/shuttle/supply)
"l" = (
/obj/basic/effect/turf_decal/tile/brown,
/obj/basic/effect/turf_decal/tile/brown{
	dir = 1
	},
/obj/basic/effect/turf_decal/stripes/line{
	dir = 4
	},
/obj/basic/machinery/light/directional/east,
/turf/open/floor/mineral/titanium/yellow,
/area/shuttle/supply)
"m" = (
/obj/basic/machinery/door/airlock/shuttle{
	name = "Supply Shuttle Airlock";
	req_access_txt = "31"
	},
/obj/basic/effect/decal/cleanable/dirt,
/obj/basic/docking_port/mobile/supply{
	dir = 4;
	dwidth = 4
	},
/turf/open/floor/mineral/plastitanium,
/area/shuttle/supply)
"n" = (
/obj/basic/effect/turf_decal/tile/brown,
/obj/basic/effect/turf_decal/tile/brown{
	dir = 1
	},
/obj/basic/effect/turf_decal/stripes/line{
	dir = 1
	},
/obj/basic/effect/turf_decal/stripes/corner{
	dir = 8
	},
/turf/open/floor/mineral/titanium/yellow,
/area/shuttle/supply)
"o" = (
/obj/basic/effect/turf_decal/tile/brown,
/obj/basic/effect/turf_decal/tile/brown{
	dir = 1
	},
/obj/basic/effect/turf_decal/stripes/corner{
	dir = 1
	},
/turf/open/floor/mineral/titanium/yellow,
/area/shuttle/supply)
"p" = (
/obj/basic/effect/turf_decal/tile/brown,
/obj/basic/effect/turf_decal/tile/brown{
	dir = 1
	},
/obj/basic/effect/turf_decal/stripes/line{
	dir = 8
	},
/obj/basic/machinery/button/door/directional/west{
	id = "QMLoaddoor";
	name = "Off Ramp Toggle";
	pixel_y = 8;
	req_access_txt = "31"
	},
/obj/basic/machinery/button/door/directional/west{
	id = "QMLoaddoor2";
	name = "On Ramp Toggle";
	pixel_y = -8;
	req_access_txt = "31"
	},
/turf/open/floor/mineral/titanium/yellow,
/area/shuttle/supply)
"q" = (
/obj/basic/effect/turf_decal/tile/brown,
/obj/basic/effect/turf_decal/tile/brown{
	dir = 1
	},
/obj/basic/effect/turf_decal/stripes/line{
	dir = 4
	},
/obj/basic/structure/sign/departments/cargo{
	pixel_x = 32
	},
/turf/open/floor/mineral/titanium/yellow,
/area/shuttle/supply)
"r" = (
/obj/basic/machinery/door/airlock/shuttle{
	name = "Supply Shuttle Airlock";
	req_access_txt = "31"
	},
/obj/basic/effect/decal/cleanable/dirt,
/turf/open/floor/mineral/plastitanium,
/area/shuttle/supply)
"s" = (
/obj/basic/effect/turf_decal/tile/brown,
/obj/basic/effect/turf_decal/tile/brown{
	dir = 1
	},
/obj/basic/effect/turf_decal/stripes/line,
/obj/basic/effect/turf_decal/stripes/corner{
	dir = 1
	},
/turf/open/floor/mineral/titanium/yellow,
/area/shuttle/supply)
"t" = (
/obj/basic/machinery/door/poddoor{
	id = "QMLoaddoor2";
	name = "Supply Dock Loading Door"
	},
/obj/basic/machinery/conveyor{
	dir = 4;
	id = "QMLoad2";
	name = "on ramp"
	},
/turf/open/floor/plating,
/area/shuttle/supply)
"u" = (
/obj/basic/effect/turf_decal/loading_area{
	dir = 4
	},
/turf/open/floor/mineral/plastitanium,
/area/shuttle/supply)
"v" = (
/obj/basic/effect/turf_decal/tile/brown,
/obj/basic/effect/turf_decal/tile/brown{
	dir = 1
	},
/obj/basic/effect/turf_decal/stripes/end{
	dir = 8
	},
/turf/open/floor/mineral/titanium/yellow,
/area/shuttle/supply)
"w" = (
/obj/basic/effect/turf_decal/tile/brown,
/obj/basic/effect/turf_decal/tile/brown{
	dir = 1
	},
/obj/basic/effect/turf_decal/stripes/corner,
/turf/open/floor/mineral/titanium/yellow,
/area/shuttle/supply)
"x" = (
/obj/basic/effect/turf_decal/tile/brown,
/obj/basic/effect/turf_decal/tile/brown{
	dir = 1
	},
/obj/basic/effect/turf_decal/stripes/line{
	dir = 6
	},
/turf/open/floor/mineral/titanium/yellow,
/area/shuttle/supply)
"y" = (
/obj/basic/structure/sign/warning/fire,
/turf/closed/wall/mineral/titanium/nodiagonal,
/area/shuttle/supply)
"z" = (
/obj/basic/effect/turf_decal/tile/brown,
/obj/basic/effect/turf_decal/tile/brown{
	dir = 1
	},
/obj/basic/effect/turf_decal/stripes/line,
/turf/open/floor/mineral/titanium/yellow,
/area/shuttle/supply)
"A" = (
/obj/basic/effect/spawner/structure/window/shuttle,
/obj/basic/structure/shuttle/engine/heater,
/turf/open/floor/plating,
/area/shuttle/supply)
"B" = (
/turf/template_noop,
/area/template_noop)
"C" = (
/obj/basic/structure/shuttle/engine/propulsion/burst/left,
/obj/basic/effect/turf_decal/stripes/line,
/turf/open/floor/plating/airless,
/area/shuttle/supply)
"D" = (
/obj/basic/structure/shuttle/engine/propulsion,
/obj/basic/effect/turf_decal/stripes/line,
/turf/open/floor/plating/airless,
/area/shuttle/supply)
"E" = (
/obj/basic/structure/shuttle/engine/propulsion/burst/right,
/obj/basic/effect/turf_decal/stripes/line,
/turf/open/floor/plating/airless,
/area/shuttle/supply)

(1,1,1) = {"
a
a
a
i
m
a
r
t
a
a
a
B
"}
(2,1,1) = {"
a
b
e
j
n
p
s
u
v
y
a
C
"}
(3,1,1) = {"
a
c
f
k
o
g
f
k
k
e
A
D
"}
(4,1,1) = {"
a
c
g
g
g
g
g
g
g
z
A
D
"}
(5,1,1) = {"
a
c
g
g
g
g
g
g
w
x
A
D
"}
(6,1,1) = {"
a
d
h
l
h
q
h
l
x
y
a
E
"}
(7,1,1) = {"
a
a
a
a
a
a
a
a
a
a
a
B
"}
