"a" = (/turf/open/space/basic,/area/space)
"d" = (/turf/closed/wall/r_wall/syndicate,/area/space)
"e" = (/obj/structure/chair/comfy/shuttle{dir = 8; name = "tactical chair"},/obj/effect/turf_decal/stripes/line{dir = 8},/obj/effect/decal/cleanable/dirt,/obj/machinery/power/apc/syndicate{aidisabled = 1; area = "/area/shuttle/syndicate/bridge"; name = "Infiltrator E.V.A APC"; pixel_y = -26},/obj/structure/cable,/turf/open/floor/mineral/plastitanium/red,/area/space)
"h" = (/obj/effect/turf_decal/stripes/line{dir = 1},/obj/effect/turf_decal/stripes/corner,/obj/machinery/atmospherics/components/unary/vent_pump/on{dir = 4},/obj/structure/cable,/turf/open/floor/mineral/plastitanium/red,/area/space)
"i" = (/obj/structure/chair/comfy/shuttle{dir = 1; name = "tactical chair"},/turf/open/floor/mineral/plastitanium,/area/space)
"j" = (/obj/machinery/porta_turret/syndicate/shuttle{dir = 5; faction = list("Supervillain")},/turf/closed/wall/r_wall/syndicate,/area/space)
"l" = (/turf/template_noop,/area/space)
"o" = (/obj/structure/window/plasma/reinforced/plastitanium,/obj/machinery/door/poddoor/shutters{id = "syndieshutters"; name = "blast shutters"},/obj/structure/grille,/turf/open/floor/plating,/area/space)
"p" = (/obj/effect/turf_decal/stripes/line{dir = 1},/obj/effect/turf_decal/stripes/line,/obj/machinery/atmospherics/pipe/simple/supply/hidden{dir = 10},/obj/structure/cable,/turf/open/floor/mineral/plastitanium/red,/area/space)
"q" = (/obj/machinery/computer/camera_advanced/syndie,/obj/effect/turf_decal/bot,/obj/effect/turf_decal/stripes/line{dir = 4},/obj/effect/decal/cleanable/dirt,/turf/open/floor/mineral/plastitanium,/area/space)
"r" = (/obj/structure/table/reinforced,/obj/effect/turf_decal/stripes/line{dir = 8},/obj/effect/decal/cleanable/dirt,/obj/item/radio/intercom{freerange = 1; name = "Syndicate Radio Intercom"},/turf/open/floor/mineral/plastitanium,/area/space)
"s" = (/obj/effect/turf_decal/bot,/obj/machinery/computer/monitor/secret{dir = 8},/obj/structure/cable,/turf/open/floor/mineral/plastitanium,/area/space)
"B" = (/obj/machinery/computer/crew/syndie{dir = 4},/obj/effect/turf_decal/bot,/turf/open/floor/mineral/plastitanium,/area/space)
"D" = (/obj/structure/chair/comfy/shuttle{dir = 8; name = "tactical chair"},/obj/effect/turf_decal/stripes/line{dir = 9},/obj/machinery/status_display/evac{pixel_x = -32; pixel_y = 32},/obj/effect/decal/cleanable/dirt,/turf/open/floor/mineral/plastitanium/red,/area/space)
"H" = (/obj/effect/turf_decal/bot,/obj/effect/turf_decal/stripes/line{dir = 8},/obj/machinery/computer/camera_advanced/shuttle_docker{jumpto_ports = list("villain_home" = 1, "villain_custom", "syndicate_nw" = 1); shuttleId = "darkmothership"; shuttlePortId = "villain_custom"},/turf/open/floor/mineral/plastitanium,/area/space)
"I" = (/obj/effect/turf_decal/stripes/line{dir = 1},/obj/effect/turf_decal/stripes/corner{dir = 8},/obj/effect/decal/cleanable/dirt,/obj/structure/cable,/turf/open/floor/mineral/plastitanium/red,/area/space)
"J" = (/obj/machinery/computer/med_data/syndie{dir = 4},/obj/effect/turf_decal/bot,/obj/machinery/firealarm{dir = 1; pixel_y = -26},/turf/open/floor/mineral/plastitanium,/area/space)
"K" = (/obj/structure/table/reinforced,/obj/machinery/button/door{id = "syndieshutters"; name = "Bridge View Toggle"; pixel_y = 7; req_access_txt = "150"},/obj/effect/turf_decal/stripes/line{dir = 4},/obj/machinery/button/door{id = "infiltrator_bridge"; name = "Bridge Bolt Control"; normaldoorcontrol = 1; pixel_y = -2; specialfunctions = 4},/turf/open/floor/mineral/plastitanium,/area/space)
"M" = (/obj/structure/chair/comfy/shuttle{dir = 4; name = "tactical chair"},/obj/effect/turf_decal/stripes/line{dir = 4},/obj/machinery/airalarm/syndicate{dir = 1; pixel_y = -24},/obj/effect/decal/cleanable/dirt,/obj/structure/cable,/turf/open/floor/mineral/plastitanium/red,/area/space)
"Q" = (/obj/machinery/porta_turret/syndicate/shuttle{dir = 9; faction = list("Supervillain")},/turf/closed/wall/r_wall/syndicate,/area/space)
"R" = (/turf/closed/wall/r_wall/syndicate/nodiagonal,/area/space)
"S" = (/obj/structure/chair/comfy/shuttle{dir = 4; name = "tactical chair"},/obj/effect/turf_decal/stripes/line{dir = 5},/obj/machinery/status_display/ai{pixel_x = 32; pixel_y = 32},/obj/effect/decal/cleanable/dirt,/turf/open/floor/mineral/plastitanium/red,/area/space)
"V" = (/obj/structure/table/reinforced,/obj/machinery/light{dir = 8},/obj/item/reagent_containers/food/drinks/bottle/whiskey{desc = "A bottle of whiskey. There's a label that reads 'tears' taped to the front."; name = "Bottle of Tears"; pixel_x = 3; pixel_y = 5},/obj/item/reagent_containers/food/drinks/drinkingglass/shotglass{pixel_x = -7; pixel_y = 10},/obj/item/reagent_containers/food/drinks/drinkingglass/shotglass{pixel_x = -7; pixel_y = 4},/turf/open/floor/mineral/plastitanium,/area/space)
"W" = (/obj/structure/table/reinforced,/obj/machinery/light{dir = 4},/obj/item/stack/cable_coil,/obj/item/crowbar/red,/turf/open/floor/mineral/plastitanium,/area/space)
"X" = (/obj/effect/turf_decal/bot,/obj/machinery/computer/shuttle{name = "Dark Mothership shuttle console"; possible_destinations = "villain_home;villain_custom;syndicate_nw"; shuttleId = "darkmothership"},/turf/open/floor/mineral/plastitanium,/area/space)
"Y" = (/obj/effect/turf_decal/bot,/obj/machinery/computer/secure_data/syndie{dir = 8},/turf/open/floor/mineral/plastitanium,/area/space)

(1,1,1) = {"
aaaaaalQooooojlaaaaaa
aaaaaadRVHXqWRdaaaaaa
aaaaaaoBDriKSYoaaaaaa
aaaaaaoJehpIMsoaaaaaa
aaaaaadddddddddaaaaaa
aaaaaaaaaaaaaaaaaaaaa
aaaaaaaaaaaaaaaaaaaaa
aaaaaaaaaaaaaaaaaaaaa
aaaaaaaaaaaaaaaaaaaaa
aaaaaaaaaaaaaaaaaaaaa
aaaaaaaaaaaaaaaaaaaaa
aaaaaaaaaaaaaaaaaaaaa
aaaaaaaaaaaaaaaaaaaaa
aaaaaaaaaaaaaaaaaaaaa
aaaaaaaaaaaaaaaaaaaaa
aaaaaaaaaaaaaaaaaaaaa
aaaaaaaaaaaaaaaaaaaaa
aaaaaaaaaaaaaaaaaaaaa
aaaaaaaaaaaaaaaaaaaaa
aaaaaaaaaaaaaaaaaaaaa
aaaaaaaaaaaaaaaaaaaaa
"}
