"a" = (/turf/open/space,/area/space)
"b" = (/turf/closed/mineral,/area/shuttle/escape{always_unpowered = 1; requires_power = 1})
"c" = (/obj/structure/window/reinforced{dir = 1; layer = 2.9},/turf/open/floor/plating/asteroid,/area/shuttle/escape{always_unpowered = 1; requires_power = 1})
"d" = (/turf/open/floor/plating/asteroid,/area/shuttle/escape{always_unpowered = 1; requires_power = 1})
"e" = (/obj/machinery/computer/emergency_shuttle{use_power = 0},/turf/open/floor/plating/asteroid,/area/shuttle/escape{always_unpowered = 1; requires_power = 1})
"f" = (/mob/living/simple_animal/hostile/asteroid/goliath,/turf/open/floor/plating/asteroid,/area/shuttle/escape{always_unpowered = 1; requires_power = 1})
"g" = (/obj/structure/mineral_door/iron,/turf/open/floor/plating/asteroid,/area/shuttle/escape{always_unpowered = 1; requires_power = 1})
"h" = (/obj/item/weapon/pickaxe,/turf/open/floor/plating/asteroid,/area/shuttle/escape{always_unpowered = 1; requires_power = 1})
"i" = (/obj/effect/station_crash,/turf/open/floor/plating/asteroid,/area/shuttle/escape{always_unpowered = 1; requires_power = 1})
"j" = (/obj/docking_port/mobile/emergency{dwidth = 20; height = 40; name = "a meteor with engines strapped to it"; timid = 1; width = 40},/turf/open/floor/plating/asteroid,/area/shuttle/escape{always_unpowered = 1; requires_power = 1})
"k" = (/obj/structure/closet/crate,/turf/open/floor/plating/asteroid,/area/shuttle/escape{always_unpowered = 1; requires_power = 1})
"l" = (/obj/machinery/power/smes,/turf/open/floor/plating/asteroid,/area/shuttle/escape{always_unpowered = 1; requires_power = 1})
"m" = (/obj/structure/window/reinforced{dir = 1},/obj/structure/shuttle/engine/heater,/turf/open/floor/plating/airless,/area/shuttle/escape{always_unpowered = 1; requires_power = 1})
"n" = (/obj/structure/shuttle/engine/propulsion,/turf/open/floor/plating/airless,/area/shuttle/escape{always_unpowered = 1; requires_power = 1})

(1,1,1) = {"
aaabbbbbbaaabbbbaaaaabbbbbabbbbaaaaaaaaa
aabbbbbbbbbbbbbbcccccbbbbbbbbbbbbbbbbbaa
abbbbbbbbbbbbbbbdddddbbbbbbbbbbbbbbbbbba
bbbbbbbbbbbbbbbbeddddbbbbbbbbbbbbbbbbbba
bbbbbbbbbbbbbbbbbbdbbbbbbbbbbbbbbbbbbbba
ddddbbbbbbdbbbbbbbdbbbbbbbbbbbbbbbbbbbba
ddddbbbbbbddbbbbbbdbbbbbbbbbbbbbbbddbbbb
ddddbbbbbbddbbbbbbdbbbdddddbbbbbbdddbbbb
bbbbbbbbbbddbbbbbbdddddddddbbbbbbdfdbbbb
bbbbbbbbbbddbbbbbbbbbddbbbbbbbbbbdddbbbb
bbbbbbbbbbddbbbbbbbbbddbbbbbbbbbbbbbbbbb
dbbbbbbbbbddbbbbbbbbbddbbbbbbbbbbbbbbbbb
dbddbbbbbdddbbbbbbbbdddddddbbbbbbbbbbbbb
dbddddddgdddbbbbbbbddddddddbbbbbbbbbbbaa
bbddddddgdddbbbbbbbdbbbbbbbbbbbbbbdbbbaa
bddbbbbbbbbdbbbbbbbdbbbbbbbddddddddbbbbb
bdbbbbbbbbbdbbbbbbbdbbbbbbbbdbbbbbdbbbbb
ddbbbbbbbbbdbbbbbbbdbbbbbbbbdbbbbbdbbbbb
dbbbbbbbbbbdbbbbbbbdbbbbbbbbddddhbdbbbbb
dibbbbbbbbbdbbbbbbbdbbbbbbbbbbbbbbdbbbbb
jbbbbbbbbbbdbbbbbbbdbbbbbbbbbbbbbbdbbbba
dbbbbddddddddddddddddbbbbbbdbbbbbbdbbbba
dbbbdddbbbbdbbbbbbbdbbbbbbbddddddddbbbbb
bbbbdddbbbbdbbbbbbbdbbbbbbbdbbbbbbbbbbba
dbbbdddbbbbdbbbbbbbdbbbbbbbdbbbbbbbbbbba
dbbbddbbbbbbbbbbbbbdbbbbbbbdbbbbbbbbbbba
dbbbkkkbbbbbbbbbbbbdbbbbbbbdbbbllllllbba
dbbbbbbbbbbbbbbbbbbdbbbbbbbdbbbddddddbbb
dbbbbbbbbbbbbbbbbbbddddddddddddddddddbbb
ddbbbbbbbbbbbbbbbbbdbbbbbbbbbbbddddddbbb
ddbbbbbbbbbbbbbbbbbdbbbbbbbbbbbddddddbbb
ddbbbbbbbbbbbbbbbbbdbbbbbbbbbbbddddddbbb
ddbbbbbbbbbbbbbbbbbdbbbbbbbbbbbbbbbdbbbb
ddbbbbbbbbbbbbbbbbbdbbbbbbbbbbbbbbbdbbbb
ddbbbbbbbbbbbbbbbbbdbbbbbbbbbbbbbbbdbbbb
ddbbbbbbbbbbbbbbbbddddbbbbbbbbbbbbbdbbbb
bbbbbbbbbbbbbbbbbbddddbbbbbbbbbbbbbdbbbb
abbbbbbbbbbbbbbbbbddddbbbbbbbbbbbmmmmbba
aaabbbbaaaaaabbbbbmmmmbbbbbbbbaaannnnbaa
aaaaabbaaaaaabbaabnnnnaaaaaaaaaaaaaaaaaa
"}
