//MAP CONVERTED BY dmm2tgm.py THIS HEADER COMMENT PREVENTS RECONVERSION, DO NOT REMOVE
"aY" = (
/obj/machinery/door/airlock/shuttle,
/obj/effect/mapping_helpers/airlock/cyclelink_helper{
	dir = 8
	},
/turf/open/floor/wood,
/area/shuttle/escape)
"ca" = (
/obj/machinery/vending/cola,
/turf/open/floor/wood,
/area/shuttle/escape)
"cf" = (
/obj/effect/turf_decal/tile/blue{
	dir = 4
	},
/turf/open/floor/iron/white,
/area/shuttle/escape)
"cu" = (
/obj/machinery/vending/cola/red,
/turf/open/floor/wood,
/area/shuttle/escape)
"cz" = (
/obj/structure/table/wood/fancy,
/obj/item/food/nachos,
/obj/item/food/honeybun{
	pixel_x = 3;
	pixel_y = 13
	},
/turf/open/floor/wood,
/area/shuttle/escape)
"cZ" = (
/obj/item/toy/plush/lizard_plushie/green{
	name = "Hides-On-Shuttle"
	},
/turf/open/floor/wood,
/area/shuttle/escape)
"dd" = (
/obj/machinery/light/directional/north,
/obj/machinery/computer/records/medical,
/obj/effect/turf_decal/tile/blue{
	dir = 8
	},
/turf/open/floor/iron/white,
/area/shuttle/escape)
"dQ" = (
/obj/machinery/door/airlock/shuttle,
/obj/effect/turf_decal/tile/blue/fourcorners,
/turf/open/floor/iron/white,
/area/shuttle/escape)
"dR" = (
/obj/machinery/power/shuttle_engine/heater,
/turf/closed/wall/mineral/titanium/nodiagonal,
/area/shuttle/escape)
"en" = (
/obj/effect/spawner/structure/window/reinforced/shuttle,
/turf/open/floor/plating,
/area/shuttle/escape)
"fB" = (
/obj/structure/table/wood,
/obj/machinery/chem_dispenser/drinks{
	dir = 8
	},
/turf/open/floor/wood,
/area/shuttle/escape)
"fI" = (
/obj/machinery/vending/boozeomat/all_access,
/turf/open/floor/wood,
/area/shuttle/escape)
"gQ" = (
/obj/structure/table/wood/fancy,
/turf/open/floor/wood,
/area/shuttle/escape)
"iO" = (
/obj/structure/table/reinforced,
/obj/item/reagent_containers/cup/glass/mug/britcup{
	pixel_x = 8;
	pixel_y = -1
	},
/obj/item/storage/medkit/regular{
	pixel_x = -9;
	pixel_y = 3
	},
/obj/effect/turf_decal/tile/blue/fourcorners,
/turf/open/floor/iron/white,
/area/shuttle/escape)
"iP" = (
/obj/structure/window/reinforced/spawner/directional/west,
/obj/effect/turf_decal/tile/blue/fourcorners,
/turf/open/floor/iron/white,
/area/shuttle/escape)
"jt" = (
/turf/closed/wall/mineral/titanium,
/area/shuttle/escape)
"ju" = (
/obj/effect/turf_decal/tile/blue{
	dir = 8
	},
/turf/open/floor/iron/white,
/area/shuttle/escape)
"jP" = (
/obj/machinery/light/directional/north,
/obj/machinery/computer/records/security,
/obj/effect/turf_decal/tile/red/anticorner/contrasted{
	dir = 1
	},
/obj/effect/turf_decal/tile/blue,
/turf/open/floor/iron/white,
/area/shuttle/escape)
"jT" = (
/obj/item/kirbyplants/photosynthetic,
/turf/open/floor/iron/white,
/area/shuttle/escape)
"kd" = (
/turf/template_noop,
/area/template_noop)
"kE" = (
/obj/structure/table/wood/fancy,
/obj/item/flashlight/flare/candle/infinite{
	desc = "A synthetic candle that won't melt down.";
	name = "crimson red candle";
	pixel_x = 1;
	pixel_y = 6
	},
/turf/open/floor/wood,
/area/shuttle/escape)
"kJ" = (
/obj/structure/table/wood/fancy,
/obj/item/food/burger/baconburger{
	pixel_x = 3
	},
/obj/item/food/cracker{
	pixel_x = -13;
	pixel_y = 9
	},
/turf/open/floor/wood,
/area/shuttle/escape)
"kQ" = (
/obj/structure/table/reinforced,
/obj/item/clipboard,
/obj/item/folder/red,
/obj/item/pen/red,
/obj/effect/turf_decal/tile/red/anticorner/contrasted{
	dir = 8
	},
/obj/effect/turf_decal/tile/blue{
	dir = 4
	},
/turf/open/floor/iron/white,
/area/shuttle/escape)
"lg" = (
/obj/machinery/computer/station_alert{
	desc = "Used to access the shuttle's automated alert system.";
	dir = 8;
	name = "ship alert console"
	},
/obj/effect/turf_decal/tile/yellow/anticorner/contrasted,
/obj/effect/turf_decal/tile/blue{
	dir = 1
	},
/obj/machinery/light/directional/south,
/turf/open/floor/iron/white,
/area/shuttle/escape)
"lJ" = (
/obj/structure/table/reinforced,
/obj/item/camera{
	pixel_y = 3
	},
/obj/effect/turf_decal/tile/blue/fourcorners,
/turf/open/floor/iron/white,
/area/shuttle/escape)
"mv" = (
/obj/effect/turf_decal/tile/blue/anticorner/contrasted{
	dir = 1
	},
/turf/open/floor/iron/white,
/area/shuttle/escape)
"mw" = (
/mob/living/simple_animal/hostile/alien/maid/barmaid,
/turf/open/floor/wood,
/area/shuttle/escape)
"mG" = (
/obj/machinery/computer/communications,
/obj/effect/turf_decal/tile/blue/fourcorners,
/turf/open/floor/iron/white,
/area/shuttle/escape)
"ni" = (
/turf/open/floor/light/colour_cycle/dancefloor_b,
/area/shuttle/escape)
"nU" = (
/obj/structure/chair/comfy/brown{
	dir = 4
	},
/turf/open/floor/wood,
/area/shuttle/escape)
"oo" = (
/obj/machinery/light/directional/east,
/turf/open/floor/wood,
/area/shuttle/escape)
"oQ" = (
/obj/machinery/computer/slot_machine,
/turf/open/floor/wood,
/area/shuttle/escape)
"oZ" = (
/obj/machinery/computer/crew,
/obj/effect/turf_decal/tile/blue,
/turf/open/floor/iron/white,
/area/shuttle/escape)
"qd" = (
/obj/machinery/computer/warrant,
/obj/effect/turf_decal/tile/red/anticorner/contrasted{
	dir = 4
	},
/obj/effect/turf_decal/tile/blue{
	dir = 8
	},
/turf/open/floor/iron/white,
/area/shuttle/escape)
"qs" = (
/obj/structure/statue/diamond/ai1{
	anchored = 1;
	name = "statue of an AI hologram"
	},
/obj/machinery/light/directional/south,
/turf/open/floor/iron/white,
/area/shuttle/escape)
"qw" = (
/obj/effect/turf_decal/tile/blue/fourcorners,
/turf/open/floor/iron/white,
/area/shuttle/escape)
"qE" = (
/obj/machinery/door/airlock/shuttle,
/obj/effect/mapping_helpers/airlock/cyclelink_helper{
	dir = 4
	},
/turf/open/floor/wood,
/area/shuttle/escape)
"qI" = (
/obj/structure/table/wood,
/obj/machinery/chem_dispenser/drinks/beer{
	dir = 8
	},
/turf/open/floor/wood,
/area/shuttle/escape)
"rp" = (
/obj/structure/chair/comfy/shuttle{
	dir = 4
	},
/obj/machinery/light/small/directional/west,
/turf/open/floor/iron/white,
/area/shuttle/escape)
"rw" = (
/obj/structure/chair/comfy/shuttle{
	dir = 8
	},
/obj/effect/turf_decal/tile/blue/fourcorners,
/turf/open/floor/iron/white,
/area/shuttle/escape)
"rX" = (
/obj/effect/turf_decal/tile/blue/anticorner/contrasted{
	dir = 8
	},
/turf/open/floor/iron/white,
/area/shuttle/escape)
"si" = (
/obj/structure/table/wood/fancy,
/obj/machinery/light/directional/east,
/turf/open/floor/wood,
/area/shuttle/escape)
"sk" = (
/obj/structure/chair/comfy/shuttle{
	dir = 4
	},
/obj/effect/turf_decal/tile/blue/fourcorners,
/turf/open/floor/iron/white,
/area/shuttle/escape)
"sv" = (
/obj/structure/table/reinforced,
/obj/item/clipboard,
/obj/item/folder/white,
/obj/item/pen/blue,
/obj/effect/turf_decal/tile/blue{
	dir = 1
	},
/turf/open/floor/iron/white,
/area/shuttle/escape)
"sW" = (
/obj/machinery/power/shuttle_engine/huge,
/turf/open/floor/plating/airless,
/area/shuttle/escape)
"tx" = (
/obj/structure/chair/comfy/shuttle{
	dir = 1;
	name = "Shuttle Captain seat"
	},
/obj/effect/turf_decal/tile/blue/fourcorners,
/turf/open/floor/iron/white,
/area/shuttle/escape)
"uV" = (
/turf/closed/wall/mineral/titanium/nodiagonal,
/area/shuttle/escape)
"uX" = (
/obj/machinery/computer/atmos_alert{
	desc = "Used to monitor the shuttle's air alarms.";
	dir = 8
	},
/obj/effect/turf_decal/tile/yellow/anticorner/contrasted{
	dir = 4
	},
/obj/effect/turf_decal/tile/blue{
	dir = 8
	},
/turf/open/floor/iron/white,
/area/shuttle/escape)
"vq" = (
/obj/machinery/computer/emergency_shuttle,
/obj/effect/turf_decal/tile/blue/fourcorners,
/turf/open/floor/iron/white,
/area/shuttle/escape)
"vL" = (
/obj/structure/table/reinforced,
/obj/item/clothing/mask/cigarette/robust{
	pixel_x = -4;
	pixel_y = 15
	},
/obj/item/clothing/mask/cigarette/robust{
	pixel_x = 3;
	pixel_y = 7
	},
/obj/item/clothing/mask/cigarette/robust{
	pixel_x = 7;
	pixel_y = 12
	},
/obj/item/storage/fancy/cigarettes/cigpack_robust{
	pixel_x = -13;
	pixel_y = 2
	},
/obj/item/lighter/greyscale{
	pixel_x = 6;
	pixel_y = -10
	},
/obj/item/cigbutt{
	pixel_x = -8
	},
/obj/effect/turf_decal/tile/blue/fourcorners,
/turf/open/floor/iron/white,
/area/shuttle/escape)
"wf" = (
/obj/structure/table/wood/fancy,
/obj/item/food/salad/fruit{
	pixel_y = 4
	},
/turf/open/floor/wood,
/area/shuttle/escape)
"wF" = (
/obj/machinery/door/window/left/directional/west{
	name = "Bar Door"
	},
/turf/open/floor/wood,
/area/shuttle/escape)
"xb" = (
/mob/living/basic/drone/snowflake/bardrone,
/turf/open/floor/wood,
/area/shuttle/escape)
"xf" = (
/obj/structure/table/wood/fancy,
/obj/item/food/donkpocket/warm{
	pixel_x = -5;
	pixel_y = 14
	},
/obj/item/food/fries{
	pixel_x = 16;
	pixel_y = 11
	},
/turf/open/floor/wood,
/area/shuttle/escape)
"xj" = (
/turf/open/floor/plating/airless,
/area/shuttle/escape)
"xB" = (
/obj/structure/table/reinforced,
/obj/item/storage/fancy/donut_box{
	pixel_y = -7
	},
/obj/item/food/donut/plain{
	pixel_x = 5;
	pixel_y = 10
	},
/obj/effect/turf_decal/tile/blue/fourcorners,
/turf/open/floor/iron/white,
/area/shuttle/escape)
"yn" = (
/obj/effect/turf_decal/tile/blue/anticorner/contrasted{
	dir = 4
	},
/turf/open/floor/iron/white,
/area/shuttle/escape)
"yq" = (
/obj/machinery/vending/snack/green,
/turf/open/floor/wood,
/area/shuttle/escape)
"zm" = (
/obj/structure/chair/comfy/shuttle{
	dir = 1;
	name = "Shuttle HoP seat"
	},
/obj/effect/turf_decal/tile/blue/fourcorners,
/turf/open/floor/iron/white,
/area/shuttle/escape)
"Aq" = (
/obj/structure/table/wood/fancy,
/obj/item/food/cakeslice/chocolate{
	pixel_x = 16;
	pixel_y = -8
	},
/obj/item/food/burrito{
	pixel_x = -6;
	pixel_y = -4
	},
/obj/item/food/baguette{
	pixel_x = 3;
	pixel_y = 10
	},
/turf/open/floor/wood,
/area/shuttle/escape)
"Bp" = (
/obj/item/reactive_armour_shell,
/obj/structure/table/reinforced,
/obj/effect/turf_decal/tile/blue{
	dir = 1
	},
/obj/effect/turf_decal/tile/purple/anticorner/contrasted,
/turf/open/floor/iron/white,
/area/shuttle/escape)
"Cn" = (
/obj/machinery/shuttle_manipulator{
	desc = "A holographic display of the cruise shuttle we're on right now.";
	layer = 2.7;
	max_integrity = 99999;
	name = "shuttle holographic display"
	},
/obj/effect/turf_decal/tile/blue/fourcorners,
/turf/open/floor/iron/white,
/area/shuttle/escape)
"Cw" = (
/obj/machinery/vending/snack/orange,
/turf/open/floor/wood,
/area/shuttle/escape)
"CR" = (
/obj/machinery/door/airlock/shuttle,
/obj/effect/mapping_helpers/airlock/cyclelink_helper{
	dir = 4
	},
/obj/docking_port/mobile/emergency{
	name = "The NTSS Independence"
	},
/turf/open/floor/wood,
/area/shuttle/escape)
"Dn" = (
/obj/structure/table/reinforced,
/obj/item/camera_film{
	pixel_x = 4;
	pixel_y = 4
	},
/obj/item/camera_film{
	pixel_x = -13;
	pixel_y = 8
	},
/obj/effect/turf_decal/tile/blue/fourcorners,
/turf/open/floor/iron/white,
/area/shuttle/escape)
"Dq" = (
/obj/structure/table/wood/fancy,
/obj/item/food/salad/jungle{
	pixel_y = 4
	},
/turf/open/floor/wood,
/area/shuttle/escape)
"DJ" = (
/obj/machinery/light/directional/north,
/obj/effect/turf_decal/tile/blue/fourcorners,
/turf/open/floor/iron/white,
/area/shuttle/escape)
"DZ" = (
/obj/machinery/light/small/directional/south,
/turf/open/floor/wood,
/area/shuttle/escape)
"El" = (
/obj/structure/window/reinforced/spawner/directional/east,
/obj/effect/turf_decal/tile/blue/fourcorners,
/turf/open/floor/iron/white,
/area/shuttle/escape)
"Eo" = (
/obj/structure/table/reinforced,
/obj/item/toy/figure{
	desc = "A model spaceship, it looks like those used back in the day when travelling to Orion!";
	icon_state = "ship";
	name = "Orion Settler Ship figure";
	pixel_y = -5;
	toysay = "Oxygen offline. Weapons charging. All systems nominal.";
	toysound = 'sound/mecha/nominal.ogg'
	},
/obj/effect/turf_decal/tile/blue/fourcorners,
/turf/open/floor/iron/white,
/area/shuttle/escape)
"EC" = (
/obj/structure/chair/comfy/brown,
/turf/open/floor/wood,
/area/shuttle/escape)
"EH" = (
/obj/structure/chair/comfy/shuttle{
	dir = 4
	},
/obj/machinery/light/directional/west,
/turf/open/floor/iron/white,
/area/shuttle/escape)
"Fx" = (
/obj/structure/statue/diamond/ai2{
	anchored = 1;
	name = "statue of an AI core."
	},
/obj/machinery/light/directional/south,
/turf/open/floor/iron/white,
/area/shuttle/escape)
"FR" = (
/obj/machinery/computer/aifixer{
	dir = 4
	},
/obj/effect/turf_decal/tile/blue,
/obj/effect/turf_decal/tile/purple/anticorner/contrasted{
	dir = 1
	},
/turf/open/floor/iron/white,
/area/shuttle/escape)
"FS" = (
/obj/machinery/door/airlock/command/glass{
	name = "Cockpit"
	},
/obj/effect/mapping_helpers/airlock/access/all/command/general,
/obj/effect/turf_decal/tile/blue/fourcorners,
/turf/open/floor/iron/white,
/area/shuttle/escape)
"Gv" = (
/obj/structure{
	density = 1;
	icon = 'icons/obj/machines/shuttle_manipulator.dmi';
	icon_state = "hologram_on";
	layer = 2.8;
	light_color = "#2cb2e8";
	light_range = 2;
	max_integrity = 7500;
	mouse_opacity = 0;
	name = "holographic projection";
	pixel_x = -32;
	pixel_y = 17
	},
/obj/structure{
	desc = "This is the shuttle we're on. It's amazing what Nanotrasen can do once they actually put more than ten seconds of effort into their projects.";
	icon = 'icons/obj/machines/shuttle_manipulator.dmi';
	icon_state = "hologram_whiteship";
	layer = 4;
	light_color = "#2cb2e8";
	light_range = 7;
	max_integrity = 75000;
	name = "Cruise Shuttle Hologram";
	pixel_x = -32;
	pixel_y = 27
	},
/obj/effect/turf_decal/tile/blue/fourcorners,
/turf/open/floor/iron/white,
/area/shuttle/escape)
"Ho" = (
/obj/structure/chair/comfy/shuttle{
	dir = 1;
	name = "shuttle CMO seat"
	},
/obj/effect/turf_decal/tile/blue{
	dir = 4
	},
/turf/open/floor/iron/white,
/area/shuttle/escape)
"HA" = (
/obj/effect/turf_decal/tile/blue/anticorner/contrasted,
/turf/open/floor/iron/white,
/area/shuttle/escape)
"IL" = (
/obj/structure/chair/comfy/shuttle{
	dir = 4;
	name = "Shuttle CE seat"
	},
/obj/effect/turf_decal/tile/yellow/anticorner/contrasted{
	dir = 1
	},
/obj/effect/turf_decal/tile/blue,
/turf/open/floor/iron/white,
/area/shuttle/escape)
"Kc" = (
/obj/item/kirbyplants/photosynthetic,
/obj/machinery/light/directional/east,
/turf/open/floor/iron/white,
/area/shuttle/escape)
"Ki" = (
/obj/structure/chair/comfy/shuttle{
	dir = 8
	},
/turf/open/floor/iron/white,
/area/shuttle/escape)
"KB" = (
/obj/structure/chair/comfy/shuttle{
	dir = 1;
	name = "Shuttle HoS seat"
	},
/obj/effect/turf_decal/tile/red/anticorner/contrasted,
/obj/effect/turf_decal/tile/blue{
	dir = 1
	},
/turf/open/floor/iron/white,
/area/shuttle/escape)
"KD" = (
/turf/open/floor/iron/white,
/area/shuttle/escape)
"KM" = (
/obj/machinery/modular_computer/preset/research{
	dir = 4
	},
/obj/effect/turf_decal/tile/blue{
	dir = 4
	},
/obj/effect/turf_decal/tile/purple/anticorner/contrasted{
	dir = 8
	},
/obj/machinery/light/directional/south,
/turf/open/floor/iron/white,
/area/shuttle/escape)
"KS" = (
/obj/structure/chair/comfy/shuttle{
	dir = 8
	},
/obj/machinery/light/small/directional/east,
/turf/open/floor/iron/white,
/area/shuttle/escape)
"KU" = (
/obj/structure/showcase/mecha/marauder{
	desc = "A stand with an empty old Nanotrasen Corporation combat mech bolted to it. The marauder is described as the premier unit used to defend corporate interests and employees.";
	dir = 4;
	max_integrity = 2500;
	name = "marauder mech exhibit"
	},
/turf/open/floor/iron/white,
/area/shuttle/escape)
"Lo" = (
/obj/structure/table/wood/fancy,
/obj/item/reagent_containers/cup/glass/drinkingglass/shotglass{
	pixel_x = -3;
	pixel_y = 6
	},
/obj/item/reagent_containers/cup/glass/drinkingglass/shotglass{
	pixel_x = 6;
	pixel_y = 14
	},
/turf/open/floor/wood,
/area/shuttle/escape)
"LM" = (
/obj/structure/table/reinforced,
/obj/item/book/bible/booze{
	pixel_x = -3;
	pixel_y = 4
	},
/obj/item/taperecorder{
	pixel_x = 15;
	pixel_y = 4
	},
/obj/effect/turf_decal/tile/blue/fourcorners,
/turf/open/floor/iron/white,
/area/shuttle/escape)
"Me" = (
/obj/structure/chair/comfy/brown{
	dir = 1
	},
/turf/open/floor/wood,
/area/shuttle/escape)
"MI" = (
/obj/structure/table/reinforced,
/obj/item/paper_bin,
/obj/item/pen/fourcolor,
/obj/effect/turf_decal/tile/blue/fourcorners,
/turf/open/floor/iron/white,
/area/shuttle/escape)
"Nv" = (
/obj/structure/chair/comfy/shuttle,
/obj/effect/turf_decal/tile/blue/fourcorners,
/turf/open/floor/iron/white,
/area/shuttle/escape)
"NH" = (
/obj/structure/chair/comfy/brown{
	dir = 8
	},
/turf/open/floor/wood,
/area/shuttle/escape)
"Oh" = (
/obj/structure/chair/comfy/shuttle{
	dir = 8
	},
/obj/machinery/light/directional/east,
/turf/open/floor/iron/white,
/area/shuttle/escape)
"OJ" = (
/turf/open/floor/light/colour_cycle/dancefloor_a,
/area/shuttle/escape)
"Rf" = (
/obj/structure/showcase/mecha/marauder{
	desc = "A stand with an empty old Nanotrasen Corporation combat mech bolted to it. The seraph is described as the most valuable unit in defending the VIPs of Nanotrasen.";
	dir = 8;
	icon_state = "seraph";
	max_integrity = 2500;
	name = "seraph mech exhibit"
	},
/turf/open/floor/iron/white,
/area/shuttle/escape)
"So" = (
/obj/item/storage/cans/sixbeer,
/turf/open/floor/wood,
/area/shuttle/escape)
"Sx" = (
/obj/structure/table/wood,
/obj/item/coin/iron{
	pixel_x = 4;
	pixel_y = -2
	},
/obj/item/coin/iron{
	pixel_x = -8;
	pixel_y = 6
	},
/turf/open/floor/wood,
/area/shuttle/escape)
"SK" = (
/obj/structure/chair/comfy/shuttle{
	dir = 1
	},
/obj/effect/turf_decal/tile/blue/fourcorners,
/turf/open/floor/iron/white,
/area/shuttle/escape)
"TI" = (
/obj/structure/chair/comfy/shuttle{
	dir = 4
	},
/turf/open/floor/iron/white,
/area/shuttle/escape)
"Ud" = (
/obj/structure/chair/comfy/shuttle{
	dir = 8;
	name = "Shuttle RD seat"
	},
/obj/effect/turf_decal/tile/blue{
	dir = 8
	},
/obj/effect/turf_decal/tile/purple/anticorner/contrasted{
	dir = 4
	},
/turf/open/floor/iron/white,
/area/shuttle/escape)
"Uo" = (
/obj/machinery/light/directional/south,
/obj/effect/turf_decal/tile/blue/fourcorners,
/turf/open/floor/iron/white,
/area/shuttle/escape)
"UF" = (
/obj/effect/turf_decal/tile/blue{
	dir = 1
	},
/turf/open/floor/iron/white,
/area/shuttle/escape)
"UN" = (
/obj/structure/table/wood/fancy,
/obj/item/reagent_containers/cup/rag{
	pixel_y = 7
	},
/obj/effect/fun_balloon/sentience/emergency_shuttle{
	group_name = "bar staff on the NTSS Independence"
	},
/turf/open/floor/wood,
/area/shuttle/escape)
"Vk" = (
/obj/effect/turf_decal/tile/blue,
/turf/open/floor/iron/white,
/area/shuttle/escape)
"Vm" = (
/turf/closed/wall/mineral/titanium/interior,
/area/shuttle/escape)
"VO" = (
/obj/structure/table/reinforced,
/obj/item/phone{
	pixel_x = 1;
	pixel_y = 3
	},
/obj/effect/turf_decal/tile/blue/fourcorners,
/turf/open/floor/iron/white,
/area/shuttle/escape)
"VV" = (
/obj/machinery/vending/coffee,
/turf/open/floor/wood,
/area/shuttle/escape)
"WT" = (
/turf/open/floor/wood,
/area/shuttle/escape)
"Yv" = (
/obj/structure/table/reinforced,
/obj/item/clothing/glasses/heat{
	pixel_y = -5
	},
/obj/item/clothing/glasses/heat,
/obj/item/clothing/glasses/heat{
	pixel_y = 5
	},
/obj/effect/turf_decal/tile/blue/fourcorners,
/turf/open/floor/iron/white,
/area/shuttle/escape)
"YN" = (
/obj/structure{
	desc = "A jukebox for playing music. Seems like it ran out of charge.";
	icon = 'icons/obj/machines/music.dmi';
	icon_state = "jukebox";
	name = "jukebox"
	},
/turf/open/floor/wood,
/area/shuttle/escape)
"YV" = (
/obj/structure/table/reinforced,
/obj/item/clothing/head/collectable/welding,
/obj/effect/turf_decal/tile/yellow/anticorner/contrasted{
	dir = 8
	},
/obj/effect/turf_decal/tile/blue{
	dir = 4
	},
/obj/machinery/light/directional/south,
/turf/open/floor/iron/white,
/area/shuttle/escape)
"YZ" = (
/obj/machinery/light/directional/west,
/turf/open/floor/wood,
/area/shuttle/escape)

(1,1,1) = {"
kd
kd
kd
kd
kd
kd
kd
kd
kd
jt
qE
CR
jt
kd
kd
kd
kd
kd
kd
kd
kd
kd
kd
kd
kd
kd
jt
qE
qE
jt
kd
kd
kd
kd
kd
kd
kd
kd
kd
kd
kd
kd
kd
kd
"}
(2,1,1) = {"
kd
kd
kd
kd
kd
kd
en
en
jt
jt
WT
WT
jt
jt
jt
jt
kd
kd
kd
kd
kd
kd
jt
en
en
en
jt
WT
WT
jt
en
en
en
jt
kd
kd
kd
kd
kd
kd
kd
kd
kd
kd
"}
(3,1,1) = {"
kd
kd
kd
kd
kd
en
en
nU
YZ
jt
aY
aY
jt
yq
cu
jt
jt
en
en
en
en
jt
jt
EC
kE
Me
jt
aY
aY
jt
WT
nU
DZ
jt
kd
kd
kd
kd
kd
kd
kd
kd
kd
kd
"}
(4,1,1) = {"
kd
kd
kd
kd
kd
en
EC
kE
WT
WT
WT
WT
WT
WT
WT
WT
WT
WT
WT
WT
WT
WT
WT
WT
WT
WT
WT
WT
WT
WT
EC
kE
Me
jt
jt
en
en
en
en
uV
uV
kd
kd
kd
"}
(5,1,1) = {"
kd
kd
kd
kd
kd
jt
WT
WT
WT
WT
WT
WT
WT
WT
WT
WT
oo
WT
WT
WT
WT
WT
WT
WT
WT
WT
oo
WT
WT
WT
WT
NH
WT
WT
YZ
nU
nU
nU
WT
VV
uV
jt
jt
kd
"}
(6,1,1) = {"
kd
kd
en
en
jt
jt
Vm
Vm
dQ
Vm
Vm
Vm
dQ
Vm
Vm
Vm
Vm
en
en
en
en
Vm
Vm
Vm
Vm
dQ
Vm
dQ
Vm
Vm
WT
WT
WT
WT
EC
Aq
Dq
xf
Me
uV
uV
jt
jt
jt
"}
(7,1,1) = {"
jt
jt
en
qw
FR
KM
Vm
jT
qw
TI
EH
TI
qw
jT
Vm
rp
yn
TI
TI
TI
TI
HA
rp
Vm
jT
qw
KU
qw
jT
Vm
Vm
Vm
WT
WT
EC
kJ
wf
cz
Me
uV
dR
xj
xj
sW
"}
(8,1,1) = {"
jt
jP
kQ
qw
Ud
Bp
Vm
KD
qw
qw
qw
qw
qw
KD
Vm
HA
qw
qw
qw
qw
qw
qw
yn
Vm
KD
qw
qw
qw
cf
KD
jT
Vm
Vm
WT
WT
NH
NH
NH
DZ
uV
dR
xj
xj
xj
"}
(9,1,1) = {"
en
qd
KB
qw
qw
uV
Vm
KD
qw
qw
qw
qw
qw
KD
Vm
Vm
qw
qw
qw
qw
qw
qw
Vm
Vm
KD
qw
sk
sk
sk
qw
qw
qw
dQ
WT
WT
WT
WT
WT
WT
uV
dR
xj
xj
xj
"}
(10,1,1) = {"
en
qw
qw
qw
qw
Vm
jT
KD
qw
Ki
Ki
Ki
qw
KD
jT
Vm
qw
Ki
Ki
Ki
Ki
Uo
Vm
jT
Vk
Nv
xB
MI
lJ
SK
qw
qw
dQ
WT
WT
OJ
ni
OJ
WT
uV
uV
uV
uV
uV
"}
(11,1,1) = {"
en
vq
tx
qw
qw
FS
qw
qw
qw
iP
iP
iP
qw
qw
qw
dQ
qw
iP
iP
iP
iP
qw
dQ
qw
qw
Nv
LM
Cn
Dn
SK
UF
Fx
Vm
oQ
WT
ni
OJ
ni
WT
Sx
uV
cZ
uV
kd
"}
(12,1,1) = {"
en
mG
zm
qw
qw
FS
qw
qw
qw
El
El
El
qw
qw
qw
dQ
qw
El
El
El
El
qw
dQ
qw
qw
Nv
VO
Gv
iO
SK
cf
qs
Vm
oQ
WT
OJ
ni
OJ
WT
YN
uV
So
uV
kd
"}
(13,1,1) = {"
en
qw
qw
qw
qw
Vm
jT
KD
qw
TI
TI
TI
qw
KD
jT
Vm
DJ
TI
TI
TI
TI
qw
Vm
jT
ju
Nv
vL
Eo
Yv
SK
qw
qw
dQ
WT
WT
ni
OJ
ni
WT
uV
uV
uV
uV
uV
"}
(14,1,1) = {"
en
oZ
Ho
qw
qw
uV
Vm
KD
qw
qw
qw
qw
qw
KD
Vm
Vm
qw
qw
qw
qw
qw
qw
Vm
Vm
KD
qw
rw
rw
rw
qw
qw
qw
dQ
WT
WT
WT
WT
WT
WT
uV
dR
xj
xj
sW
"}
(15,1,1) = {"
jt
dd
sv
qw
IL
YV
Vm
KD
qw
qw
qw
qw
qw
KD
Vm
rX
qw
qw
qw
qw
qw
qw
mv
Vm
KD
qw
qw
qw
UF
KD
Kc
Vm
Vm
WT
WT
nU
nU
nU
DZ
uV
dR
xj
xj
xj
"}
(16,1,1) = {"
jt
jt
en
qw
uX
lg
Vm
jT
qw
Ki
Oh
Ki
qw
jT
Vm
KS
mv
Ki
Ki
Ki
Ki
rX
KS
Vm
jT
qw
Rf
qw
jT
Vm
Vm
Vm
WT
WT
gQ
Lo
UN
gQ
wF
uV
dR
xj
xj
xj
"}
(17,1,1) = {"
kd
kd
en
en
jt
jt
Vm
Vm
dQ
Vm
Vm
Vm
dQ
Vm
Vm
Vm
Vm
en
en
en
en
Vm
Vm
Vm
Vm
dQ
Vm
dQ
Vm
Vm
WT
WT
WT
EC
gQ
WT
mw
xb
WT
uV
uV
jt
jt
jt
"}
(18,1,1) = {"
kd
kd
kd
kd
kd
jt
WT
WT
WT
WT
WT
WT
WT
WT
WT
WT
YZ
WT
WT
WT
WT
WT
WT
WT
WT
WT
YZ
WT
WT
WT
WT
nU
WT
EC
si
WT
fB
qI
WT
fI
uV
jt
jt
kd
"}
(19,1,1) = {"
kd
kd
kd
kd
kd
en
EC
kE
WT
WT
WT
WT
WT
WT
WT
WT
WT
WT
WT
WT
WT
WT
WT
WT
WT
WT
WT
WT
WT
WT
EC
kE
Me
jt
jt
en
en
en
en
uV
uV
kd
kd
kd
"}
(20,1,1) = {"
kd
kd
kd
kd
kd
en
en
NH
oo
jt
qE
qE
jt
Cw
ca
jt
jt
en
en
en
en
jt
jt
EC
kE
Me
jt
qE
qE
jt
WT
NH
DZ
jt
kd
kd
kd
kd
kd
kd
kd
kd
kd
kd
"}
(21,1,1) = {"
kd
kd
kd
kd
kd
kd
en
en
jt
jt
WT
WT
jt
jt
jt
jt
kd
kd
kd
kd
kd
kd
jt
en
en
en
jt
WT
WT
jt
en
en
en
jt
kd
kd
kd
kd
kd
kd
kd
kd
kd
kd
"}
(22,1,1) = {"
kd
kd
kd
kd
kd
kd
kd
kd
kd
jt
aY
aY
jt
kd
kd
kd
kd
kd
kd
kd
kd
kd
kd
kd
kd
kd
jt
aY
aY
jt
kd
kd
kd
kd
kd
kd
kd
kd
kd
kd
kd
kd
kd
kd
"}
