"aa" = (/turf/open/space,/area/space)
"ab" = (/turf/closed/wall/rust,/area/shuttle/escape)
"ac" = (/obj/structure/grille,/obj/structure/window/reinforced/fulltile,/turf/open/floor/plating,/area/shuttle/escape)
"ad" = (/obj/structure/table,/obj/item/weapon/storage/firstaid/fire,/turf/open/floor/mineral/titanium,/area/shuttle/escape)
"ae" = (/obj/structure/chair{dir = 1},/turf/open/floor/mineral/titanium/blue,/area/shuttle/escape)
"af" = (/obj/machinery/computer/emergency_shuttle,/turf/open/floor/mineral/titanium/blue,/area/shuttle/escape)
"ag" = (/obj/structure/table,/obj/item/weapon/storage/firstaid/regular{pixel_x = 2; pixel_y = 3},/obj/item/weapon/crowbar,/turf/open/floor/mineral/titanium,/area/shuttle/escape)
"ah" = (/obj/machinery/computer/atmos_alert,/turf/open/floor/mineral/titanium,/area/shuttle/escape)
"ai" = (/obj/structure/chair{dir = 8},/turf/open/floor/mineral/titanium/blue,/area/shuttle/escape)
"aj" = (/turf/open/floor/mineral/titanium/blue,/area/shuttle/escape)
"ak" = (/obj/effect/decal/cleanable/dirt,/turf/open/floor/mineral/titanium/blue,/area/shuttle/escape)
"al" = (/obj/structure/table,/obj/item/weapon/reagent_containers/food/drinks/bottle/vodka/badminka{pixel_y = 8},/turf/open/floor/mineral/titanium,/area/shuttle/escape)
"am" = (/obj/machinery/computer/security,/turf/open/floor/mineral/titanium,/area/shuttle/escape)
"an" = (/obj/machinery/button/flasher{id = "cockpit_flasher"; pixel_x = 6; pixel_y = -24},/obj/structure/chair{dir = 8},/turf/open/floor/mineral/titanium/blue,/area/shuttle/escape)
"ao" = (/obj/item/device/radio/intercom{name = "Station Intercom (General)"; pixel_x = -5; pixel_y = -29},/obj/machinery/button/door{id = "combatants"; name = "close fight pit"; pixel_x = 10; pixel_y = -26; req_access_txt = "19"},/obj/effect/decal/cleanable/dirt,/turf/open/floor/mineral/titanium/blue,/area/shuttle/escape)
"ap" = (/obj/structure/chair,/turf/open/floor/mineral/titanium/blue,/area/shuttle/escape)
"aq" = (/obj/machinery/button/door{id = "bears"; name = "bears"; pixel_x = 26; pixel_y = 6; req_access_txt = "20"},/obj/machinery/button/door{id = "ohnorevs"; name = "in case of revolution"; pixel_x = 26; pixel_y = -6; req_access_txt = "19"; step_x = 0; step_y = 0},/obj/structure/chair,/turf/open/floor/mineral/titanium/blue,/area/shuttle/escape)
"ar" = (/obj/machinery/door/airlock/glass{name = "Glorious Leaders"; req_access_txt = "19"},/turf/open/floor/mineral/titanium/blue,/area/shuttle/escape)
"as" = (/obj/structure/grille,/obj/structure/window/reinforced/fulltile,/obj/machinery/door/poddoor/shutters/preopen{id = "ohnorevs"},/turf/open/floor/plating,/area/shuttle/escape)
"at" = (/obj/structure/chair,/turf/open/floor/mineral/plastitanium/brig,/area/shuttle/escape)
"au" = (/obj/machinery/flasher{id = "cockpit_flasher"; pixel_x = 6; pixel_y = 24},/turf/open/floor/mineral/plastitanium,/area/shuttle/escape)
"av" = (/turf/open/floor/mineral/plastitanium,/area/shuttle/escape)
"aw" = (/obj/structure/window/reinforced{dir = 1},/obj/structure/window/reinforced{dir = 8},/turf/open/floor/engine,/area/shuttle/escape)
"ax" = (/obj/structure/window/reinforced{dir = 1},/turf/open/floor/engine,/area/shuttle/escape)
"ay" = (/obj/structure/window/reinforced{dir = 1},/obj/effect/decal/cleanable/dirt,/turf/open/floor/engine,/area/shuttle/escape)
"az" = (/obj/structure/window/reinforced{dir = 4},/obj/structure/window/reinforced{dir = 1},/turf/open/floor/engine,/area/shuttle/escape)
"aA" = (/obj/machinery/flasher{id = "shuttle_flasher"; pixel_x = -24; pixel_y = 6},/obj/machinery/button/flasher{id = "shuttle_flasher"; pixel_x = -24; pixel_y = -6},/turf/open/floor/mineral/plastitanium/brig,/area/shuttle/escape)
"aB" = (/obj/effect/decal/cleanable/dirt,/turf/open/floor/mineral/plastitanium/brig,/area/shuttle/escape)
"aC" = (/turf/open/floor/mineral/plastitanium/brig,/area/shuttle/escape)
"aD" = (/obj/machinery/door/airlock/glass{name = "Emergency Shuttle Brig"; req_access_txt = "2"},/turf/open/floor/mineral/plastitanium,/area/shuttle/escape)
"aE" = (/obj/structure/chair{dir = 4},/turf/open/floor/mineral/plastitanium,/area/shuttle/escape)
"aF" = (/obj/structure/window/reinforced{dir = 8},/turf/open/floor/engine,/area/shuttle/escape)
"aG" = (/obj/effect/decal/cleanable/blood/old,/turf/open/floor/engine,/area/shuttle/escape)
"aH" = (/turf/open/floor/engine,/area/shuttle/escape)
"aI" = (/obj/machinery/door/poddoor{id = "bears"},/obj/effect/decal/cleanable/blood/old,/turf/open/floor/engine,/area/shuttle/escape)
"aJ" = (/obj/effect/decal/cleanable/blood/old,/mob/living/simple_animal/hostile/bear,/turf/open/floor/engine,/area/shuttle/escape)
"aK" = (/obj/machinery/door/airlock/titanium{name = "Emergency Shuttle Airlock"; req_access_txt = "2"},/turf/open/floor/plating,/area/shuttle/escape)
"aL" = (/obj/structure/chair{dir = 1},/turf/open/floor/mineral/plastitanium/brig,/area/shuttle/escape)
"aM" = (/obj/effect/decal/cleanable/robot_debris/old,/turf/open/floor/engine,/area/shuttle/escape)
"aN" = (/obj/effect/decal/cleanable/dirt,/turf/open/floor/engine,/area/shuttle/escape)
"aO" = (/obj/effect/decal/cleanable/vomit/old,/turf/open/floor/engine,/area/shuttle/escape)
"aP" = (/obj/effect/decal/cleanable/dirt,/turf/open/floor/mineral/plastitanium,/area/shuttle/escape)
"aQ" = (/obj/structure/window/reinforced{dir = 8},/obj/effect/decal/cleanable/dirt,/turf/open/floor/engine,/area/shuttle/escape)
"aR" = (/obj/machinery/door/airlock/titanium{name = "Emergency Shuttle Airlock"},/obj/docking_port/mobile/emergency{height = 15; name = "Box emergency shuttle"; timid = 1},/turf/open/floor/plating,/area/shuttle/escape)
"aS" = (/obj/structure/extinguisher_cabinet{pixel_x = -5; pixel_y = 30},/turf/open/floor/mineral/plastitanium,/area/shuttle/escape)
"aT" = (/obj/item/weapon/broken_bottle,/turf/open/floor/mineral/plastitanium,/area/shuttle/escape)
"aU" = (/obj/structure/window/reinforced,/obj/structure/window/reinforced{dir = 8},/turf/open/floor/engine,/area/shuttle/escape)
"aV" = (/obj/effect/decal/cleanable/shreds,/turf/open/floor/engine,/area/shuttle/escape)
"aW" = (/obj/structure/window/reinforced,/turf/open/floor/engine,/area/shuttle/escape)
"aX" = (/obj/effect/decal/cleanable/blood/old,/obj/structure/window/reinforced,/turf/open/floor/engine,/area/shuttle/escape)
"aY" = (/obj/structure/window/reinforced,/obj/structure/window/reinforced{dir = 4},/turf/open/floor/engine,/area/shuttle/escape)
"aZ" = (/obj/structure/chair{dir = 8},/obj/structure/window/reinforced{dir = 4},/turf/open/floor/mineral/plastitanium,/area/shuttle/escape)
"ba" = (/obj/structure/window/reinforced{dir = 8},/obj/structure/chair{dir = 4},/turf/open/floor/mineral/plastitanium,/area/shuttle/escape)
"bb" = (/obj/structure/table,/obj/item/weapon/reagent_containers/food/drinks/bottle/vodka,/turf/open/floor/mineral/plastitanium,/area/shuttle/escape)
"bc" = (/obj/structure/window/reinforced{dir = 4},/obj/structure/chair{dir = 1},/turf/open/floor/mineral/plastitanium,/area/shuttle/escape)
"bd" = (/obj/machinery/door/poddoor/shutters/preopen{id = "combatants"},/turf/open/floor/mineral/plastitanium,/area/shuttle/escape)
"be" = (/obj/structure/window/reinforced{dir = 8},/obj/structure/chair{dir = 1},/turf/open/floor/mineral/plastitanium,/area/shuttle/escape)
"bf" = (/obj/structure/chair{dir = 1},/turf/open/floor/mineral/plastitanium,/area/shuttle/escape)
"bg" = (/obj/structure/table,/obj/item/stack/medical/bruise_pack{pixel_x = 5; pixel_y = 5},/obj/item/stack/medical/bruise_pack,/turf/open/floor/mineral/plastitanium,/area/shuttle/escape)
"bh" = (/obj/effect/decal/cleanable/vomit/old,/turf/open/floor/mineral/plastitanium,/area/shuttle/escape)
"bi" = (/turf/open/floor/mineral/plastitanium{icon_state = "CL7"},/area/shuttle/escape)
"bj" = (/turf/open/floor/mineral/plastitanium{icon_state = "CL8"},/area/shuttle/escape)
"bk" = (/turf/open/floor/mineral/plastitanium{icon_state = "CL9"},/area/shuttle/escape)
"bl" = (/obj/structure/kitchenspike,/turf/open/floor/mineral/plastitanium,/area/shuttle/escape)
"bm" = (/turf/open/floor/mineral/plastitanium{icon_state = "CL4"},/area/shuttle/escape)
"bn" = (/turf/open/floor/mineral/plastitanium{icon_state = "CL5"},/area/shuttle/escape)
"bo" = (/turf/open/floor/mineral/plastitanium{icon_state = "CL6"},/area/shuttle/escape)
"bp" = (/obj/structure/table,/turf/open/floor/mineral/plastitanium,/area/shuttle/escape)
"bq" = (/obj/structure/table,/obj/item/clothing/gloves/boxing{pixel_x = 4; pixel_y = 7},/obj/item/clothing/gloves/boxing,/turf/open/floor/mineral/plastitanium,/area/shuttle/escape)
"br" = (/turf/open/floor/mineral/plastitanium{icon_state = "CL1"},/area/shuttle/escape)
"bs" = (/turf/open/floor/mineral/plastitanium{icon_state = "CL2"},/area/shuttle/escape)
"bt" = (/turf/open/floor/mineral/plastitanium{icon_state = "CL3"},/area/shuttle/escape)
"bu" = (/obj/item/weapon/broken_bottle,/obj/effect/decal/cleanable/blood/old,/turf/open/floor/mineral/plastitanium,/area/shuttle/escape)
"bv" = (/obj/machinery/door/airlock/titanium{name = "Emergency Shuttle Airlock"},/turf/open/floor/plating,/area/shuttle/escape)
"bw" = (/obj/structure/extinguisher_cabinet{pixel_x = 0; pixel_y = -30},/turf/open/floor/mineral/plastitanium,/area/shuttle/escape)
"bx" = (/obj/structure/extinguisher_cabinet{pixel_x = 27; pixel_y = 0},/obj/structure/table,/obj/item/weapon/reagent_containers/food/drinks/bottle/vodka,/turf/open/floor/mineral/plastitanium,/area/shuttle/escape)
"by" = (/obj/machinery/door/airlock/titanium{name = "Emergency Shuttle Cargo"},/turf/open/floor/mineral/plastitanium,/area/shuttle/escape)
"bz" = (/obj/machinery/status_display,/turf/closed/wall/rust,/area/shuttle/escape)
"bA" = (/obj/structure/grille,/obj/structure/window/shuttle,/turf/open/floor/plating,/area/shuttle/escape)
"bB" = (/obj/machinery/door/airlock/glass{name = "Emergency Shuttle Infirmary"},/turf/open/floor/mineral/plastitanium,/area/shuttle/escape)
"bC" = (/turf/open/floor/mineral/titanium/yellow,/area/shuttle/escape)
"bD" = (/obj/structure/extinguisher_cabinet{pixel_x = 27; pixel_y = 0},/turf/open/floor/mineral/titanium/yellow,/area/shuttle/escape)
"bE" = (/obj/structure/closet/emcloset,/turf/open/floor/mineral/titanium,/area/shuttle/escape)
"bF" = (/turf/open/floor/mineral/titanium,/area/shuttle/escape)
"bG" = (/obj/structure/extinguisher_cabinet{pixel_x = -5; pixel_y = 30},/turf/open/floor/mineral/titanium,/area/shuttle/escape)
"bH" = (/obj/machinery/sleeper{icon_state = "sleeper-open"; dir = 8},/turf/open/floor/mineral/titanium,/area/shuttle/escape)
"bI" = (/obj/machinery/sleeper{icon_state = "sleeper-open"; dir = 4},/turf/open/floor/mineral/titanium,/area/shuttle/escape)
"bJ" = (/obj/structure/table,/obj/item/weapon/storage/firstaid/brute,/obj/item/weapon/storage/firstaid{pixel_x = 2; pixel_y = 3},/obj/item/weapon/crowbar,/turf/open/floor/mineral/titanium,/area/shuttle/escape)
"bK" = (/obj/structure/closet,/turf/open/floor/mineral/titanium/yellow,/area/shuttle/escape)
"bL" = (/obj/structure/closet/crate,/turf/open/floor/mineral/titanium/yellow,/area/shuttle/escape)
"bM" = (/obj/structure/window/reinforced{dir = 1},/obj/structure/shuttle/engine/heater,/turf/open/floor/plating/airless,/area/shuttle/escape)
"bN" = (/obj/structure/shuttle/engine/propulsion,/turf/open/floor/plating/airless,/area/shuttle/escape)

(1,1,1) = {"
aaaaaaaaabacacacacacabaaaaaaaa
aaaaaaababadaeafaeagababaaaaaa
aaaaaaabahaiajajakajalabaaaaaa
aaaaaaabamanajaoapapaqabaaaaaa
ababababababarabasasasabababab
abatatatacauavawaxaxayazababab
abaAaBaCaDavaEaFaGaGaHaGaIaJab
aKaCaLaLacavaEaFaMaNaOaHabaJab
abababababaPaEaQaHaGaHaMaIaJab
aRavaSavaTavaEaUaVaWaXaYababab
abaEavaZbaaPbbbcbdbebfbfavbgab
acaEbhaZbaavavbibjbkavavavblac
acaEavaZbaaPaZbmbnbobpbqaPblac
acaEavaZbaavaZbrbsbtbpbpavblac
abaEavaZbabhaZavavbuavaPavblab
bvavbwaPavavavavavavavavavbxab
abababbyabababbzabbAbBbAababab
bvbCbCbCbCbCbDabbEbFbFbFbGbHac
ababbCbCbCbCbCabbIbFbFbFbJabab
aaababbKbKbLbLabbEbFbFbHababaa
aaaaababbMbMbMbMbMbMbMababaaaa
aaaaaaabbNbNbNbNbNbNbNabaaaaaa
"}
