//MAP CONVERTED BY dmm2tgm.py THIS HEADER COMMENT PREVENTS RECONVERSION, DO NOT REMOVE
"ax" = (
/turf/closed/wall/mineral/titanium/nodiagonal,
/area/shuttle/escape/brig)
"aR" = (
/obj/item/bedsheet/random{
	dir = 8
	},
/obj/structure/bed,
/obj/item/pillow/random,
/obj/effect/spawner/random/entertainment/plushie_delux,
/obj/machinery/light/dim/directional/east{
	brightness = 5;
	nightshift_brightness = 4
	},
/turf/open/floor/mineral/titanium/yellow,
/area/shuttle/escape)
"bw" = (
/turf/closed/wall/mineral/plastitanium/nodiagonal,
/area/shuttle/escape)
"cb" = (
/obj/machinery/power/shuttle_engine/heater,
/obj/structure/window/reinforced/plasma{
	dir = 1
	},
/turf/open/floor/plating,
/area/shuttle/escape)
"cQ" = (
/turf/closed/wall/mineral/titanium,
/area/shuttle/escape/brig)
"cW" = (
/mob/living/simple_animal/pet/fox,
/turf/open/floor/mineral/titanium/blue,
/area/shuttle/escape)
"dz" = (
/mob/living/simple_animal/parrot/natural{
	melee_damage_upper = 5
	},
/turf/open/floor/mineral/titanium/blue,
/area/shuttle/escape)
"dC" = (
/obj/structure/closet/cabinet,
/obj/item/pillow/random,
/obj/item/pillow/random,
/obj/item/pillow/random,
/obj/item/pillow/random,
/obj/effect/spawner/random/entertainment/plushie_delux,
/obj/effect/spawner/random/entertainment/plushie_delux,
/turf/open/floor/mineral/titanium/yellow,
/area/shuttle/escape)
"dP" = (
/obj/structure/closet/cabinet,
/obj/item/pillow/random,
/obj/item/pillow/random,
/obj/item/pillow/random,
/obj/effect/spawner/random/entertainment/plushie_delux,
/obj/effect/spawner/random/entertainment/plushie_delux,
/turf/open/floor/mineral/titanium/yellow,
/area/shuttle/escape)
"eE" = (
/turf/open/floor/mineral/titanium,
/area/shuttle/escape)
"eN" = (
/turf/open/floor/mineral/titanium/blue,
/area/shuttle/escape)
"gc" = (
/turf/closed/wall/mineral/titanium,
/area/shuttle/escape)
"gg" = (
/obj/item/bedsheet/random{
	dir = 4
	},
/obj/structure/bed{
	dir = 1
	},
/obj/item/pillow/random,
/obj/effect/spawner/random/entertainment/plushie_delux,
/turf/open/floor/mineral/titanium/yellow,
/area/shuttle/escape)
"gj" = (
/obj/structure/table,
/obj/machinery/recharger,
/obj/item/restraints/handcuffs,
/obj/machinery/light/directional/south,
/turf/open/floor/mineral/plastitanium/red,
/area/shuttle/escape/brig)
"gq" = (
/obj/structure/window,
/obj/structure/window{
	dir = 8
	},
/obj/item/pillow/random,
/turf/open/floor/mineral/titanium/blue,
/area/shuttle/escape)
"hz" = (
/obj/structure/window{
	dir = 1
	},
/turf/open/floor/mineral/titanium/blue,
/area/shuttle/escape)
"hH" = (
/mob/living/simple_animal/pet/penguin/baby,
/turf/open/floor/mineral/titanium/blue,
/area/shuttle/escape)
"iI" = (
/obj/structure/bed,
/obj/item/bedsheet/random,
/obj/item/pillow/random,
/obj/effect/spawner/random/entertainment/plushie_delux,
/turf/open/floor/mineral/titanium/yellow,
/area/shuttle/escape)
"jl" = (
/obj/structure/window{
	dir = 1
	},
/obj/structure/window{
	dir = 8
	},
/turf/open/floor/mineral/titanium/purple,
/area/shuttle/escape)
"kB" = (
/obj/machinery/door/airlock/titanium{
	name = "Emergency Shuttle Airlock"
	},
/turf/open/floor/plating,
/area/shuttle/escape)
"kZ" = (
/obj/structure/window/reinforced{
	dir = 8
	},
/obj/structure/window/reinforced{
	dir = 4
	},
/turf/open/floor/catwalk_floor/titanium,
/area/shuttle/escape)
"oo" = (
/obj/structure/bed{
	dir = 1
	},
/obj/item/bedsheet/random{
	dir = 4
	},
/obj/item/pillow/random,
/obj/effect/spawner/random/entertainment/plushie_delux,
/turf/open/floor/mineral/titanium/yellow,
/area/shuttle/escape)
"oY" = (
/obj/item/pillow/random,
/obj/structure/rack,
/obj/machinery/light/directional/south,
/turf/open/floor/mineral/titanium/blue,
/area/shuttle/escape)
"px" = (
/obj/machinery/power/shuttle_engine/heater,
/turf/open/floor/plating,
/area/shuttle/escape)
"pO" = (
/obj/structure/window/reinforced,
/obj/machinery/portable_atmospherics/canister/oxygen,
/obj/machinery/light/small/directional/north,
/turf/open/floor/catwalk_floor/titanium,
/area/shuttle/escape)
"pY" = (
/turf/template_noop,
/area/template_noop)
"rj" = (
/obj/structure/window{
	dir = 4
	},
/obj/structure/window{
	dir = 1
	},
/obj/item/pillow/random,
/turf/open/floor/mineral/titanium/purple,
/area/shuttle/escape)
"sx" = (
/obj/effect/spawner/random/entertainment/plushie_delux,
/obj/machinery/door/window/left/directional/west,
/turf/open/floor/mineral/titanium/purple,
/area/shuttle/escape)
"sG" = (
/mob/living/basic/pet/dog/corgi,
/turf/open/floor/mineral/titanium/blue,
/area/shuttle/escape)
"up" = (
/obj/structure/table,
/obj/effect/spawner/random/entertainment/musical_instrument,
/obj/effect/spawner/random/entertainment/musical_instrument,
/obj/machinery/light/dim/directional/south{
	brightness = 5;
	nightshift_brightness = 4
	},
/turf/open/floor/mineral/titanium/blue,
/area/shuttle/escape)
"ys" = (
/obj/item/bedsheet/random{
	dir = 4
	},
/obj/structure/bed{
	dir = 1
	},
/obj/item/pillow/random,
/obj/effect/spawner/random/entertainment/plushie_delux,
/obj/machinery/light/dim/directional/west{
	brightness = 5;
	nightshift_brightness = 4
	},
/turf/open/floor/mineral/titanium/yellow,
/area/shuttle/escape)
"yF" = (
/obj/structure/table,
/obj/effect/spawner/random/entertainment/plushie_delux,
/obj/effect/spawner/random/entertainment/plushie_delux,
/turf/open/floor/mineral/titanium/blue,
/area/shuttle/escape)
"zt" = (
/obj/item/bedsheet/captain,
/obj/effect/spawner/random/entertainment/plushie_delux,
/obj/structure/bed/pod,
/turf/open/floor/mineral/titanium/blue,
/area/shuttle/escape)
"Ag" = (
/turf/closed/wall/mineral/titanium/nodiagonal,
/area/shuttle/escape)
"Aw" = (
/obj/structure/chair/comfy/shuttle{
	dir = 1
	},
/turf/open/floor/mineral/titanium/blue,
/area/shuttle/escape)
"AM" = (
/obj/machinery/door/airlock/titanium{
	name = "Emergency Shuttle Airlock"
	},
/turf/open/floor/mineral/titanium,
/area/shuttle/escape)
"BW" = (
/obj/machinery/light/small/directional/east,
/turf/open/floor/catwalk_floor/titanium,
/area/shuttle/escape)
"Hf" = (
/mob/living/simple_animal/pet/cat/kitten,
/turf/open/floor/mineral/titanium/blue,
/area/shuttle/escape)
"IH" = (
/obj/effect/fun_balloon/sentience/emergency_shuttle{
	group_name = "a bunch of cutesy animals";
	effect_range = 4
	},
/turf/open/floor/mineral/titanium/purple,
/area/shuttle/escape)
"IW" = (
/turf/closed/wall,
/area/shuttle/escape)
"JE" = (
/obj/effect/mapping_helpers/airlock/access/all/security/general,
/obj/machinery/door/airlock/security/glass{
	name = "Emergency Shuttle Brig"
	},
/turf/open/floor/mineral/plastitanium/red,
/area/shuttle/escape/brig)
"JF" = (
/obj/docking_port/mobile/emergency{
	name = "Hugcage"
	},
/obj/effect/mapping_helpers/airlock/access/all/security/general,
/obj/machinery/door/airlock/security/glass{
	name = "Emergency Shuttle Brig"
	},
/turf/open/floor/mineral/plastitanium/red,
/area/shuttle/escape/brig)
"KT" = (
/obj/structure/chair/comfy/shuttle,
/turf/open/floor/mineral/plastitanium/red,
/area/shuttle/escape/brig)
"KW" = (
/obj/item/bedsheet/random{
	dir = 8
	},
/obj/structure/bed,
/obj/item/pillow/random,
/obj/effect/spawner/random/entertainment/plushie_delux,
/turf/open/floor/mineral/titanium/yellow,
/area/shuttle/escape)
"Ly" = (
/obj/structure/window,
/turf/open/floor/mineral/titanium/purple,
/area/shuttle/escape)
"LC" = (
/obj/machinery/computer/emergency_shuttle,
/turf/open/floor/mineral/titanium/blue,
/area/shuttle/escape)
"Mu" = (
/turf/open/floor/catwalk_floor/titanium,
/area/shuttle/escape)
"Ok" = (
/obj/structure/chair/comfy/shuttle{
	dir = 1
	},
/turf/open/floor/mineral/plastitanium/red,
/area/shuttle/escape/brig)
"Qc" = (
/obj/machinery/door/window/left/directional/east,
/turf/open/floor/mineral/titanium/purple,
/area/shuttle/escape)
"QX" = (
/turf/open/floor/mineral/titanium/yellow,
/area/shuttle/escape)
"Rj" = (
/obj/machinery/power/shuttle_engine/propulsion,
/turf/open/floor/plating,
/area/shuttle/escape)
"RZ" = (
/obj/effect/spawner/structure/window/reinforced/shuttle,
/turf/open/floor/plating,
/area/shuttle/escape/brig)
"Tw" = (
/turf/open/floor/mineral/plastitanium/red,
/area/shuttle/escape/brig)
"TW" = (
/obj/structure/table,
/obj/item/bikehorn/rubberducky,
/turf/open/floor/mineral/titanium/blue,
/area/shuttle/escape)
"Vf" = (
/obj/effect/mapping_helpers/airlock/access/all/command/general,
/obj/machinery/door/airlock/command/glass{
	name = "Cockpit"
	},
/turf/open/floor/mineral/titanium/blue,
/area/shuttle/escape)
"Xb" = (
/obj/structure/window,
/obj/structure/window{
	dir = 4
	},
/turf/open/floor/mineral/titanium/blue,
/area/shuttle/escape)
"XN" = (
/obj/effect/spawner/structure/window/reinforced/shuttle,
/turf/open/floor/plating,
/area/shuttle/escape)
"YW" = (
/obj/structure/window/reinforced,
/obj/structure/rack,
/obj/effect/spawner/random/engineering/toolbox,
/obj/machinery/light/small/directional/north,
/turf/open/floor/catwalk_floor/titanium,
/area/shuttle/escape)

(1,1,1) = {"
cQ
cQ
JE
cQ
JF
cQ
pY
pY
gc
kB
gc
kB
gc
gc
pY
pY
pY
pY
"}
(2,1,1) = {"
RZ
KT
Tw
Tw
Tw
cQ
pY
gc
Ag
QX
ys
QX
gg
Ag
gc
pY
pY
pY
"}
(3,1,1) = {"
RZ
KT
Tw
Tw
gj
cQ
IW
gc
dC
eN
eN
eN
eN
gg
Ag
gc
pY
pY
"}
(4,1,1) = {"
RZ
KT
Tw
Ok
ax
ax
pY
gc
iI
eN
hH
eN
eN
cW
gg
bw
bw
pY
"}
(5,1,1) = {"
cQ
cQ
JE
RZ
cQ
YW
pY
Ag
Ag
eN
jl
sx
gq
eN
yF
cb
Rj
pY
"}
(6,1,1) = {"
pY
XN
eE
eE
AM
Mu
kZ
BW
AM
eN
hz
IH
Ly
eN
up
bw
px
Rj
"}
(7,1,1) = {"
gc
gc
Vf
XN
gc
pO
pY
Ag
Ag
eN
rj
Qc
Xb
eN
TW
cb
Rj
pY
"}
(8,1,1) = {"
XN
Aw
eN
Aw
Ag
Ag
pY
gc
oo
sG
eN
dz
eN
eN
KW
bw
bw
pY
"}
(9,1,1) = {"
XN
LC
eN
eN
oY
gc
IW
gc
dP
eN
eN
eN
Hf
KW
Ag
gc
pY
pY
"}
(10,1,1) = {"
XN
Aw
eN
eN
zt
gc
pY
gc
Ag
KW
aR
KW
KW
Ag
gc
pY
pY
pY
"}
(11,1,1) = {"
gc
gc
gc
gc
gc
gc
pY
pY
gc
gc
gc
gc
gc
gc
pY
pY
pY
pY
"}
