//MAP CONVERTED BY dmm2tgm.py THIS HEADER COMMENT PREVENTS RECONVERSION, DO NOT REMOVE
"aa" = (
/turf/template_noop,
/area/template_noop)
"ab" = (
/turf/closed/wall/clockwork,
/area/shuttle/escape)
"ac" = (
/turf/closed/wall/mineral/titanium,
/area/shuttle/escape)
"ad" = (
/obj/effect/spawner/structure/window/shuttle,
/obj/effect/decal/cleanable/salt,
/turf/open/floor/fakespace,
/area/shuttle/escape)
"ae" = (
/turf/closed/wall/mineral/titanium,
/turf/closed/wall/mineral/cult,
/area/shuttle/escape)
"af" = (
/obj/effect/decal/cleanable/salt,
/obj/structure/destructible/clockwork/trap/trigger/pressure_sensor,
/obj/structure/destructible/clockwork/trap/brass_skewer,
/turf/open/indestructible/clock_spawn_room,
/area/shuttle/escape)
"ag" = (
/obj/structure/shuttle/engine/propulsion/right{
	dir = 4
	},
/turf/open/floor/plating/airless,
/area/shuttle/escape)
"ah" = (
/turf/closed/wall/mineral/titanium/nodiagonal,
/area/shuttle/escape)
"ai" = (
/obj/machinery/computer/emergency_shuttle,
/obj/effect/decal/cleanable/salt,
/turf/open/floor/fakespace,
/area/shuttle/escape)
"aj" = (
/obj/effect/decal/cleanable/salt,
/obj/structure/table/reinforced,
/obj/item/card/emag/fake,
/obj/machinery/light{
	dir = 1
	},
/turf/open/floor/fakespace,
/area/shuttle/escape)
"ak" = (
/obj/effect/decal/cleanable/salt,
/turf/open/floor/fakespace,
/area/shuttle/escape)
"al" = (
/obj/effect/decal/cleanable/salt,
/turf/open/floor/plasteel/cult,
/area/shuttle/escape)
"am" = (
/obj/effect/decal/cleanable/salt,
/obj/effect/decal/cleanable/crayon,
/turf/open/floor/plasteel/cult,
/area/shuttle/escape)
"an" = (
/obj/machinery/light{
	dir = 1
	},
/obj/effect/decal/cleanable/salt,
/turf/open/floor/plasteel/cult,
/area/shuttle/escape)
"ao" = (
/obj/effect/decal/cleanable/salt,
/obj/item/tome,
/obj/structure/table/reinforced,
/turf/open/floor/plasteel/cult,
/area/shuttle/escape)
"ap" = (
/obj/effect/decal/cleanable/salt,
/obj/item/clothing/gloves/clockwork,
/obj/structure/destructible/clockwork/trap/trigger/pressure_sensor,
/obj/structure/destructible/clockwork/trap/brass_skewer,
/turf/open/indestructible/clock_spawn_room,
/area/shuttle/escape)
"aq" = (
/obj/effect/decal/cleanable/salt,
/obj/item/clothing/suit/armor/clockwork,
/obj/structure/destructible/clockwork/trap/trigger/pressure_sensor,
/obj/structure/destructible/clockwork/trap/brass_skewer,
/turf/open/indestructible/clock_spawn_room,
/area/shuttle/escape)
"ar" = (
/obj/machinery/light{
	dir = 4
	},
/obj/effect/decal/cleanable/salt,
/obj/item/clothing/shoes/clockwork,
/obj/structure/destructible/clockwork/trap/trigger/pressure_sensor,
/obj/structure/destructible/clockwork/trap/brass_skewer,
/turf/open/indestructible/clock_spawn_room,
/area/shuttle/escape)
"as" = (
/obj/structure/shuttle/engine/propulsion{
	dir = 4
	},
/turf/open/floor/plating/airless,
/area/shuttle/escape)
"at" = (
/obj/effect/decal/cleanable/salt,
/obj/machinery/portable_atmospherics/canister/water_vapor,
/turf/open/floor/fakespace,
/area/shuttle/escape)
"au" = (
/obj/effect/decal/cleanable/salt,
/obj/structure/table/reinforced,
/obj/structure/holosign/wetsign,
/turf/open/floor/fakespace,
/area/shuttle/escape)
"av" = (
/obj/machinery/door/airlock/command/glass{
	name = "bridge door";
	req_access_txt = "19";
	secondsElectrified = -1
	},
/obj/effect/decal/cleanable/salt,
/turf/open/floor/fakespace,
/area/shuttle/escape)
"aw" = (
/obj/effect/decal/cleanable/salt,
/obj/structure/destructible/clockwork/trap/trigger/pressure_sensor,
/turf/open/indestructible/clock_spawn_room,
/area/shuttle/escape)
"ax" = (
/obj/structure/shuttle/engine/propulsion/left{
	dir = 4
	},
/turf/open/floor/plating/airless,
/area/shuttle/escape)
"ay" = (
/obj/machinery/light,
/obj/effect/decal/cleanable/salt,
/turf/open/floor/fakespace,
/area/shuttle/escape)
"az" = (
/turf/open/floor/plasteel/cult,
/turf/closed/wall/mineral/cult,
/area/shuttle/escape)
"aA" = (
/obj/effect/decal/cleanable/salt,
/obj/structure/table/reinforced,
/obj/item/twohanded/spear,
/obj/item/device/assembly/flash/handheld,
/turf/open/floor/plasteel/cult,
/area/shuttle/escape)
"aB" = (
/obj/structure/table/reinforced,
/obj/effect/decal/cleanable/salt,
/obj/item/greentext,
/obj/item/banhammer,
/turf/open/floor/plasteel/cult,
/area/shuttle/escape)
"aC" = (
/obj/effect/decal/cleanable/salt,
/turf/open/indestructible/clock_spawn_room,
/area/shuttle/escape)
"aD" = (
/obj/machinery/door/airlock/security/glass{
	name = "security airlock";
	req_access_txt = "63";
	secondsElectrified = -1
	},
/obj/effect/decal/cleanable/salt,
/turf/open/floor/plasteel/cult,
/area/shuttle/escape)
"aE" = (
/obj/structure/sign/poster/contraband/energy_swords,
/turf/closed/wall/clockwork,
/area/shuttle/escape)
"aF" = (
/obj/structure/sign/poster/contraband/revolver,
/turf/closed/wall/clockwork,
/area/shuttle/escape)
"aG" = (
/obj/effect/decal/cleanable/salt,
/obj/machinery/door/airlock/clockwork{
	req_access = null
	},
/turf/open/indestructible/clock_spawn_room,
/area/shuttle/escape)
"aH" = (
/obj/structure/sign/poster/contraband/kudzu,
/turf/closed/wall/clockwork,
/area/shuttle/escape)
"aI" = (
/obj/structure/sign/poster/contraband/busty_backdoor_xeno_babes_6,
/turf/closed/wall/clockwork,
/area/shuttle/escape)
"aJ" = (
/obj/effect/decal/cleanable/salt,
/obj/structure/table/reinforced,
/obj/item/reagent_containers/glass/beaker/waterbottle/large,
/turf/open/floor/fakespace,
/area/shuttle/escape)
"aK" = (
/obj/effect/decal/cleanable/salt,
/obj/item/grown/bananapeel,
/turf/open/floor/fakespace,
/area/shuttle/escape)
"aL" = (
/obj/structure/table/reinforced,
/obj/machinery/light{
	dir = 1
	},
/obj/effect/decal/cleanable/salt,
/obj/item/clothing/mask/vape,
/turf/open/floor/fakespace,
/area/shuttle/escape)
"aM" = (
/obj/effect/decal/cleanable/salt,
/obj/structure/table/glass,
/obj/item/toy/plush/plushvar,
/turf/open/floor/fakespace,
/area/shuttle/escape)
"aN" = (
/obj/effect/decal/cleanable/salt,
/obj/structure/table/reinforced,
/obj/item/reagent_containers/food/snacks/salad/validsalad,
/obj/item/toy/figure/warden,
/turf/open/floor/fakespace,
/area/shuttle/escape)
"aO" = (
/obj/item/grown/bananapeel,
/obj/item/storage/backpack,
/obj/effect/decal/cleanable/salt,
/turf/open/floor/fakespace,
/area/shuttle/escape)
"aP" = (
/obj/structure/table/reinforced,
/obj/effect/decal/cleanable/salt,
/obj/item/gun/ballistic/automatic/c20r/toy/unrestricted,
/turf/open/floor/fakespace,
/area/shuttle/escape)
"aQ" = (
/obj/item/soap/deluxe,
/obj/effect/decal/cleanable/salt,
/turf/open/floor/fakespace,
/area/shuttle/escape)
"aR" = (
/obj/effect/decal/cleanable/salt,
/obj/structure/table/glass,
/obj/item/toy/spinningtoy,
/turf/open/floor/fakespace,
/area/shuttle/escape)
"aS" = (
/obj/structure/table/reinforced,
/obj/effect/decal/cleanable/salt,
/obj/item/toy/katana,
/turf/open/floor/fakespace,
/area/shuttle/escape)
"aT" = (
/obj/machinery/door/airlock/titanium,
/obj/item/soap/deluxe,
/turf/open/floor/fakespace,
/area/shuttle/escape)
"aU" = (
/obj/effect/decal/cleanable/salt,
/obj/item/toy/syndicateballoon,
/turf/open/floor/fakespace,
/area/shuttle/escape)
"aW" = (
/obj/structure/table/reinforced,
/obj/effect/decal/cleanable/salt,
/obj/item/clothing/mask/vape,
/turf/open/floor/fakespace,
/area/shuttle/escape)
"aX" = (
/obj/effect/decal/cleanable/salt,
/obj/structure/table/glass,
/obj/item/toy/plush/narplush,
/turf/open/floor/fakespace,
/area/shuttle/escape)
"aY" = (
/obj/effect/decal/cleanable/salt,
/obj/structure/table/reinforced,
/obj/item/reagent_containers/food/snacks/salad/validsalad,
/obj/item/toy/figure/hos,
/turf/open/floor/fakespace,
/area/shuttle/escape)
"ba" = (
/obj/structure/table/reinforced,
/obj/effect/decal/cleanable/salt,
/obj/item/gun/ballistic/revolver/reverse,
/turf/open/floor/fakespace,
/area/shuttle/escape)
"bb" = (
/obj/structure/table/reinforced,
/obj/effect/decal/cleanable/salt,
/obj/item/toy/sword,
/turf/open/floor/fakespace,
/area/shuttle/escape)
"bc" = (
/obj/machinery/light/small,
/obj/item/soap/deluxe,
/obj/effect/decal/cleanable/salt,
/turf/open/floor/fakespace,
/area/shuttle/escape)
"bd" = (
/obj/machinery/door/airlock/titanium,
/obj/docking_port/mobile/emergency{
	dheight = 0;
	dir = 8;
	dwidth = 6;
	height = 18;
	name = "Saltmine";
	port_direction = 4;
	timid = 1;
	width = 14
	},
/obj/item/soap/deluxe,
/turf/open/floor/fakespace,
/area/shuttle/escape)
"be" = (
/obj/effect/decal/cleanable/salt,
/mob/living/simple_animal/bot/secbot/beepsky,
/turf/open/floor/fakespace,
/area/shuttle/escape)
"bf" = (
/obj/effect/decal/cleanable/salt,
/obj/structure/table/reinforced,
/obj/item/reagent_containers/glass/beaker/waterbottle/large,
/obj/structure/window/plasma/reinforced,
/turf/open/floor/fakespace,
/area/shuttle/escape)
"bg" = (
/obj/effect/decal/cleanable/salt,
/obj/item/grown/bananapeel,
/obj/structure/window/plasma/reinforced,
/turf/open/floor/fakespace,
/area/shuttle/escape)
"bh" = (
/obj/structure/table/reinforced,
/obj/effect/decal/cleanable/salt,
/obj/effect/decal/cleanable/salt,
/obj/item/clothing/mask/vape,
/obj/structure/window/plasma/reinforced,
/turf/open/floor/fakespace,
/area/shuttle/escape)
"bi" = (
/obj/effect/decal/cleanable/salt,
/obj/structure/window/plasma/reinforced,
/obj/structure/table/glass,
/obj/item/toy/plush/nukeplushie,
/turf/open/floor/fakespace,
/area/shuttle/escape)
"bj" = (
/obj/structure/window/plasma/reinforced,
/obj/effect/decal/cleanable/salt,
/obj/item/grown/bananapeel,
/turf/open/floor/fakespace,
/area/shuttle/escape)
"bk" = (
/obj/structure/window/plasma/reinforced,
/obj/effect/decal/cleanable/salt,
/obj/structure/table/reinforced,
/obj/item/reagent_containers/food/snacks/salad/validsalad,
/obj/item/toy/figure/secofficer,
/turf/open/floor/fakespace,
/area/shuttle/escape)
"bl" = (
/obj/structure/window/plasma/reinforced,
/obj/effect/decal/cleanable/salt,
/obj/item/grown/bananapeel,
/obj/item/storage/backpack,
/turf/open/floor/fakespace,
/area/shuttle/escape)
"bm" = (
/obj/structure/window/plasma/reinforced,
/obj/machinery/light{
	dir = 4
	},
/obj/effect/decal/cleanable/salt,
/obj/structure/table/reinforced,
/obj/item/gun/ballistic/automatic/l6_saw/toy/unrestricted,
/turf/open/floor/fakespace,
/area/shuttle/escape)
"bn" = (
/obj/structure/sign/poster/contraband/lizard,
/turf/closed/wall/mineral/titanium/nodiagonal,
/area/shuttle/escape)
"bo" = (
/obj/structure/sign/poster/contraband/lusty_xenomorph,
/turf/closed/wall/mineral/titanium/nodiagonal,
/area/shuttle/escape)
"bp" = (
/obj/structure/sign/poster/contraband/grey_tide,
/turf/closed/wall/mineral/titanium/nodiagonal,
/area/shuttle/escape)
"bq" = (
/obj/structure/sign/poster/contraband/fun_police,
/turf/closed/wall/mineral/titanium,
/area/shuttle/escape)
"br" = (
/obj/structure/sign/poster/official/wtf_is_co2,
/turf/closed/wall/mineral/titanium,
/area/shuttle/escape)
"bs" = (
/obj/effect/decal/cleanable/salt,
/obj/structure/table/reinforced,
/obj/item/reagent_containers/glass/beaker/waterbottle/large,
/obj/structure/window/plasma/reinforced{
	dir = 1
	},
/turf/open/floor/fakespace,
/area/shuttle/escape)
"bt" = (
/obj/effect/decal/cleanable/salt,
/obj/item/grown/bananapeel,
/obj/structure/window/plasma/reinforced{
	dir = 1
	},
/turf/open/floor/fakespace,
/area/shuttle/escape)
"bu" = (
/obj/effect/decal/cleanable/salt,
/obj/structure/table/reinforced,
/obj/item/clothing/head/collectable/wizard,
/obj/structure/window/plasma/reinforced{
	dir = 1
	},
/turf/open/floor/fakespace,
/area/shuttle/escape)
"bv" = (
/obj/effect/decal/cleanable/salt,
/obj/structure/table/glass,
/obj/item/clothing/head/kitty/genuine,
/obj/structure/window/plasma/reinforced{
	dir = 1
	},
/turf/open/floor/fakespace,
/area/shuttle/escape)
"bw" = (
/obj/effect/decal/cleanable/salt,
/obj/item/grown/bananapeel,
/obj/structure/window/plasma/reinforced{
	dir = 1
	},
/obj/item/device/assembly/flash,
/turf/open/floor/fakespace,
/area/shuttle/escape)
"bx" = (
/obj/effect/decal/cleanable/salt,
/obj/structure/table/reinforced,
/obj/structure/window/plasma/reinforced{
	dir = 1
	},
/obj/item/toy/plush/lizardplushie,
/turf/open/floor/fakespace,
/area/shuttle/escape)
"by" = (
/obj/effect/decal/cleanable/salt,
/turf/closed/wall/mineral/titanium,
/area/shuttle/escape)
"bz" = (
/obj/effect/decal/cleanable/salt,
/obj/structure/table/reinforced,
/obj/item/clothing/suit/wizrobe,
/turf/open/floor/fakespace,
/area/shuttle/escape)
"bA" = (
/obj/structure/table/glass,
/obj/effect/decal/cleanable/salt,
/obj/item/clothing/head/rabbitears,
/turf/open/floor/fakespace,
/area/shuttle/escape)
"bB" = (
/obj/effect/decal/cleanable/salt,
/obj/structure/table/reinforced,
/obj/item/stack/sheet/animalhide/lizard,
/turf/open/floor/fakespace,
/area/shuttle/escape)
"bC" = (
/obj/structure/table/reinforced,
/obj/effect/decal/cleanable/salt,
/obj/item/bikehorn,
/obj/item/organ/eyes/moth,
/turf/open/floor/fakespace,
/area/shuttle/escape)
"bD" = (
/obj/effect/decal/cleanable/salt,
/turf/open/floor/fakepit,
/area/shuttle/escape)
"bE" = (
/obj/structure/table/glass,
/obj/effect/decal/cleanable/salt,
/obj/item/storage/firstaid/fire,
/turf/open/floor/fakepit,
/area/shuttle/escape)
"bF" = (
/obj/machinery/light,
/obj/effect/decal/cleanable/salt,
/obj/structure/table/reinforced,
/obj/item/gun/magic/wand/resurrection/inert,
/turf/open/floor/fakespace,
/area/shuttle/escape)
"bG" = (
/obj/effect/decal/cleanable/salt,
/obj/structure/table/glass,
/obj/item/clothing/head/rabbitears,
/turf/open/floor/fakespace,
/area/shuttle/escape)
"bH" = (
/obj/effect/decal/cleanable/salt,
/obj/structure/table/reinforced,
/obj/item/reagent_containers/food/drinks/bottle/lizardwine,
/turf/open/floor/fakespace,
/area/shuttle/escape)
"bI" = (
/turf/open/chasm,
/area/shuttle/escape)
"bJ" = (
/obj/structure/table/glass,
/obj/machinery/light{
	dir = 4
	},
/obj/effect/decal/cleanable/salt,
/obj/item/clothing/mask/frog,
/obj/item/storage/box/hug/medical,
/turf/open/floor/fakepit,
/area/shuttle/escape)
"bK" = (
/obj/effect/decal/cleanable/salt,
/obj/structure/table/glass,
/obj/item/clothing/head/kitty/genuine,
/turf/open/floor/fakespace,
/area/shuttle/escape)
"bL" = (
/obj/effect/decal/cleanable/salt,
/obj/structure/table/reinforced,
/obj/item/toy/plush/lizardplushie,
/turf/open/floor/fakespace,
/area/shuttle/escape)
"bM" = (
/obj/effect/decal/cleanable/salt,
/obj/machinery/sleeper/syndie,
/turf/open/floor/fakepit,
/area/shuttle/escape)
"bN" = (
/obj/structure/table/glass,
/obj/effect/decal/cleanable/salt,
/obj/item/grenade/flashbang,
/obj/item/grenade/flashbang,
/obj/item/grenade/flashbang,
/obj/item/grenade/flashbang,
/obj/item/grenade/flashbang,
/turf/open/floor/fakepit,
/area/shuttle/escape)
"jz" = (
/obj/effect/decal/cleanable/salt,
/obj/structure/statue/plasma/scientist{
	desc = "This statue is suitably made from tears of a certain man, you can still hear him crying to this day.";
	oreAmount = 0
	},
/turf/open/floor/fakespace,
/area/shuttle/escape)
"oC" = (
/obj/effect/decal/cleanable/salt,
/obj/structure/window,
/obj/structure/window{
	dir = 4
	},
/mob/living/simple_animal/hostile/retaliate/clown{
	health = 200;
	maxHealth = 200
	},
/turf/open/floor/fakespace,
/area/shuttle/escape)
"rH" = (
/obj/effect/decal/cleanable/salt,
/obj/item/mecha_parts/mecha_equipment/weapon/honker,
/obj/structure/table/reinforced,
/turf/open/floor/fakespace,
/area/shuttle/escape)
"vf" = (
/obj/effect/spawner/structure/window/shuttle,
/obj/effect/decal/cleanable/salt,
/obj/structure/table/reinforced,
/turf/open/floor/fakespace,
/area/shuttle/escape)
"wp" = (
/obj/effect/decal/cleanable/salt,
/obj/structure/destructible/clockwork/trap/trigger/pressure_sensor,
/obj/structure/destructible/clockwork/trap/brass_skewer,
/obj/item/device/radio/beacon,
/turf/open/indestructible/clock_spawn_room,
/area/shuttle/escape)
"xd" = (
/obj/effect/decal/cleanable/salt,
/obj/structure/table/reinforced,
/obj/item/codespeak_manual/unlimited,
/turf/open/floor/plasteel/cult,
/area/shuttle/escape)
"xi" = (
/obj/effect/decal/cleanable/salt,
/obj/structure/table/reinforced,
/obj/item/reagent_containers/food/snacks/grown/citrus/orange,
/turf/open/floor/fakespace,
/area/shuttle/escape)
"Ac" = (
/obj/effect/decal/cleanable/salt,
/mob/living/simple_animal/bot/honkbot,
/turf/open/floor/fakespace,
/area/shuttle/escape)
"CB" = (
/obj/effect/decal/cleanable/salt,
/obj/structure/window{
	dir = 4
	},
/mob/living/simple_animal/hostile/retaliate/clown{
	health = 200;
	maxHealth = 200
	},
/turf/open/floor/fakespace,
/area/shuttle/escape)
"Ho" = (
/obj/effect/decal/cleanable/salt,
/obj/structure/window/plasma/reinforced{
	dir = 1
	},
/obj/structure/table/reinforced,
/obj/item/clothing/neck/petcollar,
/obj/item/restraints/handcuffs,
/turf/open/floor/fakespace,
/area/shuttle/escape)
"HA" = (
/obj/effect/decal/cleanable/salt,
/obj/structure/table/reinforced,
/obj/item/clothing/under/schoolgirl,
/obj/item/clothing/head/kitty,
/turf/open/floor/fakespace,
/area/shuttle/escape)
"Iq" = (
/obj/effect/decal/cleanable/salt,
/obj/structure/bed/dogbed/ian,
/obj/item/stack/sheet/animalhide/corgi,
/obj/item/reagent_containers/food/snacks/meat/slab/corgi,
/turf/open/floor/fakespace,
/area/shuttle/escape)
"LR" = (
/obj/effect/decal/cleanable/salt,
/obj/mecha/combat/honker{
	max_integrity = 60
	},
/turf/open/floor/fakespace,
/area/shuttle/escape)
"Uc" = (
/obj/effect/decal/cleanable/salt,
/obj/item/grown/bananapeel,
/obj/structure/table/reinforced,
/obj/item/clothing/suit/armor/reactive/table,
/turf/open/floor/fakespace,
/area/shuttle/escape)

(1,1,1) = {"
aa
aa
ac
ac
ac
ac
ad
ad
ad
ad
ad
ac
aa
aa
"}
(2,1,1) = {"
aa
ac
ah
LR
CB
vf
jz
aU
aU
aU
jz
ah
ac
aa
"}
(3,1,1) = {"
aa
ac
ai
oC
xi
av
Ac
ak
be
ak
Ac
ak
ac
aa
"}
(4,1,1) = {"
aa
ac
aj
rH
ay
ac
aJ
aJ
bf
bs
aJ
aJ
ac
aa
"}
(5,1,1) = {"
aa
ac
ak
at
ak
ac
aK
aK
bg
bt
aK
aK
ac
aa
"}
(6,1,1) = {"
aa
ac
Iq
au
ak
ac
aL
aW
bh
bu
bz
bF
ah
ac
"}
(7,1,1) = {"
aa
ae
ae
av
az
ae
aK
aK
bg
bt
aK
aK
aK
ac
"}
(8,1,1) = {"
aa
ae
al
al
al
az
aM
aX
bi
bv
bA
bG
bK
ac
"}
(9,1,1) = {"
aa
ae
am
al
aA
aD
aK
aK
bj
bw
aK
aK
aK
ad
"}
(10,1,1) = {"
aa
ae
an
al
al
az
aN
aY
bk
bx
bB
bH
bL
ad
"}
(11,1,1) = {"
aa
ae
al
al
al
ae
aO
aO
bl
bt
aK
aK
aK
ad
"}
(12,1,1) = {"
aa
ae
ao
xd
aB
ae
aP
ba
bm
Ho
aK
Uc
HA
ac
"}
(13,1,1) = {"
ab
ab
ab
ab
ab
aE
aQ
aQ
bn
ah
bC
ad
ac
ac
"}
(14,1,1) = {"
ab
wp
ap
af
af
aF
aR
aR
bo
by
bD
bD
bM
ac
"}
(15,1,1) = {"
ab
wp
aq
af
af
aG
aQ
aQ
bp
by
bD
bI
bD
ac
"}
(16,1,1) = {"
ab
wp
ar
aw
aC
aH
aS
bb
bq
ac
bE
bJ
bN
ac
"}
(17,1,1) = {"
ab
ab
ab
ab
ab
aI
aQ
bc
br
ac
ac
ac
ac
ac
"}
(18,1,1) = {"
ac
ag
as
ax
ac
ac
aT
bd
ac
ah
ag
as
ax
ac
"}
