//MAP CONVERTED BY dmm2tgm.py THIS HEADER COMMENT PREVENTS RECONVERSION, DO NOT REMOVE
//Model dictionary trimmed on: 11-07-2017 21:23 (UTC)
"aa" = (
/turf/open/space,
/obj/machinery/porta_turret/centcomm_shuttle{
	dir = 9
	},
/turf/closed/wall/mineral/plastitanium{
	dir = 8;
	icon_state = "diagonalWall3"
	},
/area/shuttle/escape)
"ab" = (
/obj/machinery/status_display,
/turf/closed/wall/mineral/plastitanium/interior,
/area/shuttle/escape)
"ac" = (
/obj/structure/grille,
/obj/structure/window/reinforced/fulltile,
/obj/machinery/door/poddoor/shutters{
	id = "shuttleshutters";
	name = "blast shutters"
	},
/turf/open/floor/plating,
/area/shuttle/escape)
"ad" = (
/turf/open/space,
/area/space)
"ae" = (
/obj/structure/table/reinforced,
/obj/machinery/recharger,
/turf/open/floor/plasteel/vault,
/area/shuttle/escape)
"af" = (
/obj/structure/table/reinforced,
/obj/item/weapon/storage/fancy/donut_box,
/turf/open/floor/plasteel/vault,
/area/shuttle/escape)
"ag" = (
/obj/machinery/computer/med_data,
/turf/open/floor/plasteel/black,
/area/shuttle/escape)
"ah" = (
/obj/machinery/computer/shuttle,
/turf/open/floor/plasteel/black,
/area/shuttle/escape)
"ai" = (
/obj/machinery/computer/communications,
/turf/open/floor/plasteel/black,
/area/shuttle/escape)
"aj" = (
/obj/machinery/computer/crew,
/turf/open/floor/plasteel/black,
/area/shuttle/escape)
"ak" = (
/obj/structure/table/reinforced,
/obj/item/weapon/restraints/handcuffs,
/obj/item/device/assembly/flash,
/turf/open/floor/plasteel/vault,
/area/shuttle/escape)
"al" = (
/obj/structure/table/reinforced,
/obj/item/weapon/storage/firstaid/regular,
/turf/open/floor/plasteel/vault,
/area/shuttle/escape)
"am" = (
/obj/machinery/computer/security,
/turf/open/floor/plasteel/black,
/area/shuttle/escape)
"an" = (
/turf/open/floor/plasteel/darkblue/side{
	dir = 9
	},
/area/shuttle/escape)
"ao" = (
/obj/structure/chair/office/dark{
	dir = 1
	},
/turf/open/floor/plasteel/darkblue/side{
	dir = 1
	},
/area/shuttle/escape)
"ap" = (
/turf/open/floor/plasteel/darkblue/side{
	dir = 5
	},
/area/shuttle/escape)
"aq" = (
/obj/machinery/computer/station_alert,
/turf/open/floor/plasteel/black,
/area/shuttle/escape)
"ar" = (
/turf/closed/wall/mineral/plastitanium,
/area/shuttle/escape)
"as" = (
/obj/structure/table/optable,
/obj/item/weapon/surgical_drapes,
/obj/item/clothing/gloves/color/latex,
/obj/item/clothing/mask/surgical,
/turf/open/floor/plasteel/darkpurple/side{
	dir = 1
	},
/area/shuttle/escape)
"at" = (
/obj/machinery/computer/operating,
/turf/open/floor/plasteel/darkpurple/side{
	dir = 1
	},
/area/shuttle/escape)
"au" = (
/obj/machinery/computer/secure_data,
/turf/open/floor/plasteel/black,
/area/shuttle/escape)
"av" = (
/obj/structure/chair/office/dark{
	dir = 8
	},
/turf/open/floor/plasteel/darkblue/side{
	dir = 10
	},
/area/shuttle/escape)
"aw" = (
/obj/machinery/light,
/turf/open/floor/plasteel/darkblue/side,
/area/shuttle/escape)
"ax" = (
/turf/open/floor/plasteel/darkblue/corner{
	dir = 8
	},
/area/shuttle/escape)
"ay" = (
/turf/open/floor/plasteel/darkblue/corner,
/area/shuttle/escape)
"az" = (
/obj/structure/chair/office/dark{
	dir = 4
	},
/turf/open/floor/plasteel/darkblue/side{
	dir = 6
	},
/area/shuttle/escape)
"aA" = (
/obj/machinery/computer/atmos_alert,
/turf/open/floor/plasteel/black,
/area/shuttle/escape)
"aB" = (
/obj/structure/table/reinforced,
/obj/item/weapon/scalpel,
/obj/item/weapon/circular_saw,
/obj/item/weapon/retractor,
/obj/item/weapon/hemostat,
/turf/open/floor/plasteel/darkpurple/side{
	dir = 8
	},
/area/shuttle/escape)
"aC" = (
/turf/open/floor/plasteel/black,
/area/shuttle/escape)
"aD" = (
/obj/structure/chair/office/dark{
	dir = 1
	},
/turf/open/floor/plasteel/black,
/area/shuttle/escape)
"aE" = (
/obj/structure/table/reinforced,
/obj/item/weapon/defibrillator/loaded,
/obj/machinery/light{
	dir = 4
	},
/turf/open/floor/plasteel/darkpurple/side{
	dir = 4
	},
/area/shuttle/escape)
"aF" = (
/obj/machinery/door/airlock/hatch{
	name = "Shuttle Bridge Access";
	req_access_txt = "19"
	},
/turf/open/floor/plasteel/darkblue/side{
	dir = 8
	},
/area/shuttle/escape)
"aG" = (
/obj/machinery/door/airlock/hatch{
	name = "Shuttle Bridge Access";
	req_access_txt = "19"
	},
/turf/open/floor/plasteel/darkblue/side{
	dir = 4
	},
/area/shuttle/escape)
"aH" = (
/obj/machinery/shower{
	dir = 4;
	icon_state = "shower";
	name = "emergency shower"
	},
/turf/open/floor/plasteel/darkpurple/side{
	dir = 8
	},
/area/shuttle/escape)
"aI" = (
/obj/structure/sink{
	dir = 4;
	pixel_x = 11
	},
/turf/open/floor/plasteel/darkpurple/side{
	dir = 4
	},
/area/shuttle/escape)
"aJ" = (
/obj/machinery/button/flasher{
	id = "shuttleflash";
	pixel_y = -23
	},
/obj/machinery/light{
	dir = 1
	},
/turf/open/floor/plasteel/darkblue/side{
	dir = 1
	},
/area/shuttle/escape)
"aK" = (
/turf/open/floor/plasteel/darkblue/corner{
	dir = 1
	},
/area/shuttle/escape)
"aL" = (
/turf/open/floor/plasteel/darkblue/corner{
	dir = 4
	},
/area/shuttle/escape)
"aM" = (
/obj/machinery/light{
	dir = 1
	},
/turf/open/floor/plasteel/darkblue/side{
	dir = 1
	},
/area/shuttle/escape)
"aN" = (
/obj/machinery/door/airlock/hatch,
/turf/open/floor/plasteel/darkpurple/side{
	dir = 8
	},
/area/shuttle/escape)
"aO" = (
/obj/machinery/door/airlock/hatch,
/turf/open/floor/plasteel/darkpurple/side{
	dir = 4
	},
/area/shuttle/escape)
"aP" = (
/obj/machinery/door/airlock/hatch{
	name = "Shuttle Security Bride Access";
	req_access_txt = "2"
	},
/turf/open/floor/plasteel/black,
/area/shuttle/escape)
"aQ" = (
/obj/machinery/door/airlock/hatch{
	name = "Shuttle Bridge Access";
	req_access_txt = "19"
	},
/turf/open/floor/plasteel/black,
/area/shuttle/escape)
"aR" = (
/obj/machinery/door/airlock/hatch{
	name = "Shuttle EVA";
	req_access_txt = "19"
	},
/turf/open/floor/plasteel/black,
/area/shuttle/escape)
"aS" = (
/turf/open/floor/plasteel/darkpurple/side{
	dir = 8
	},
/area/shuttle/escape)
"aT" = (
/obj/structure/table/reinforced,
/obj/item/weapon/storage/firstaid/toxin,
/obj/item/weapon/storage/firstaid/o2{
	pixel_x = 4;
	pixel_y = 4
	},
/turf/open/floor/plasteel/black,
/area/shuttle/escape)
"aU" = (
/obj/structure/table/reinforced,
/obj/item/weapon/storage/firstaid/fire,
/obj/item/weapon/storage/firstaid/brute{
	pixel_x = 3;
	pixel_y = 4
	},
/turf/open/floor/plasteel/black,
/area/shuttle/escape)
"aV" = (
/turf/open/floor/plasteel/darkpurple/side{
	dir = 4
	},
/area/shuttle/escape)
"aW" = (
/turf/open/floor/mineral/plastitanium/brig{
	dir = 9;
	floor_tile = /obj/item/stack/tile/plasteel;
	icon_state = "darkred"
	},
/area/shuttle/escape)
"aX" = (
/turf/open/floor/mineral/plastitanium/brig{
	dir = 4;
	floor_tile = /obj/item/stack/tile/plasteel;
	icon_state = "darkred"
	},
/area/shuttle/escape)
"aY" = (
/turf/open/floor/plasteel/darkgreen/side{
	dir = 4
	},
/area/shuttle/escape)
"aZ" = (
/turf/open/floor/plasteel/darkyellow/side{
	dir = 8;
	icon_state = "darkyellow"
	},
/area/shuttle/escape)
"ba" = (
/obj/item/clothing/suit/hazardvest{
	desc = "A high-visibility lifejacket complete with whistle and slot for oxygen tanks.";
	name = "emergency lifejacket"
	},
/obj/item/clothing/suit/hazardvest{
	desc = "A high-visibility lifejacket complete with whistle and slot for oxygen tanks.";
	name = "emergency lifejacket"
	},
/obj/item/clothing/suit/hazardvest{
	desc = "A high-visibility lifejacket complete with whistle and slot for oxygen tanks.";
	name = "emergency lifejacket"
	},
/obj/item/clothing/suit/hazardvest{
	desc = "A high-visibility lifejacket complete with whistle and slot for oxygen tanks.";
	name = "emergency lifejacket"
	},
/obj/item/clothing/suit/hazardvest{
	desc = "A high-visibility lifejacket complete with whistle and slot for oxygen tanks.";
	name = "emergency lifejacket"
	},
/obj/item/weapon/tank/internals/emergency_oxygen/double{
	pixel_x = 3
	},
/obj/item/weapon/tank/internals/emergency_oxygen/double{
	pixel_x = 3
	},
/obj/item/weapon/tank/internals/emergency_oxygen/double{
	pixel_x = 3
	},
/obj/item/weapon/tank/internals/emergency_oxygen/double{
	pixel_x = 3
	},
/obj/item/weapon/tank/internals/emergency_oxygen/double{
	pixel_x = 3
	},
/obj/item/clothing/mask/breath{
	pixel_x = -3;
	pixel_y = -3
	},
/obj/item/clothing/mask/breath{
	pixel_x = -3;
	pixel_y = -3
	},
/obj/item/clothing/mask/breath{
	pixel_x = -3;
	pixel_y = -3
	},
/obj/item/clothing/mask/breath{
	pixel_x = -3;
	pixel_y = -3
	},
/obj/item/clothing/mask/breath{
	pixel_x = -3;
	pixel_y = -3
	},
/obj/item/clothing/head/hardhat/orange{
	name = "protective hat";
	pixel_y = 9
	},
/obj/item/clothing/head/hardhat/orange{
	name = "protective hat";
	pixel_y = 9
	},
/obj/item/clothing/head/hardhat/orange{
	name = "protective hat";
	pixel_y = 9
	},
/obj/item/clothing/head/hardhat/orange{
	name = "protective hat";
	pixel_y = 9
	},
/obj/item/clothing/head/hardhat/orange{
	name = "protective hat";
	pixel_y = 9
	},
/obj/structure/closet/crate/internals,
/obj/machinery/light{
	dir = 1
	},
/turf/open/floor/plasteel/darkyellow/side{
	icon_state = "darkyellow";
	dir = 5
	},
/area/shuttle/escape)
"bb" = (
/turf/open/floor/mineral/plastitanium/brig{
	dir = 8;
	floor_tile = /obj/item/stack/tile/plasteel;
	icon_state = "darkred"
	},
/area/shuttle/escape)
"bc" = (
/obj/structure/chair{
	dir = 8
	},
/turf/open/floor/mineral/plastitanium/brig{
	dir = 4;
	floor_tile = /obj/item/stack/tile/plasteel;
	icon_state = "darkred"
	},
/area/shuttle/escape)
"bd" = (
/turf/open/floor/plasteel/darkgreen/side{
	dir = 8
	},
/area/shuttle/escape)
"be" = (
/turf/open/floor/plasteel/darkyellow/side{
	dir = 4;
	icon_state = "darkyellow"
	},
/area/shuttle/escape)
"bf" = (
/obj/structure/table/reinforced,
/obj/item/weapon/storage/firstaid,
/turf/open/floor/plasteel/darkpurple/side{
	dir = 8
	},
/area/shuttle/escape)
"bg" = (
/obj/structure/chair/office/dark{
	dir = 8
	},
/turf/open/floor/plasteel/black,
/area/shuttle/escape)
"bh" = (
/obj/structure/bed/roller,
/obj/machinery/iv_drip,
/turf/open/floor/plasteel/darkpurple/side{
	dir = 4
	},
/area/shuttle/escape)
"bi" = (
/obj/machinery/suit_storage_unit/standard_unit,
/turf/open/floor/plasteel/darkyellow/side{
	dir = 10;
	icon_state = "darkyellow"
	},
/area/shuttle/escape)
"bj" = (
/obj/machinery/suit_storage_unit/standard_unit,
/turf/open/floor/plasteel/darkyellow/side{
	icon_state = "darkyellow";
	dir = 6
	},
/area/shuttle/escape)
"bk" = (
/obj/item/weapon/reagent_containers/glass/bottle/epinephrine{
	pixel_x = 6
	},
/obj/item/weapon/reagent_containers/glass/bottle/charcoal{
	pixel_x = -3
	},
/obj/item/weapon/reagent_containers/glass/bottle/epinephrine{
	pixel_x = -3;
	pixel_y = 8
	},
/obj/item/weapon/reagent_containers/glass/bottle/charcoal{
	pixel_x = 6;
	pixel_y = 8
	},
/obj/item/weapon/reagent_containers/syringe/epinephrine{
	pixel_x = 3;
	pixel_y = -2
	},
/obj/item/weapon/reagent_containers/syringe/epinephrine{
	pixel_x = 4;
	pixel_y = 1
	},
/obj/item/weapon/reagent_containers/syringe/epinephrine{
	pixel_x = -2;
	pixel_y = 5
	},
/obj/item/weapon/reagent_containers/syringe/epinephrine{
	pixel_x = 2;
	pixel_y = 8
	},
/obj/structure/table/reinforced,
/obj/machinery/light{
	dir = 8
	},
/turf/open/floor/plasteel/darkpurple/side{
	dir = 8
	},
/area/shuttle/escape)
"bl" = (
/obj/machinery/sleeper{
	dir = 8
	},
/turf/open/floor/plasteel/darkpurple/side{
	dir = 4
	},
/area/shuttle/escape)
"bm" = (
/obj/structure/table/reinforced,
/obj/machinery/recharger,
/turf/open/floor/mineral/plastitanium/brig{
	dir = 4;
	floor_tile = /obj/item/stack/tile/plasteel;
	icon_state = "darkred"
	},
/area/shuttle/escape)
"bn" = (
/obj/machinery/status_display,
/turf/closed/wall/mineral/plastitanium,
/area/shuttle/escape)
"bo" = (
/mob/living/simple_animal/bot/medbot{
	name = "\improper emergency medibot";
	pixel_x = -3;
	pixel_y = 2
	},
/turf/open/floor/plasteel/darkpurple/side{
	dir = 8
	},
/area/shuttle/escape)
"bp" = (
/turf/open/floor/plasteel/darkgreen/corner{
	dir = 4
	},
/area/shuttle/escape)
"bq" = (
/turf/open/floor/plasteel/darkgreen/side{
	icon_state = "darkgreen";
	dir = 1
	},
/area/shuttle/escape)
"br" = (
/obj/machinery/door/airlock/hatch,
/turf/open/floor/plasteel/black,
/area/shuttle/escape)
"bs" = (
/turf/open/floor/plasteel/darkpurple/side{
	dir = 1
	},
/area/shuttle/escape)
"bt" = (
/turf/open/floor/plasteel/darkpurple/corner{
	dir = 1
	},
/area/shuttle/escape)
"bu" = (
/obj/structure/chair/office/dark,
/turf/open/floor/plasteel/black,
/area/shuttle/escape)
"bv" = (
/obj/structure/chair{
	dir = 8
	},
/turf/open/floor/mineral/plastitanium/brig{
	dir = 6;
	floor_tile = /obj/item/stack/tile/plasteel;
	icon_state = "darkred"
	},
/area/shuttle/escape)
"bw" = (
/turf/open/floor/plasteel/darkgreen/corner,
/area/shuttle/escape)
"bx" = (
/turf/open/floor/plasteel/darkgreen/side,
/area/shuttle/escape)
"by" = (
/turf/open/floor/plasteel/darkpurple/side,
/area/shuttle/escape)
"bz" = (
/obj/structure/table/reinforced,
/obj/item/weapon/paper_bin,
/obj/item/weapon/pen/blue,
/turf/open/floor/plasteel/darkpurple/side,
/area/shuttle/escape)
"bA" = (
/obj/machinery/computer/med_data,
/turf/open/floor/plasteel/darkpurple/side,
/area/shuttle/escape)
"bB" = (
/obj/machinery/door/airlock/hatch{
	name = "Shuttle Brig";
	req_access_txt = "2"
	},
/turf/open/floor/plasteel/black,
/area/shuttle/escape)
"bC" = (
/obj/docking_port/mobile/emergency{
	dwidth = 14;
	height = 18;
	name = "Centcomm Raven Battlecruiser";
	timid = 1;
	width = 32
	},
/obj/machinery/door/airlock/hatch,
/turf/open/floor/plasteel/black,
/area/shuttle/escape)
"bD" = (
/turf/open/floor/plasteel/darkgreen/side{
	dir = 9;
	icon_state = "darkgreen"
	},
/area/shuttle/escape)
"bE" = (
/turf/open/floor/plasteel/darkgreen/corner{
	dir = 1
	},
/area/shuttle/escape)
"bF" = (
/obj/structure/rack,
/obj/item/weapon/storage/toolbox/mechanical{
	pixel_x = 3;
	pixel_y = -6
	},
/obj/item/weapon/storage/toolbox/emergency,
/obj/item/weapon/storage/toolbox/electrical{
	pixel_x = -2;
	pixel_y = 5
	},
/turf/open/floor/plasteel/darkgreen/side{
	dir = 9;
	icon_state = "darkgreen"
	},
/area/shuttle/escape)
"bG" = (
/obj/structure/rack,
/obj/item/clothing/suit/fire/firefighter,
/obj/item/weapon/tank/internals/oxygen/red,
/obj/item/clothing/mask/gas,
/obj/item/clothing/head/hardhat/red,
/turf/open/floor/plasteel/darkgreen/side{
	dir = 5
	},
/area/shuttle/escape)
"bH" = (
/obj/structure/chair,
/turf/open/floor/plasteel/darkgreen/side{
	dir = 8
	},
/area/shuttle/escape)
"bI" = (
/obj/machinery/door/airlock/hatch,
/turf/open/floor/plasteel/darkgreen/side{
	icon_state = "darkgreen";
	dir = 1
	},
/area/shuttle/escape)
"bJ" = (
/obj/structure/table/reinforced,
/obj/item/weapon/dice/d20,
/turf/open/floor/plasteel/darkgreen/side{
	dir = 10
	},
/area/shuttle/escape)
"bK" = (
/obj/structure/chair{
	dir = 8
	},
/turf/open/floor/plasteel/darkgreen/side,
/area/shuttle/escape)
"bL" = (
/turf/open/floor/plasteel/darkgreen/corner{
	dir = 8
	},
/area/shuttle/escape)
"bM" = (
/obj/machinery/door/airlock/hatch,
/turf/open/floor/plasteel/darkgreen/side,
/area/shuttle/escape)
"bN" = (
/obj/item/clothing/suit/hazardvest{
	desc = "A high-visibility lifejacket complete with whistle and slot for oxygen tanks.";
	name = "emergency lifejacket"
	},
/obj/item/clothing/suit/hazardvest{
	desc = "A high-visibility lifejacket complete with whistle and slot for oxygen tanks.";
	name = "emergency lifejacket"
	},
/obj/item/clothing/suit/hazardvest{
	desc = "A high-visibility lifejacket complete with whistle and slot for oxygen tanks.";
	name = "emergency lifejacket"
	},
/obj/item/clothing/suit/hazardvest{
	desc = "A high-visibility lifejacket complete with whistle and slot for oxygen tanks.";
	name = "emergency lifejacket"
	},
/obj/item/clothing/suit/hazardvest{
	desc = "A high-visibility lifejacket complete with whistle and slot for oxygen tanks.";
	name = "emergency lifejacket"
	},
/obj/item/weapon/tank/internals/emergency_oxygen/double{
	pixel_x = 3
	},
/obj/item/weapon/tank/internals/emergency_oxygen/double{
	pixel_x = 3
	},
/obj/item/weapon/tank/internals/emergency_oxygen/double{
	pixel_x = 3
	},
/obj/item/weapon/tank/internals/emergency_oxygen/double{
	pixel_x = 3
	},
/obj/item/weapon/tank/internals/emergency_oxygen/double{
	pixel_x = 3
	},
/obj/item/clothing/mask/breath{
	pixel_x = -3;
	pixel_y = -3
	},
/obj/item/clothing/mask/breath{
	pixel_x = -3;
	pixel_y = -3
	},
/obj/item/clothing/mask/breath{
	pixel_x = -3;
	pixel_y = -3
	},
/obj/item/clothing/mask/breath{
	pixel_x = -3;
	pixel_y = -3
	},
/obj/item/clothing/mask/breath{
	pixel_x = -3;
	pixel_y = -3
	},
/obj/item/clothing/head/hardhat/orange{
	name = "protective hat";
	pixel_y = 9
	},
/obj/item/clothing/head/hardhat/orange{
	name = "protective hat";
	pixel_y = 9
	},
/obj/item/clothing/head/hardhat/orange{
	name = "protective hat";
	pixel_y = 9
	},
/obj/item/clothing/head/hardhat/orange{
	name = "protective hat";
	pixel_y = 9
	},
/obj/item/clothing/head/hardhat/orange{
	name = "protective hat";
	pixel_y = 9
	},
/obj/structure/closet/crate/internals,
/turf/open/floor/plasteel/darkgreen/side{
	dir = 6
	},
/area/shuttle/escape)
"bO" = (
/obj/machinery/door/airlock/hatch,
/turf/open/floor/plasteel/darkgreen/side{
	dir = 8
	},
/area/shuttle/escape)
"bP" = (
/obj/machinery/door/airlock/hatch,
/turf/open/floor/plasteel/darkgreen/side{
	dir = 4
	},
/area/shuttle/escape)
"bQ" = (
/obj/machinery/recharge_station,
/turf/open/floor/plasteel/darkgreen/side{
	dir = 9;
	icon_state = "darkgreen"
	},
/area/shuttle/escape)
"bR" = (
/obj/machinery/recharge_station,
/turf/open/floor/plasteel/darkgreen/side{
	dir = 5
	},
/area/shuttle/escape)
"bS" = (
/obj/item/weapon/twohanded/required/kirbyplants{
	icon_state = "plant-22"
	},
/turf/open/floor/plasteel/darkgreen/side{
	dir = 9;
	icon_state = "darkgreen"
	},
/area/shuttle/escape)
"bT" = (
/obj/item/weapon/twohanded/required/kirbyplants{
	icon_state = "plant-22"
	},
/turf/open/floor/plasteel/darkgreen/side{
	dir = 5
	},
/area/shuttle/escape)
"bU" = (
/obj/structure/chair{
	dir = 8
	},
/obj/structure/window/reinforced{
	dir = 4
	},
/turf/open/floor/plasteel/black,
/area/shuttle/escape)
"bV" = (
/obj/structure/chair{
	dir = 4
	},
/obj/structure/window/reinforced{
	dir = 8
	},
/turf/open/floor/plasteel/black,
/area/shuttle/escape)
"bW" = (
/obj/structure/chair{
	dir = 1
	},
/obj/structure/window/reinforced,
/turf/open/floor/plasteel/black,
/area/shuttle/escape)
"bX" = (
/obj/structure/chair,
/obj/structure/window/reinforced{
	dir = 1
	},
/turf/open/floor/plasteel/black,
/area/shuttle/escape)
"bY" = (
/obj/structure/chair,
/turf/open/floor/plasteel/darkgreen/side{
	icon_state = "darkgreen";
	dir = 1
	},
/area/shuttle/escape)
"bZ" = (
/obj/structure/chair{
	dir = 1
	},
/turf/open/floor/plasteel/darkgreen/side,
/area/shuttle/escape)
"ca" = (
/obj/item/weapon/twohanded/required/kirbyplants{
	icon_state = "plant-22"
	},
/turf/open/floor/plasteel/darkgreen/side{
	dir = 10
	},
/area/shuttle/escape)
"cb" = (
/obj/item/weapon/twohanded/required/kirbyplants{
	icon_state = "plant-22"
	},
/turf/open/floor/plasteel/darkgreen/side{
	dir = 6
	},
/area/shuttle/escape)
"cc" = (
/obj/structure/reagent_dispensers/fueltank,
/obj/machinery/light{
	dir = 8
	},
/turf/open/floor/plasteel/darkgreen/side{
	dir = 9;
	icon_state = "darkgreen"
	},
/area/shuttle/escape)
"cd" = (
/obj/structure/reagent_dispensers/watertank,
/obj/machinery/light{
	dir = 4
	},
/turf/open/floor/plasteel/darkgreen/side{
	dir = 5
	},
/area/shuttle/escape)
"ce" = (
/obj/machinery/door/airlock/hatch,
/turf/open/floor/plasteel/darkgreen/corner{
	dir = 8
	},
/area/shuttle/escape)
"cf" = (
/obj/machinery/door/airlock/hatch,
/turf/open/floor/plasteel/darkgreen/corner,
/area/shuttle/escape)
"cg" = (
/obj/structure/shuttle/engine/heater,
/turf/open/floor/plating,
/area/shuttle/escape)
"ch" = (
/obj/structure/window/reinforced{
	dir = 8
	},
/turf/open/floor/plasteel/darkgreen/side{
	dir = 8
	},
/area/shuttle/escape)
"ci" = (
/obj/structure/window/reinforced{
	dir = 4
	},
/turf/open/floor/plasteel/darkgreen/side{
	dir = 4
	},
/area/shuttle/escape)
"cj" = (
/obj/structure/shuttle/engine/propulsion,
/turf/open/floor/plating,
/area/shuttle/escape)
"ck" = (
/obj/structure/window/reinforced,
/obj/structure/window/reinforced{
	dir = 8
	},
/turf/open/floor/plasteel/darkgreen/side{
	dir = 8
	},
/area/shuttle/escape)
"cl" = (
/obj/structure/window/reinforced,
/obj/structure/window/reinforced{
	dir = 4
	},
/turf/open/floor/plasteel/darkgreen/side{
	dir = 4
	},
/area/shuttle/escape)
"cm" = (
/turf/open/space,
/obj/machinery/porta_turret/centcomm_shuttle{
	dir = 5
	},
/turf/closed/wall/mineral/plastitanium{
	dir = 1;
	icon_state = "diagonalWall3"
	},
/area/shuttle/escape)
"cn" = (
/turf/closed/wall/mineral/plastitanium/interior,
/area/shuttle/escape)
"co" = (
/obj/structure/grille,
/obj/structure/window/reinforced/fulltile,
/turf/open/floor/plating,
/area/shuttle/escape)
"cp" = (
/turf/open/space,
/turf/closed/wall/mineral/plastitanium{
	dir = 8;
	icon_state = "diagonalWall3"
	},
/area/shuttle/escape)
"cq" = (
/turf/open/space,
/turf/closed/wall/mineral/plastitanium{
	dir = 1;
	icon_state = "diagonalWall3"
	},
/area/shuttle/escape)
"cr" = (
/obj/machinery/button/door{
	id = "shuttleshutters";
	name = "Bridge Blast Shutters";
	pixel_y = -26;
	req_access_txt = "19"
	},
/obj/machinery/light,
/turf/open/floor/plasteel/darkblue/side,
/area/shuttle/escape)
"cs" = (
/obj/structure/grille,
/obj/machinery/door/poddoor/shutters{
	id = "shuttleshutters";
	name = "blast shutters"
	},
/obj/structure/window/reinforced/fulltile,
/turf/open/floor/plating,
/area/shuttle/escape)
"ct" = (
/turf/open/space,
/turf/closed/wall/mineral/plastitanium{
	icon_state = "diagonalWall3"
	},
/area/shuttle/escape)
"cu" = (
/turf/open/space,
/turf/closed/wall/mineral/plastitanium{
	dir = 4;
	icon_state = "diagonalWall3"
	},
/area/shuttle/escape)
"cv" = (
/turf/open/space,
/obj/machinery/porta_turret/centcomm_shuttle{
	dir = 10
	},
/turf/closed/wall/mineral/plastitanium{
	icon_state = "diagonalWall3"
	},
/area/shuttle/escape)
"cw" = (
/turf/open/space,
/obj/machinery/porta_turret/centcomm_shuttle{
	dir = 6
	},
/turf/closed/wall/mineral/plastitanium{
	dir = 4;
	icon_state = "diagonalWall3"
	},
/area/shuttle/escape)
"cx" = (
/obj/machinery/flasher{
	id = "shuttleflash";
	pixel_x = 24
	},
/obj/machinery/light{
	dir = 4
	},
/turf/open/floor/plasteel/darkgreen/side{
	dir = 4
	},
/area/shuttle/escape)
"cy" = (
/obj/machinery/light{
	dir = 4
	},
/turf/open/floor/plasteel/darkpurple/side{
	dir = 4
	},
/area/shuttle/escape)
"cz" = (
/obj/machinery/light{
	dir = 8
	},
/turf/open/floor/mineral/plastitanium/brig{
	dir = 8;
	floor_tile = /obj/item/stack/tile/plasteel;
	icon_state = "darkred"
	},
/area/shuttle/escape)
"cA" = (
/obj/machinery/light{
	dir = 1
	},
/turf/open/floor/plasteel/darkgreen/side{
	icon_state = "darkgreen";
	dir = 1
	},
/area/shuttle/escape)
"cB" = (
/obj/machinery/light{
	dir = 8
	},
/turf/open/floor/plasteel/darkgreen/side{
	dir = 8
	},
/area/shuttle/escape)
"cC" = (
/obj/machinery/light{
	dir = 1
	},
/turf/open/floor/plasteel/darkgreen/side{
	icon_state = "darkgreen";
	dir = 1
	},
/area/shuttle/escape)
"cD" = (
/obj/machinery/light,
/turf/open/floor/plasteel/darkgreen/side,
/area/shuttle/escape)
"cE" = (
/obj/machinery/light,
/turf/open/floor/plasteel/darkgreen/side,
/area/shuttle/escape)
"cF" = (
/obj/machinery/button/flasher{
	id = "cockpit_flasher";
	pixel_x = 6;
	pixel_y = -24
	},
/obj/machinery/light,
/turf/open/floor/mineral/titanium/blue,
/area/space)
"cG" = (
/obj/machinery/light{
	dir = 1
	},
/turf/open/floor/plasteel/darkgreen/side{
	icon_state = "darkgreen";
	dir = 1
	},
/area/shuttle/escape)
"cH" = (
/obj/machinery/light{
	dir = 1
	},
/turf/open/floor/plasteel/darkgreen/side{
	icon_state = "darkgreen";
	dir = 1
	},
/area/shuttle/escape)
"cI" = (
/obj/machinery/light{
	dir = 1
	},
/turf/open/floor/plasteel/darkgreen/side{
	icon_state = "darkgreen";
	dir = 1
	},
/area/shuttle/escape)
"cJ" = (
/obj/machinery/light{
	dir = 4
	},
/turf/open/floor/plasteel/darkgreen/side{
	dir = 4
	},
/area/shuttle/escape)
"cK" = (
/obj/machinery/light{
	dir = 8
	},
/turf/open/floor/plasteel/darkgreen/side{
	dir = 8
	},
/area/shuttle/escape)
"cL" = (
/obj/machinery/light,
/turf/open/floor/plasteel/darkgreen/side,
/area/shuttle/escape)
"cM" = (
/obj/machinery/light{
	dir = 4
	},
/turf/open/floor/plasteel/darkgreen/side{
	dir = 4
	},
/area/shuttle/escape)
"cN" = (
/obj/machinery/light,
/turf/open/floor/plasteel/darkgreen/side,
/area/shuttle/escape)
"cO" = (
/obj/machinery/light,
/turf/open/floor/plasteel/darkgreen/side,
/area/shuttle/escape)

(1,1,1) = {"
aa
cn
ac
ac
ct
ad
aa
co
co
cn
co
co
br
cn
bC
co
co
ct
ad
aa
br
co
br
cn
co
cn
co
cv
ad
ad
aa
ar
"}
(2,1,1) = {"
ab
ae
am
au
cn
cn
ar
aW
bb
cz
bb
bb
bb
bB
bD
bH
bJ
cn
ad
co
bD
bd
bd
cK
bd
bd
ca
co
ad
cp
ar
cj
"}
(3,1,1) = {"
ac
af
an
av
cn
an
aP
aX
bc
bc
bm
bc
bv
ab
bq
aC
bK
cn
cn
cn
bq
bW
bX
aC
bW
bX
bx
cn
cn
cn
cg
cj
"}
(4,1,1) = {"
ac
ag
ao
aw
ar
aJ
ar
cn
co
co
co
co
cn
ar
cC
aC
cD
ar
bQ
bn
cG
bW
bX
aC
bW
bX
cN
ab
cc
ar
cg
cj
"}
(5,1,1) = {"
ac
ah
ao
ax
aF
aK
aQ
bd
bd
bd
bd
bd
cB
bd
bE
aC
bL
bO
bE
bO
bE
aC
aC
aC
bW
bX
bL
bO
bE
ce
ch
ck
"}
(6,1,1) = {"
ac
ai
ao
ay
aG
aL
aQ
cx
aY
aY
aY
bp
bw
aY
aY
bp
bw
bP
bp
bP
bp
aC
aC
aC
bW
bX
bw
bP
bp
cf
ci
cl
"}
(7,1,1) = {"
ac
aj
ao
cr
ar
aM
ar
cn
co
co
ab
bq
bx
bn
cn
bI
bM
ar
bR
bn
cH
bW
bX
aC
bW
bX
cO
ab
cd
ar
cg
cj
"}
(8,1,1) = {"
ac
ak
ap
az
cn
ap
aR
aZ
aZ
bi
cn
bq
bx
cn
bF
bE
cE
cn
cn
cn
bq
bW
bX
aC
bW
bX
bx
cn
cn
cn
cg
cj
"}
(9,1,1) = {"
ab
al
aq
aA
cn
cn
ar
ba
be
bj
cn
cA
bx
cn
bG
aY
bN
cn
ad
co
bT
aY
bp
aC
bw
aY
cb
co
ad
cq
ar
cj
"}
(10,1,1) = {"
cm
cn
ac
cs
cu
ad
cm
cn
aR
cn
ar
bq
bx
ar
co
co
co
cu
ad
cm
co
cn
bq
aC
bx
cn
co
cw
ad
ad
cm
ar
"}
(11,1,1) = {"
ad
ad
ad
ad
ad
ad
ad
ad
ad
ad
cn
br
br
cn
ad
ad
ad
ad
ad
ad
ad
co
bY
aC
bZ
co
ad
ad
ad
ad
ad
ad
"}
(12,1,1) = {"
ad
ad
cp
cn
co
cn
co
co
co
cn
bn
bs
by
bn
ad
ad
ad
ad
aa
cn
cn
cn
cI
aC
cL
cn
cn
cn
ct
ad
ad
ad
"}
(13,1,1) = {"
ad
aa
ar
aB
aH
aN
aS
aS
bf
bk
bo
bt
by
co
ad
ad
ad
ad
cn
bS
bd
bd
bE
aC
bL
bd
bd
ca
cn
ad
ad
ad
"}
(14,1,1) = {"
ad
co
as
aC
aC
co
aT
aC
bg
bg
aC
bu
bz
co
ad
ad
cF
ad
co
bq
bU
bU
bU
aC
bU
bU
bU
bx
co
ad
ad
ad
"}
(15,1,1) = {"
ad
co
at
aD
aC
co
aU
aC
aC
aC
aC
aC
bA
co
ad
ad
ad
ad
co
bq
bV
bV
bV
aC
bV
bV
bV
bx
co
ad
ad
ad
"}
(16,1,1) = {"
ad
cm
ar
aE
aI
aO
cy
aV
bh
bl
bh
bl
ar
cu
ad
ad
ad
ad
cn
bT
aY
aY
cJ
aY
cM
aY
aY
cb
cn
ad
ad
ad
"}
(17,1,1) = {"
ad
ad
cq
cn
co
cn
cn
co
co
co
co
cn
cu
ad
ad
ad
ad
ad
cm
cn
co
co
ab
co
ab
co
co
cn
cu
ad
ad
ad
"}
