//MAP CONVERTED BY dmm2tgm.py THIS HEADER COMMENT PREVENTS RECONVERSION, DO NOT REMOVE
//Model dictionary trimmed on: 11-07-2017 21:22 (UTC)
"aa" = (
/turf/open/space,
/area/space)
"ab" = (
/obj/structure/grille,
/obj/structure/window/shuttle,
/turf/open/floor/plating,
/area/shuttle/escape)
"ac" = (
/turf/closed/wall/mineral/titanium/nodiagonal,
/area/shuttle/escape)
"ad" = (
/obj/structure/table/wood,
/obj/item/device/flashlight/lamp/green,
/turf/open/floor/carpet,
/area/shuttle/escape)
"ae" = (
/obj/structure/chair/comfy/brown{
	dir = 1
	},
/turf/open/floor/carpet,
/area/shuttle/escape)
"af" = (
/obj/machinery/computer/emergency_shuttle,
/turf/open/floor/carpet,
/area/shuttle/escape)
"ag" = (
/obj/structure/table/wood,
/obj/item/weapon/storage/fancy/cigarettes/cigars/havana,
/obj/item/weapon/lighter{
	pixel_x = -4;
	pixel_y = 6
	},
/turf/open/floor/carpet,
/area/shuttle/escape)
"ah" = (
/obj/structure/extinguisher_cabinet{
	pixel_y = 30
	},
/obj/machinery/light/small{
	dir = 1
	},
/turf/open/floor/plasteel/freezer,
/area/shuttle/escape)
"ai" = (
/obj/machinery/computer/atmos_alert,
/turf/open/floor/carpet,
/area/shuttle/escape)
"aj" = (
/obj/structure/chair/comfy/brown{
	dir = 8
	},
/turf/open/floor/carpet,
/area/shuttle/escape)
"ak" = (
/turf/open/floor/carpet,
/area/shuttle/escape)
"al" = (
/obj/structure/chair/comfy/brown{
	dir = 4
	},
/turf/open/floor/carpet,
/area/shuttle/escape)
"am" = (
/obj/machinery/computer/security,
/turf/open/floor/carpet,
/area/shuttle/escape)
"an" = (
/obj/machinery/computer/crew,
/turf/open/floor/carpet,
/area/shuttle/escape)
"ao" = (
/obj/structure/extinguisher_cabinet{
	pixel_y = -30
	},
/obj/structure/chair/comfy/brown{
	dir = 8
	},
/turf/open/floor/carpet,
/area/shuttle/escape)
"ap" = (
/obj/item/device/radio/intercom{
	name = "Station Intercom (General)";
	pixel_y = -29
	},
/turf/open/floor/carpet,
/area/shuttle/escape)
"aq" = (
/obj/machinery/button/flasher{
	id = "cockpit_flasher";
	pixel_x = 6;
	pixel_y = -24
	},
/obj/structure/table/wood/poker,
/obj/item/weapon/storage/box/drinkingglasses,
/obj/item/weapon/reagent_containers/food/drinks/bottle/whiskey,
/obj/machinery/light,
/turf/open/floor/carpet,
/area/shuttle/escape)
"ar" = (
/obj/machinery/computer/communications,
/turf/open/floor/carpet,
/area/shuttle/escape)
"as" = (
/obj/machinery/door/airlock/glass{
	name = "Emergency Shuttle Cockpit";
	req_access_txt = "19"
	},
/turf/open/floor/carpet,
/area/shuttle/escape)
"at" = (
/obj/machinery/status_display,
/turf/closed/wall/mineral/titanium,
/area/shuttle/escape)
"au" = (
/obj/structure/chair,
/turf/open/floor/mineral/plastitanium/brig,
/area/shuttle/escape)
"av" = (
/obj/machinery/flasher{
	id = "cockpit_flasher";
	pixel_x = 6;
	pixel_y = 24
	},
/obj/item/weapon/twohanded/required/kirbyplants{
	icon_state = "plant-21";
	layer = 4.1;
	pixel_x = -3;
	pixel_y = 3
	},
/obj/machinery/light{
	dir = 1
	},
/turf/open/floor/plasteel/bar,
/area/shuttle/escape)
"aw" = (
/turf/open/floor/plasteel/bar,
/area/shuttle/escape)
"ax" = (
/obj/structure/piano{
	icon_state = "piano";
	name = "space piano"
	},
/turf/open/floor/plasteel/grimy,
/area/shuttle/escape)
"ay" = (
/obj/structure/chair/stool{
	can_buckle = 1
	},
/turf/open/floor/plasteel/grimy,
/area/shuttle/escape)
"az" = (
/obj/machinery/flasher{
	id = "shuttle_flasher";
	pixel_x = -24;
	pixel_y = 6
	},
/obj/machinery/button/flasher{
	id = "shuttle_flasher";
	pixel_x = -24;
	pixel_y = -6
	},
/obj/machinery/light/small{
	brightness = 3;
	dir = 8
	},
/turf/open/floor/mineral/plastitanium/brig,
/area/shuttle/escape)
"aA" = (
/turf/open/floor/mineral/plastitanium/brig,
/area/shuttle/escape)
"aB" = (
/obj/machinery/door/airlock/glass{
	name = "Emergency Shuttle Brig";
	req_access_txt = "2"
	},
/turf/open/floor/plasteel/bar,
/area/shuttle/escape)
"aC" = (
/obj/machinery/door/airlock/titanium{
	name = "Emergency Shuttle Airlock";
	req_access_txt = "2"
	},
/turf/open/floor/mineral/plastitanium/brig,
/area/shuttle/escape)
"aD" = (
/obj/structure/extinguisher_cabinet{
	pixel_y = -30
	},
/turf/open/floor/mineral/plastitanium/brig,
/area/shuttle/escape)
"aE" = (
/obj/structure/chair{
	dir = 1
	},
/turf/open/floor/mineral/plastitanium/brig,
/area/shuttle/escape)
"aF" = (
/obj/structure/chair/stool/bar{
	can_buckle = 1;
	name = "buckleable bar stool"
	},
/turf/open/floor/plasteel/bar,
/area/shuttle/escape)
"aG" = (
/obj/structure/table/wood/bar{
	boot_dir = 9
	},
/turf/open/floor/plasteel/bar,
/area/shuttle/escape)
"aH" = (
/obj/structure/table/wood/bar,
/turf/open/floor/plasteel/bar,
/area/shuttle/escape)
"aI" = (
/obj/structure/table/wood/bar{
	boot_dir = 8
	},
/turf/open/floor/plasteel/bar,
/area/shuttle/escape)
"aJ" = (
/obj/structure/extinguisher_cabinet{
	pixel_x = 27
	},
/obj/structure/table,
/obj/item/weapon/storage/box/drinkingglasses,
/obj/item/weapon/reagent_containers/food/drinks/bottle/lizardwine,
/turf/open/floor/plasteel/bar,
/area/shuttle/escape)
"aK" = (
/obj/machinery/door/airlock/titanium{
	name = "Emergency Shuttle Airlock"
	},
/obj/docking_port/mobile/emergency{
	name = "The Emergency Escape Bar";
	timid = 1
	},
/turf/open/floor/plasteel/bar,
/area/shuttle/escape)
"aL" = (
/mob/living/simple_animal/hostile/alien/maid/barmaid,
/turf/open/floor/plasteel/bar,
/area/shuttle/escape)
"aM" = (
/obj/structure/table,
/obj/machinery/chem_dispenser/drinks/beer,
/turf/open/floor/plasteel/bar,
/area/shuttle/escape)
"aN" = (
/obj/structure/chair/wood/normal,
/turf/open/floor/plasteel/grimy,
/area/shuttle/escape)
"aO" = (
/obj/machinery/light{
	dir = 4
	},
/mob/living/simple_animal/drone/snowflake/bardrone,
/turf/open/floor/plasteel/bar,
/area/shuttle/escape)
"aP" = (
/obj/machinery/vending/boozeomat,
/turf/closed/wall/mineral/titanium,
/area/shuttle/escape)
"aQ" = (
/obj/structure/chair/wood/normal{
	dir = 4
	},
/turf/open/floor/plasteel/grimy,
/area/shuttle/escape)
"aR" = (
/obj/structure/table/wood/bar,
/obj/effect/spawner/lootdrop/gambling,
/turf/open/floor/plasteel/grimy,
/area/shuttle/escape)
"aS" = (
/obj/structure/table,
/obj/machinery/chem_dispenser/drinks,
/turf/open/floor/plasteel/bar,
/area/shuttle/escape)
"aT" = (
/obj/item/weapon/twohanded/required/kirbyplants{
	icon_state = "plant-21";
	layer = 4.1;
	pixel_x = -3;
	pixel_y = 3
	},
/turf/open/floor/plasteel/grimy,
/area/shuttle/escape)
"aU" = (
/obj/structure/table/wood/bar{
	boot_dir = 10
	},
/turf/open/floor/plasteel/bar,
/area/shuttle/escape)
"aV" = (
/obj/structure/table/wood/bar{
	boot_dir = 2
	},
/turf/open/floor/plasteel/bar,
/area/shuttle/escape)
"aW" = (
/obj/machinery/door/airlock/titanium{
	name = "Emergency Shuttle Airlock"
	},
/turf/open/floor/plasteel/bar,
/area/shuttle/escape)
"aX" = (
/turf/open/floor/mineral/titanium,
/area/shuttle/escape)
"aY" = (
/obj/machinery/vending/cigarette,
/turf/open/floor/plasteel/bar,
/area/shuttle/escape)
"aZ" = (
/obj/machinery/door/airlock{
	name = "Unisex Restrooms";
	req_access_txt = "0"
	},
/turf/open/floor/plasteel/freezer,
/area/shuttle/escape)
"ba" = (
/obj/structure/grille,
/obj/structure/window/shuttle,
/obj/structure/sign/bluecross_2,
/turf/closed/wall/mineral/titanium,
/area/shuttle/escape)
"bb" = (
/obj/machinery/door/airlock/titanium{
	name = "Emergency Shuttle Airlock"
	},
/turf/open/floor/plasteel/freezer,
/area/shuttle/escape)
"bc" = (
/turf/open/floor/plasteel/freezer,
/area/shuttle/escape)
"bd" = (
/obj/machinery/door/airlock/glass_medical{
	name = "Medbay"
	},
/turf/open/floor/mineral/titanium,
/area/shuttle/escape)
"be" = (
/obj/machinery/sleeper{
	dir = 8
	},
/turf/open/floor/mineral/titanium,
/area/shuttle/escape)
"bf" = (
/obj/machinery/door/airlock{
	name = "Unit 1"
	},
/turf/open/floor/plasteel/freezer,
/area/shuttle/escape)
"bg" = (
/turf/closed/wall/mineral/titanium,
/area/shuttle/escape)
"bh" = (
/obj/machinery/door/airlock{
	name = "Unit 2"
	},
/turf/open/floor/plasteel/freezer,
/area/shuttle/escape)
"bi" = (
/obj/machinery/door/airlock{
	name = "Unit B"
	},
/turf/open/floor/plasteel/freezer,
/area/shuttle/escape)
"bj" = (
/obj/structure/table/optable,
/obj/item/weapon/surgical_drapes,
/obj/machinery/light/small{
	brightness = 3;
	dir = 8
	},
/turf/open/floor/mineral/titanium,
/area/shuttle/escape)
"bk" = (
/obj/structure/toilet{
	dir = 4
	},
/obj/machinery/light/small{
	dir = 4
	},
/turf/open/floor/plasteel/freezer,
/area/shuttle/escape)
"bl" = (
/obj/machinery/recharge_station,
/obj/machinery/light/small{
	dir = 4
	},
/turf/open/floor/plasteel/freezer,
/area/shuttle/escape)
"bm" = (
/obj/structure/table,
/obj/item/weapon/circular_saw,
/obj/item/weapon/hemostat,
/obj/item/weapon/retractor,
/obj/item/weapon/scalpel,
/turf/open/floor/mineral/titanium,
/area/shuttle/escape)
"bn" = (
/obj/structure/window/reinforced{
	dir = 1
	},
/obj/structure/shuttle/engine/heater,
/turf/open/floor/plating/airless,
/area/shuttle/escape)
"bo" = (
/obj/structure/shuttle/engine/propulsion,
/turf/open/floor/plating/airless,
/area/shuttle/escape)
"bp" = (
/obj/structure/grille,
/obj/structure/window/shuttle,
/turf/open/floor/plasteel/freezer,
/area/shuttle/escape)
"bq" = (
/obj/item/weapon/twohanded/required/kirbyplants{
	icon_state = "plant-21";
	layer = 4.1;
	pixel_x = -3;
	pixel_y = 3
	},
/turf/open/floor/plasteel/bar,
/area/shuttle/escape)
"br" = (
/turf/open/floor/plasteel/grimy,
/area/shuttle/escape)
"bs" = (
/obj/structure/table/wood/bar,
/obj/item/device/instrument/guitar,
/turf/open/floor/plasteel/bar,
/area/shuttle/escape)
"bt" = (
/obj/structure/table/wood/bar,
/obj/item/weapon/storage/fancy/donut_box,
/turf/open/floor/plasteel/grimy,
/area/shuttle/escape)
"bu" = (
/obj/structure/chair/wood/normal{
	dir = 8
	},
/turf/open/floor/plasteel/grimy,
/area/shuttle/escape)
"bv" = (
/obj/structure/table/wood/bar,
/turf/open/floor/plasteel/grimy,
/area/shuttle/escape)
"bw" = (
/obj/structure/chair/comfy/brown{
	dir = 8
	},
/turf/open/floor/plasteel/grimy,
/area/shuttle/escape)
"bx" = (
/obj/structure/table,
/obj/item/weapon/storage/box/drinkingglasses,
/obj/item/weapon/reagent_containers/food/drinks/shaker,
/obj/item/weapon/storage/fancy/cigarettes/cigars/havana,
/turf/open/floor/plasteel/bar,
/area/shuttle/escape)
"by" = (
/obj/structure/table/wood/bar,
/obj/item/weapon/folder/red,
/turf/open/floor/plasteel/grimy,
/area/shuttle/escape)
"bz" = (
/obj/structure/table/wood/bar,
/obj/item/toy/cards/deck/cas,
/obj/item/toy/cards/deck/cas/black{
	pixel_y = 6
	},
/turf/open/floor/plasteel/grimy,
/area/shuttle/escape)
"bA" = (
/obj/structure/chair/wood/normal{
	dir = 1
	},
/turf/open/floor/plasteel/grimy,
/area/shuttle/escape)
"bB" = (
/obj/structure/extinguisher_cabinet{
	pixel_y = -30
	},
/turf/open/floor/plasteel/bar,
/area/shuttle/escape)
"bC" = (
/obj/structure/table,
/obj/item/weapon/storage/firstaid/regular,
/obj/item/weapon/storage/firstaid/toxin{
	pixel_x = 4;
	pixel_y = 4
	},
/turf/open/floor/mineral/titanium,
/area/shuttle/escape)
"bD" = (
/obj/item/weapon/twohanded/required/kirbyplants{
	icon_state = "plant-10"
	},
/turf/open/floor/plasteel/bar,
/area/shuttle/escape)
"bE" = (
/obj/structure/table,
/obj/item/weapon/storage/firstaid/fire,
/obj/item/weapon/storage/firstaid/brute{
	pixel_x = 4;
	pixel_y = 4
	},
/turf/open/floor/mineral/titanium,
/area/shuttle/escape)
"bF" = (
/obj/structure/table/wood/bar{
	boot_dir = 8
	},
/obj/effect/fun_balloon/sentience/emergency_shuttle{
	group_name = "bar staff on the Emergency Escape Bar"
	},
/turf/open/floor/plasteel/bar,
/area/shuttle/escape)
"bG" = (
/obj/machinery/light/small{
	dir = 4
	},
/turf/open/floor/plasteel/grimy,
/area/shuttle/escape)
"bH" = (
/obj/machinery/light{
	dir = 8
	},
/turf/open/floor/plasteel/bar,
/area/shuttle/escape)
"bI" = (
/obj/machinery/light/small{
	dir = 1
	},
/turf/open/floor/plasteel/bar,
/area/shuttle/escape)
"bJ" = (
/obj/machinery/light/small,
/turf/open/floor/plasteel/bar,
/area/shuttle/escape)
"bK" = (
/obj/machinery/light,
/turf/open/floor/plasteel/bar,
/area/shuttle/escape)
"bL" = (
/obj/machinery/sleeper{
	dir = 8
	},
/obj/machinery/light/small{
	dir = 4
	},
/turf/open/floor/mineral/titanium,
/area/shuttle/escape)

(1,1,1) = {"
aa
aa
aa
aa
bg
bg
bg
aC
bg
aK
bg
ab
ab
ab
bg
aW
bg
bb
bg
bg
bg
aa
"}
(2,1,1) = {"
aa
bg
bg
bg
bg
au
az
aD
bg
bI
br
aQ
aT
aQ
br
bJ
bg
bc
bf
bk
bg
bg
"}
(3,1,1) = {"
bg
ac
ai
an
bg
au
aA
aE
bg
aw
aN
aR
bv
by
bA
bB
bg
bc
bg
bg
bn
bo
"}
(4,1,1) = {"
ab
ad
aj
ao
bg
au
aA
aE
bg
aw
aN
bt
bw
bz
bA
aw
bg
ah
bh
bk
bn
bo
"}
(5,1,1) = {"
ab
ae
ak
ap
bg
ab
aB
ab
ac
aw
br
bu
br
bu
br
aw
at
bc
bg
bg
bn
bo
"}
(6,1,1) = {"
ab
af
ak
aq
bg
av
aw
aw
bH
aw
aw
aw
aw
aw
aw
aw
aZ
bc
bi
bl
bn
bo
"}
(7,1,1) = {"
ab
ae
ak
ak
as
aw
aw
aF
aF
aF
aF
aF
aF
aF
aw
bK
ac
bg
bg
bg
bn
bo
"}
(8,1,1) = {"
ab
ag
al
al
at
bq
aw
aG
aI
bF
aI
aI
aI
aU
aF
aw
ba
aX
bj
bm
bn
bo
"}
(9,1,1) = {"
bg
ac
am
ar
bg
ax
br
aH
aw
aL
aO
aw
aw
aV
aw
aw
bd
aX
aX
bC
bn
bo
"}
(10,1,1) = {"
aa
bg
bg
bg
bg
ay
bG
bs
aJ
aM
aP
aS
bx
aV
bD
aY
bp
be
bL
bE
bg
bg
"}
(11,1,1) = {"
aa
aa
aa
aa
bg
ab
bg
ab
bg
bg
bg
ab
ab
ab
bg
bg
bg
ab
bg
ab
bg
aa
"}
