//MAP CONVERTED BY dmm2tgm.py THIS HEADER COMMENT PREVENTS RECONVERSION, DO NOT REMOVE
"aa" = (
/turf/template_noop,
/area/template_noop)
"ab" = (
/turf/closed/wall/mineral/titanium,
/area/shuttle/escape)
"ac" = (
/obj/effect/spawner/structure/window/shuttle,
/turf/open/floor/plating,
/area/shuttle/escape)
"ad" = (
/obj/structure/table,
/obj/item/scalpel,
/obj/item/retractor{
	pixel_y = 5
	},
/obj/item/hemostat,
/turf/open/floor/plasteel/white,
/area/shuttle/escape)
"ae" = (
/obj/structure/table,
/obj/item/cautery,
/obj/item/surgicaldrill,
/obj/item/circular_saw{
	pixel_y = 9
	},
/turf/open/floor/plasteel/white,
/area/shuttle/escape)
"af" = (
/turf/open/floor/plasteel/white,
/area/shuttle/escape)
"ag" = (
/obj/structure/shuttle/engine/propulsion/right{
	dir = 4
	},
/turf/open/floor/plating/airless,
/area/shuttle/escape)
"ah" = (
/turf/closed/wall/mineral/titanium/nodiagonal,
/area/shuttle/escape)
"ai" = (
/obj/machinery/computer/emergency_shuttle,
/turf/open/floor/mineral/titanium/blue,
/area/shuttle/escape)
"aj" = (
/turf/open/floor/mineral/titanium/blue,
/area/shuttle/escape)
"ak" = (
/obj/item/twohanded/required/kirbyplants{
	icon_state = "plant-22"
	},
/turf/open/floor/mineral/titanium/blue,
/area/shuttle/escape)
"al" = (
/obj/structure/chair/shuttle,
/turf/open/floor/mineral/plastitanium/brig,
/area/shuttle/escape)
"am" = (
/obj/structure/chair/shuttle,
/obj/machinery/light{
	dir = 1
	},
/turf/open/floor/mineral/plastitanium/brig,
/area/shuttle/escape)
"an" = (
/obj/structure/table/optable,
/obj/item/surgical_drapes,
/turf/open/floor/plasteel/white,
/area/shuttle/escape)
"ao" = (
/obj/machinery/light{
	dir = 4
	},
/turf/open/floor/plasteel/white,
/area/shuttle/escape)
"ap" = (
/obj/structure/shuttle/engine/propulsion{
	dir = 4
	},
/turf/open/floor/plating/airless,
/area/shuttle/escape)
"aq" = (
/obj/machinery/computer/communications{
	dir = 4
	},
/turf/open/floor/mineral/titanium/blue,
/area/shuttle/escape)
"ar" = (
/obj/structure/chair/shuttle{
	dir = 8
	},
/turf/open/floor/mineral/titanium/blue,
/area/shuttle/escape)
"as" = (
/obj/machinery/door/airlock/command/glass{
	name = "bridge door";
	req_access_txt = "19"
	},
/turf/open/floor/mineral/titanium/blue,
/area/shuttle/escape)
"at" = (
/turf/open/floor/mineral/plastitanium/brig,
/area/shuttle/escape)
"au" = (
/obj/structure/shuttle/engine/propulsion/left{
	dir = 4
	},
/turf/open/floor/plating/airless,
/area/shuttle/escape)
"av" = (
/obj/machinery/light,
/turf/open/floor/mineral/titanium/blue,
/area/shuttle/escape)
"aw" = (
/obj/structure/extinguisher_cabinet{
	pixel_y = -32
	},
/turf/open/floor/mineral/titanium/blue,
/area/shuttle/escape)
"ax" = (
/obj/structure/table,
/obj/machinery/recharger{
	active_power_usage = 0;
	idle_power_usage = 0;
	pixel_y = 4;
	use_power = 0
	},
/turf/open/floor/mineral/plastitanium/brig,
/area/shuttle/escape)
"ay" = (
/obj/structure/table,
/obj/item/storage/box/handcuffs,
/turf/open/floor/mineral/plastitanium/brig,
/area/shuttle/escape)
"az" = (
/obj/machinery/door/airlock/security/glass{
	name = "security airlock";
	req_access_txt = "63"
	},
/turf/open/floor/mineral/plastitanium/brig,
/area/shuttle/escape)
"aA" = (
/obj/machinery/door/airlock/public/glass,
/turf/open/floor/plasteel/white,
/area/shuttle/escape)
"aB" = (
/obj/item/twohanded/required/kirbyplants{
	icon_state = "plant-21"
	},
/turf/open/floor/mineral/titanium,
/area/shuttle/escape)
"aC" = (
/turf/open/floor/mineral/titanium,
/area/shuttle/escape)
"aD" = (
/turf/open/floor/plasteel/dark,
/area/shuttle/escape)
"aE" = (
/obj/structure/chair/shuttle{
	dir = 4
	},
/turf/open/floor/plasteel/dark,
/area/shuttle/escape)
"aF" = (
/obj/structure/table,
/obj/machinery/light{
	dir = 1
	},
/turf/open/floor/plasteel/dark,
/area/shuttle/escape)
"aG" = (
/obj/machinery/door/airlock/titanium,
/turf/open/floor/mineral/titanium,
/area/shuttle/escape)
"aH" = (
/obj/structure/chair/shuttle{
	dir = 8
	},
/turf/open/floor/plasteel/dark,
/area/shuttle/escape)
"aI" = (
/obj/structure/table,
/obj/item/reagent_containers/food/snacks/boiledspaghetti{
	name = "pasghetti";
	pixel_x = 4;
	pixel_y = 7
	},
/turf/open/floor/plasteel/dark,
/area/shuttle/escape)
"aJ" = (
/obj/machinery/light/small,
/turf/open/floor/mineral/titanium,
/area/shuttle/escape)
"aK" = (
/obj/machinery/door/airlock/titanium,
/obj/docking_port/mobile/emergency{
	dheight = 0;
	dir = 8;
	dwidth = 6;
	height = 18;
	port_direction = 4;
	width = 14;
	name = "Birdboat emergency escape shuttle"
	},
/turf/open/floor/mineral/titanium,
/area/shuttle/escape)
"aL" = (
/obj/structure/table,
/turf/open/floor/plasteel/dark,
/area/shuttle/escape)
"aM" = (
/obj/structure/table,
/obj/item/reagent_containers/food/snacks/chocolatebar,
/turf/open/floor/plasteel/dark,
/area/shuttle/escape)
"aN" = (
/obj/structure/chair/shuttle{
	dir = 1
	},
/obj/structure/window/reinforced,
/turf/open/floor/plasteel/dark,
/area/shuttle/escape)
"aO" = (
/obj/structure/chair/shuttle{
	dir = 1
	},
/obj/structure/window/reinforced,
/obj/machinery/light{
	dir = 4
	},
/turf/open/floor/plasteel/dark,
/area/shuttle/escape)
"aP" = (
/obj/structure/chair/shuttle,
/obj/structure/window/reinforced{
	dir = 1;
	pixel_y = 2
	},
/turf/open/floor/plasteel/dark,
/area/shuttle/escape)
"aQ" = (
/obj/structure/extinguisher_cabinet{
	pixel_x = -27
	},
/turf/open/floor/plasteel/white,
/area/shuttle/escape)
"aR" = (
/obj/structure/table/glass,
/obj/item/storage/firstaid/fire{
	pixel_x = 5;
	pixel_y = 5
	},
/obj/item/storage/firstaid/toxin,
/turf/open/floor/plasteel/white,
/area/shuttle/escape)
"aS" = (
/obj/structure/chair/shuttle{
	dir = 1
	},
/turf/open/floor/plasteel/dark,
/area/shuttle/escape)
"aT" = (
/obj/structure/chair/shuttle{
	dir = 1
	},
/obj/machinery/light,
/turf/open/floor/plasteel/dark,
/area/shuttle/escape)
"aU" = (
/obj/structure/table/glass,
/obj/item/storage/firstaid/brute{
	pixel_x = 5;
	pixel_y = 5
	},
/obj/item/storage/firstaid/brute,
/obj/machinery/light{
	dir = 4
	},
/turf/open/floor/plasteel/white,
/area/shuttle/escape)
"aV" = (
/obj/structure/extinguisher_cabinet{
	pixel_y = -32
	},
/turf/open/floor/mineral/titanium,
/area/shuttle/escape)
"aW" = (
/obj/structure/chair/shuttle,
/turf/open/floor/plasteel/dark,
/area/shuttle/escape)
"aX" = (
/obj/machinery/sleeper{
	dir = 1
	},
/turf/open/floor/plasteel/white,
/area/shuttle/escape)
"aY" = (
/obj/structure/table/glass,
/obj/item/defibrillator/loaded,
/turf/open/floor/plasteel/white,
/area/shuttle/escape)

(1,1,1) = {"
aa
aa
ab
ab
ac
ab
ac
ac
ac
ac
ac
ab
aa
aa
"}
(2,1,1) = {"
aa
ab
ah
aq
ak
ac
aB
aH
aH
aH
aB
ah
ab
aa
"}
(3,1,1) = {"
aa
ab
ai
ar
aj
as
aC
aC
aC
aC
aC
aS
ab
aa
"}
(4,1,1) = {"
aa
ac
aj
aj
av
ab
aD
aD
aL
aC
aC
aS
ab
aa
"}
(5,1,1) = {"
aa
ac
aj
aj
aw
ab
aE
aE
aM
aC
aC
aS
ab
aa
"}
(6,1,1) = {"
aa
ab
ak
aj
ak
ab
aF
aI
aL
aC
aC
aT
ah
ab
"}
(7,1,1) = {"
aa
ab
ab
as
ac
ab
aC
aC
aC
aC
aC
aC
aB
ab
"}
(8,1,1) = {"
aa
ab
al
at
at
ac
aB
aC
aC
aC
aC
aC
aV
ab
"}
(9,1,1) = {"
aa
ab
al
at
at
az
aC
aC
aN
aP
aC
aC
aW
ac
"}
(10,1,1) = {"
aa
ab
am
at
at
ac
aC
aC
aN
aP
aC
aC
aW
ac
"}
(11,1,1) = {"
aa
ab
al
at
ax
ab
aC
aC
aN
aP
aC
aC
aW
ac
"}
(12,1,1) = {"
aa
ab
al
at
ay
ab
aC
aC
aO
aP
aC
aC
aB
ab
"}
(13,1,1) = {"
ab
ab
ab
ab
ab
ah
aC
aC
ah
ab
aA
ac
ab
ab
"}
(14,1,1) = {"
ab
ad
an
af
af
aA
aC
aC
aA
aQ
af
af
aX
ab
"}
(15,1,1) = {"
ab
ae
af
af
af
aA
aC
aC
aA
af
af
af
af
ab
"}
(16,1,1) = {"
ab
af
ao
af
ab
ab
aG
aG
ab
ab
aR
aU
aY
ab
"}
(17,1,1) = {"
ab
ab
ab
ab
ab
ab
aC
aJ
ab
ab
ab
ab
ab
ab
"}
(18,1,1) = {"
ab
ag
ap
au
ab
ab
aG
aK
ab
ab
ag
ap
au
ab
"}
