"aa" = (/turf/open/space,/area/space)
"ab" = (/turf/closed/wall/mineral/titanium,/area/shuttle/escape)
"ac" = (/obj/structure/shuttle/engine/propulsion{dir = 1},/turf/open/floor/plating/airless,/area/shuttle/escape)
"ad" = (/obj/structure/window/reinforced,/obj/structure/shuttle/engine/heater{dir = 1},/turf/open/floor/plating/airless,/area/shuttle/escape)
"ae" = (/obj/structure/window/shuttle,/obj/structure/grille,/turf/open/floor/plating,/area/shuttle/escape)
"af" = (/obj/structure/table,/obj/item/weapon/storage/firstaid/regular,/turf/open/floor/mineral/titanium,/area/shuttle/escape)
"ag" = (/obj/machinery/computer/shuttle,/turf/open/floor/mineral/titanium,/area/shuttle/escape)
"ah" = (/obj/structure/table,/obj/machinery/recharger,/obj/structure/extinguisher_cabinet{pixel_x = 26},/turf/open/floor/mineral/titanium,/area/shuttle/escape)
"ai" = (/turf/open/floor/mineral/titanium/blue,/area/shuttle/escape)
"aj" = (/obj/structure/chair/comfy/black{dir = 1},/turf/open/floor/mineral/titanium/blue,/area/shuttle/escape)
"ak" = (/obj/machinery/door/airlock/shuttle,/turf/open/floor/mineral/titanium/blue,/area/shuttle/escape)
"al" = (/obj/structure/table,/obj/item/weapon/cigbutt/cigarbutt,/obj/item/weapon/phone,/obj/item/weapon/cigbutt/cigarbutt,/turf/open/floor/mineral/titanium/blue,/area/shuttle/escape)
"am" = (/obj/structure/closet,/turf/open/floor/mineral/titanium/yellow,/area/shuttle/escape)
"an" = (/obj/machinery/recharge_station,/turf/open/floor/mineral/titanium/yellow,/area/shuttle/escape)
"ao" = (/obj/machinery/vending/cola,/turf/open/floor/mineral/titanium/yellow,/area/shuttle/escape)
"ap" = (/obj/machinery/computer/atmos_alert,/turf/open/floor/mineral/titanium/blue,/area/shuttle/escape)
"aq" = (/obj/structure/chair{dir = 8},/turf/open/floor/mineral/titanium/blue,/area/shuttle/escape)
"ar" = (/obj/structure/chair{dir = 4},/turf/open/floor/mineral/titanium/blue,/area/shuttle/escape)
"as" = (/obj/machinery/computer/security,/turf/open/floor/mineral/titanium/blue,/area/shuttle/escape)
"at" = (/obj/structure/chair,/turf/open/floor/mineral/plastitanium/brig,/area/shuttle/escape)
"au" = (/obj/structure/chair,/turf/open/floor/mineral/titanium,/area/shuttle/escape)
"av" = (/obj/structure/closet/crate,/turf/open/floor/mineral/titanium,/area/shuttle/escape)
"aw" = (/obj/structure/shuttle/engine/propulsion{dir = 4},/turf/open/floor/plating/airless,/area/shuttle/escape)
"ax" = (/obj/structure/window/reinforced{dir = 4},/obj/structure/shuttle/engine/heater{dir = 8},/turf/open/floor/plating/airless,/area/shuttle/escape)
"ay" = (/obj/structure/table,/obj/item/weapon/storage/fancy/donut_box,/turf/open/floor/mineral/titanium/blue,/area/shuttle/escape)
"az" = (/turf/open/floor/mineral/titanium/yellow,/area/shuttle/escape)
"aA" = (/obj/structure/extinguisher_cabinet{pixel_x = 26},/turf/open/floor/mineral/titanium/yellow,/area/shuttle/escape)
"aB" = (/obj/machinery/computer/crew,/turf/open/floor/mineral/titanium/blue,/area/shuttle/escape)
"aC" = (/obj/machinery/computer/communications,/turf/open/floor/mineral/titanium/blue,/area/shuttle/escape)
"aD" = (/obj/machinery/button/flasher{id = "Shuttle_Flasher"; pixel_x = -24; pixel_y = -6},/obj/machinery/flasher{id = "Shuttle_Flasher"; pixel_x = -24; pixel_y = 6},/turf/open/floor/mineral/plastitanium/brig,/area/shuttle/escape)
"aE" = (/turf/open/floor/mineral/plastitanium/brig,/area/shuttle/escape)
"aF" = (/obj/structure/tank_dispenser/oxygen,/turf/open/floor/mineral/titanium,/area/shuttle/escape)
"aG" = (/obj/structure/chair/office/dark,/turf/open/floor/mineral/titanium/blue,/area/shuttle/escape)
"aH" = (/obj/machinery/door/airlock/shuttle{req_access_txt = "19"},/turf/open/floor/mineral/titanium/blue,/area/shuttle/escape)
"aI" = (/obj/structure/reagent_dispensers/fueltank,/turf/open/floor/mineral/titanium/yellow,/area/shuttle/escape)
"aJ" = (/obj/structure/sign/nanotrasen,/turf/closed/wall/mineral/titanium,/area/shuttle/escape)
"aK" = (/obj/machinery/door/airlock/glass{name = "Emergency Shuttle Cockpit"; req_access_txt = "19"},/turf/open/floor/mineral/titanium/blue,/area/shuttle/escape)
"aL" = (/obj/structure/chair{dir = 1},/turf/open/floor/mineral/plastitanium/brig,/area/shuttle/escape)
"aM" = (/obj/machinery/door/airlock/shuttle{name = "Emergency Shuttle Airlock"; req_access_txt = "2"},/turf/open/floor/mineral/titanium/blue,/area/shuttle/escape)
"aN" = (/obj/structure/chair{dir = 1},/turf/open/floor/mineral/titanium,/area/shuttle/escape)
"aO" = (/obj/machinery/computer/shuttle,/turf/open/floor/mineral/titanium/blue,/area/shuttle/escape)
"aP" = (/obj/structure/chair/office/dark{dir = 8},/turf/open/floor/mineral/titanium/blue,/area/shuttle/escape)
"aQ" = (/obj/machinery/door/airlock/glass,/turf/open/floor/mineral/titanium/blue,/area/shuttle/escape)
"aR" = (/obj/item/weapon/twohanded/required/kirbyplants{icon_state = "plant-22"},/turf/open/floor/mineral/titanium/blue,/area/shuttle/escape)
"aS" = (/obj/structure/window/shuttle,/obj/structure/grille,/turf/open/floor/mineral/titanium/blue,/area/shuttle/escape)
"aT" = (/obj/machinery/door/airlock/glass{name = "Emergency Shuttle Brig"; req_access_txt = "2"},/turf/open/floor/mineral/titanium/blue,/area/shuttle/escape)
"aU" = (/turf/open/floor/mineral/titanium,/area/shuttle/escape)
"aV" = (/obj/structure/chair/office/dark{dir = 1},/turf/open/floor/mineral/titanium/blue,/area/shuttle/escape)
"aW" = (/obj/machinery/status_display{pixel_x = 32},/turf/open/floor/mineral/titanium,/area/shuttle/escape)
"aX" = (/obj/machinery/door/airlock/shuttle,/obj/docking_port/mobile/emergency{dheight = 0; dir = 8; dwidth = 11; height = 25; name = "Bluespace Catastrophe"; timid = 1; width = 21},/turf/open/floor/mineral/titanium/blue,/area/shuttle/escape)
"aY" = (/obj/structure/table,/obj/item/weapon/storage/toolbox/emergency,/turf/open/floor/mineral/titanium/blue,/area/shuttle/escape)
"aZ" = (/obj/structure/chair{dir = 4},/turf/open/floor/mineral/titanium,/area/shuttle/escape)
"ba" = (/obj/structure/window/reinforced{dir = 4},/obj/structure/chair{dir = 8},/turf/open/floor/mineral/titanium,/area/shuttle/escape)
"bb" = (/obj/structure/window/reinforced{dir = 8},/obj/structure/chair{dir = 4},/turf/open/floor/mineral/titanium,/area/shuttle/escape)
"bc" = (/turf/open/floor/carpet,/area/shuttle/escape)
"bd" = (/obj/structure/chair/comfy/beige,/turf/open/floor/carpet,/area/shuttle/escape)
"be" = (/obj/structure/window/reinforced{dir = 4},/turf/open/floor/mineral/titanium,/area/shuttle/escape)
"bf" = (/obj/structure/chair{dir = 8},/turf/open/floor/mineral/titanium,/area/shuttle/escape)
"bg" = (/obj/machinery/holopad,/turf/open/floor/mineral/titanium/blue,/area/shuttle/escape)
"bh" = (/obj/structure/table,/obj/machinery/recharger,/turf/open/floor/mineral/titanium/blue,/area/shuttle/escape)
"bi" = (/obj/structure/table,/obj/item/weapon/paper_bin,/obj/item/device/radio/intercom{name = "Station Intercom (General)"; pixel_x = 0; pixel_y = -29},/turf/open/floor/mineral/titanium/blue,/area/shuttle/escape)
"bj" = (/obj/structure/chair/comfy/beige{dir = 4},/turf/open/floor/carpet,/area/shuttle/escape)
"bk" = (/obj/structure/table/wood/poker,/obj/item/toy/cards/deck,/turf/open/floor/carpet,/area/shuttle/escape)
"bl" = (/obj/structure/chair/comfy/beige{dir = 8},/turf/open/floor/carpet,/area/shuttle/escape)
"bm" = (/obj/structure/table,/turf/open/floor/mineral/titanium,/area/shuttle/escape)
"bn" = (/obj/structure/chair/comfy/beige{dir = 1},/turf/open/floor/carpet,/area/shuttle/escape)
"bo" = (/obj/machinery/door/airlock/shuttle,/turf/open/floor/plasteel,/area/shuttle/escape)
"bp" = (/obj/structure/sign/nosmoking_2,/turf/closed/wall/mineral/titanium,/area/shuttle/escape)
"bq" = (/obj/structure/chair{dir = 4},/obj/structure/extinguisher_cabinet{dir = 4; pixel_x = 0; pixel_y = 29},/turf/open/floor/plasteel,/area/shuttle/escape)
"br" = (/turf/open/floor/plasteel,/area/shuttle/escape)
"bs" = (/obj/structure/reagent_dispensers/fueltank,/turf/open/floor/plasteel,/area/shuttle/escape)
"bt" = (/obj/machinery/recharge_station,/turf/open/floor/plasteel,/area/shuttle/escape)
"bu" = (/obj/structure/chair{dir = 4},/turf/open/floor/plasteel,/area/shuttle/escape)
"bv" = (/obj/item/weapon/cigbutt,/turf/open/floor/plasteel,/area/shuttle/escape)
"bw" = (/obj/machinery/sleeper{dir = 4; icon_state = "sleeper-open"},/turf/open/floor/mineral/titanium,/area/shuttle/escape)
"bx" = (/obj/machinery/vending/medical,/turf/open/floor/mineral/titanium,/area/shuttle/escape)
"by" = (/obj/structure/reagent_dispensers/watertank,/turf/open/floor/plasteel,/area/shuttle/escape)
"bz" = (/obj/structure/table,/obj/item/weapon/storage/firstaid/fire,/obj/item/weapon/storage/firstaid/regular,/obj/item/weapon/crowbar,/turf/open/floor/mineral/titanium,/area/shuttle/escape)
"bA" = (/obj/structure/closet/crate,/turf/open/floor/plasteel,/area/shuttle/escape)
"bB" = (/obj/structure/closet/crate/medical,/turf/open/floor/plasteel,/area/shuttle/escape)
"bC" = (/obj/machinery/portable_atmospherics/canister/oxygen,/obj/item/device/radio/intercom{name = "Station Intercom (General)"; pixel_x = 0; pixel_y = -29},/turf/open/floor/plasteel,/area/shuttle/escape)
"bD" = (/obj/structure/table,/obj/item/weapon/clipboard,/obj/item/weapon/folder/yellow,/turf/open/floor/plasteel,/area/shuttle/escape)
"bE" = (/obj/structure/window/shuttle/tinted,/obj/structure/grille,/turf/open/floor/plating,/area/shuttle/escape)
"bF" = (/obj/machinery/door/airlock/external,/turf/open/floor/plasteel,/area/shuttle/escape)
"bG" = (/obj/structure/window/reinforced{dir = 1},/obj/structure/shuttle/engine/heater,/turf/open/floor/plating/airless,/area/shuttle/escape)
"bH" = (/obj/structure/table,/obj/item/weapon/defibrillator,/turf/open/floor/mineral/titanium,/area/shuttle/escape)
"bI" = (/obj/structure/window/shuttle,/obj/structure/grille,/turf/open/floor/plasteel,/area/shuttle/escape)
"bJ" = (/obj/structure/shuttle/engine/propulsion,/turf/open/floor/plating/airless,/area/shuttle/escape)
"bK" = (/obj/structure/window/shuttle,/obj/structure/grille,/turf/open/floor/plating/airless,/area/shuttle/escape)

(1,1,1) = {"
aaaaaaaaaaaaaaaaaaabacacacacacabaaaaaaaaaaaaaaaaaa
aaaaaaaaaaaaaaaaababadadadadadababaaaaaaaaaaaaaaaa
aaaaaaaaaaaaaaaaaaaaabaeaeaeabaaaaaaaaaaaaaaaaaaaa
aaaaaaaaaaaaaaaaaaaaabafagahabaaaaaaaaaaaaaaaaaaaa
aaaaabaeaeababababababaiajaiababababababaeakababab
aaababalaiaeamanaoabapaqaiarasabatatataeauaiaiavab
awaxabayaiaeazazaAabaBaqaiaraCabaDaEaEaeaiaiaiaFae
awaxabaCaGaHazazaIabaJaeaKaeaJabaLaEaEaMaNaiaiavab
awaxabaOaPabaeaQaeabaRaiaiaiaRabaSaTaSabaUaiaiaiae
abababapaVabaUaiaiaiaiaiaiaiaiaiaiaiaWabauaiaiaiaX
awaxabaYaiaeaZaibabbaibcbdbcaibebbaibfaebgaiaiaiae
awaxabbhbiaeaZaibabbaibjbkblaibebbaibfaeaNaiaibmab
ababababababaZaibabbaibcbnbcaibebbaibfababbobobpab
awaxabbqbrboaUaiaiaiaiaiaiaiaiaiaiaiaUbobsbrbrbtab
awaxabbubrabaZaiaiababaeaQaeababaiaibfabbvbrbrbrae
awaxabbubrboaUaibfabbwaUaUaUbxabaZaiaUbobvbrbrbrae
aaababbybrabaZaibfabaUaUaUaZbzbpaZaibfabbAbBbCbDab
aaaaabbEbFabbGbGbGabbwaUaUaZbHabbGbGbGabbIbIababab
aaaaaaaaaaabbJbJbJabbGbGbGbGbGabbJbJbJabaaaaaaaaaa
aaaaaaaaaaaaaaaaaaabbJbJbJbJbJabaaaaaaaaaaaaaaaaaa
aaaaaaaaaaaaaaaaaaabbKbKbKbKbKabaaaaaaaaaaaaaaaaaa
"}
