//MAP CONVERTED BY dmm2tgm.py THIS HEADER COMMENT PREVENTS RECONVERSION, DO NOT REMOVE
"aa" = (
/turf/template_noop,
/area/template_noop)
"ab" = (
/turf/closed/wall/mineral/plastitanium,
/area/shuttle/escape)
"ac" = (
/obj/structure/grille,
/obj/effect/spawner/structure/window/plastitanium,
/turf/open/floor/plating,
/area/shuttle/escape)
"ad" = (
/obj/machinery/porta_turret/centcom_shuttle,
/turf/closed/wall/mineral/plastitanium,
/area/shuttle/escape)
"ae" = (
/obj/machinery/computer/aifixer,
/obj/machinery/light{
	dir = 1
	},
/turf/open/floor/carpet/black,
/area/shuttle/escape)
"af" = (
/obj/machinery/computer/crew,
/turf/open/floor/carpet/black,
/area/shuttle/escape)
"ag" = (
/obj/machinery/computer/robotics,
/turf/open/floor/carpet/black,
/area/shuttle/escape)
"ah" = (
/obj/machinery/computer/communications,
/turf/open/floor/carpet/black,
/area/shuttle/escape)
"ai" = (
/obj/machinery/computer/emergency_shuttle,
/turf/open/floor/carpet/black,
/area/shuttle/escape)
"aj" = (
/obj/machinery/computer/secure_data,
/turf/open/floor/carpet/black,
/area/shuttle/escape)
"ak" = (
/obj/machinery/computer/card,
/turf/open/floor/carpet/black,
/area/shuttle/escape)
"al" = (
/obj/machinery/computer/atmos_alert,
/obj/machinery/light{
	dir = 1
	},
/turf/open/floor/carpet/black,
/area/shuttle/escape)
"am" = (
/obj/structure/extinguisher_cabinet,
/turf/closed/wall/mineral/plastitanium,
/area/shuttle/escape)
"an" = (
/turf/open/floor/carpet/black,
/area/shuttle/escape)
"ao" = (
/obj/structure/table,
/obj/item/reagent_containers/glass/beaker/cryoxadone,
/obj/item/reagent_containers/glass/beaker/cryoxadone,
/obj/item/wrench,
/obj/structure/window/spawner,
/turf/open/floor/mineral/titanium/blue,
/area/shuttle/escape)
"aq" = (
/turf/open/floor/mineral/titanium/white,
/area/shuttle/escape)
"ar" = (
/obj/structure/table,
/obj/machinery/recharger,
/turf/open/floor/mineral/plastitanium/red/brig,
/area/shuttle/escape)
"as" = (
/turf/open/floor/mineral/plastitanium/red/brig,
/area/shuttle/escape)
"at" = (
/obj/machinery/door/airlock/security/glass{
	name = "Centcom Flagship Brig";
	req_access_txt = "2";
	req_one_access_txt = "0"
	},
/turf/open/floor/mineral/plastitanium,
/area/shuttle/escape)
"av" = (
/obj/structure/chair/comfy/shuttle{
	dir = 4
	},
/turf/open/floor/mineral/plastitanium/red/brig,
/area/shuttle/escape)
"aw" = (
/obj/machinery/light,
/turf/open/floor/carpet/black,
/area/shuttle/escape)
"ax" = (
/obj/structure/chair{
	dir = 8
	},
/turf/open/floor/mineral/plastitanium/red/brig,
/area/shuttle/escape)
"ay" = (
/turf/closed/wall/mineral/plastitanium/nodiagonal,
/area/shuttle/escape)
"az" = (
/obj/structure/extinguisher_cabinet,
/turf/closed/wall/mineral/plastitanium/nodiagonal,
/area/shuttle/escape)
"aA" = (
/obj/machinery/sleeper,
/turf/open/floor/mineral/titanium/blue,
/area/shuttle/escape)
"aB" = (
/obj/machinery/atmospherics/components/unary/portables_connector/visible,
/obj/machinery/portable_atmospherics/canister/oxygen,
/turf/open/floor/mineral/titanium/blue,
/area/shuttle/escape)
"aC" = (
/obj/machinery/atmospherics/components/unary/thermomachine/freezer,
/turf/open/floor/mineral/titanium/blue,
/area/shuttle/escape)
"aD" = (
/obj/machinery/atmospherics/components/unary/cryo_cell,
/turf/open/floor/mineral/titanium/blue,
/area/shuttle/escape)
"aF" = (
/turf/open/floor/mineral/titanium/blue,
/area/shuttle/escape)
"aG" = (
/obj/machinery/atmospherics/pipe/simple/purple/visible{
	dir = 5
	},
/turf/open/floor/mineral/titanium/blue,
/area/shuttle/escape)
"aH" = (
/obj/machinery/atmospherics/pipe/manifold/purple/visible,
/turf/open/floor/mineral/titanium/blue,
/area/shuttle/escape)
"aI" = (
/obj/machinery/atmospherics/pipe/simple/purple/visible{
	dir = 9
	},
/turf/open/floor/mineral/titanium/blue,
/area/shuttle/escape)
"aJ" = (
/obj/item/reagent_containers/glass/beaker/large,
/obj/item/reagent_containers/glass/beaker/large,
/obj/item/reagent_containers/glass/beaker/large,
/obj/item/reagent_containers/glass/beaker/large,
/obj/structure/table,
/obj/item/retractor/advanced,
/obj/item/scalpel/advanced,
/obj/item/surgicaldrill/advanced,
/obj/item/surgical_drapes,
/obj/structure/window/spawner,
/turf/open/floor/mineral/titanium/blue,
/area/shuttle/escape)
"aK" = (
/obj/structure/table/reinforced,
/obj/item/assembly/flash,
/obj/item/laser_pointer,
/obj/structure/window/spawner,
/turf/open/floor/carpet/black,
/area/shuttle/escape)
"aL" = (
/obj/docking_port/mobile/emergency{
	name = "Flagship emergency"
	},
/obj/structure/fans/tiny,
/obj/machinery/door/airlock/hatch,
/turf/open/floor/mineral/plastitanium,
/area/shuttle/escape)
"aM" = (
/turf/open/floor/plating,
/area/shuttle/escape)
"aN" = (
/obj/machinery/door/airlock/hatch,
/obj/structure/fans/tiny,
/turf/open/floor/mineral/plastitanium,
/area/shuttle/escape)
"aO" = (
/obj/machinery/suit_storage_unit/standard_unit,
/obj/machinery/light{
	dir = 8
	},
/turf/open/floor/mineral/plastitanium,
/area/shuttle/escape)
"aP" = (
/obj/machinery/smartfridge/chemistry/preloaded,
/turf/closed/wall/mineral/plastitanium,
/area/shuttle/escape)
"aQ" = (
/obj/machinery/chem_master,
/turf/open/floor/mineral/titanium/blue,
/area/shuttle/escape)
"aR" = (
/obj/machinery/chem_heater,
/turf/open/floor/mineral/titanium/blue,
/area/shuttle/escape)
"aS" = (
/obj/machinery/chem_dispenser,
/turf/open/floor/mineral/titanium/blue,
/area/shuttle/escape)
"aT" = (
/obj/machinery/door/airlock/medical/glass{
	id_tag = "MedbayFoyer";
	name = "Centcom Flagship Medbay";
	req_access_txt = "5"
	},
/turf/open/floor/mineral/plastitanium,
/area/shuttle/escape)
"aU" = (
/obj/machinery/door/airlock/grunge,
/obj/structure/fans/tiny,
/turf/open/floor/mineral/plastitanium,
/area/shuttle/escape)
"aV" = (
/obj/structure/table/reinforced,
/turf/open/floor/wood,
/area/shuttle/escape)
"aW" = (
/obj/structure/tank_dispenser/oxygen,
/turf/open/floor/mineral/plastitanium,
/area/shuttle/escape)
"aX" = (
/turf/open/floor/wood,
/area/shuttle/escape)
"aY" = (
/obj/machinery/door/airlock/engineering/glass{
	name = "Centcom Flagship Engineering Room";
	req_one_access_txt = "32;19"
	},
/turf/open/floor/mineral/plastitanium,
/area/shuttle/escape)
"aZ" = (
/turf/open/floor/mineral/titanium/yellow,
/area/shuttle/escape)
"ba" = (
/obj/machinery/telecomms/bus/preset_one,
/turf/open/floor/circuit/green/telecomms,
/area/shuttle/escape)
"bc" = (
/obj/machinery/telecomms/hub/preset,
/turf/open/floor/circuit/green/telecomms,
/area/shuttle/escape)
"bd" = (
/obj/machinery/telecomms/broadcaster/preset_right,
/turf/open/floor/circuit/green/telecomms,
/area/shuttle/escape)
"bf" = (
/obj/machinery/shieldgen,
/turf/open/floor/mineral/titanium/yellow,
/area/shuttle/escape)
"bg" = (
/turf/open/floor/plasteel/dark/telecomms,
/area/shuttle/escape)
"bh" = (
/obj/machinery/telecomms/server/presets/command,
/turf/open/floor/circuit/green/telecomms,
/area/shuttle/escape)
"bm" = (
/obj/machinery/telecomms/server/presets/common,
/turf/open/floor/circuit/green/telecomms,
/area/shuttle/escape)
"bo" = (
/obj/machinery/telecomms/bus/preset_two,
/turf/open/floor/circuit/green/telecomms,
/area/shuttle/escape)
"bp" = (
/obj/machinery/telecomms/processor/preset_one,
/turf/open/floor/circuit/green/telecomms,
/area/shuttle/escape)
"bq" = (
/obj/machinery/telecomms/processor/preset_two,
/turf/open/floor/circuit/green/telecomms,
/area/shuttle/escape)
"br" = (
/obj/structure/table/reinforced,
/obj/machinery/light{
	dir = 4
	},
/turf/open/floor/wood,
/area/shuttle/escape)
"bs" = (
/obj/structure/fans/tiny,
/obj/machinery/door/airlock/hatch{
	name = "Centcom Communication Server Room"
	},
/turf/open/floor/mineral/plastitanium,
/area/shuttle/escape)
"bw" = (
/obj/machinery/telecomms/server/presets/security,
/turf/open/floor/circuit/green/telecomms,
/area/shuttle/escape)
"by" = (
/obj/machinery/suit_storage_unit/engine,
/turf/open/floor/mineral/plastitanium,
/area/shuttle/escape)
"bz" = (
/obj/machinery/suit_storage_unit/atmos,
/turf/open/floor/mineral/plastitanium,
/area/shuttle/escape)
"bB" = (
/obj/machinery/suit_storage_unit/engine,
/obj/machinery/suit_storage_unit/engine,
/turf/open/floor/mineral/plastitanium,
/area/shuttle/escape)
"bD" = (
/obj/machinery/portable_atmospherics/canister/air,
/turf/open/floor/mineral/plastitanium,
/area/shuttle/escape)
"bF" = (
/obj/structure/reagent_dispensers/watertank/high,
/turf/open/floor/mineral/plastitanium,
/area/shuttle/escape)
"bG" = (
/obj/structure/reagent_dispensers/fueltank,
/turf/open/floor/mineral/plastitanium,
/area/shuttle/escape)
"bK" = (
/obj/structure/shuttle/engine/heater,
/obj/structure/window/reinforced{
	dir = 1;
	pixel_y = 2
	},
/turf/open/floor/plating,
/area/shuttle/escape)
"bM" = (
/obj/structure/shuttle/engine/propulsion,
/turf/open/floor/plating,
/area/shuttle/escape)
"bN" = (
/obj/machinery/smartfridge/food,
/turf/open/floor/wood,
/area/shuttle/escape)
"bP" = (
/obj/machinery/turretid{
	control_area = /area/shuttle/escape;
	icon_state = "control_kill";
	lethal = 1;
	pixel_y = 28
	},
/obj/item/radio/intercom{
	pixel_x = -28
	},
/turf/open/floor/carpet/black,
/area/shuttle/escape)
"bR" = (
/obj/machinery/light,
/turf/open/floor/mineral/titanium/white,
/area/shuttle/escape)
"bS" = (
/obj/machinery/light{
	dir = 8
	},
/obj/structure/chair/comfy/shuttle{
	dir = 4
	},
/turf/open/floor/mineral/titanium/white,
/area/shuttle/escape)
"bV" = (
/obj/machinery/vending/wardrobe/bar_wardrobe,
/turf/open/floor/wood,
/area/shuttle/escape)
"bW" = (
/obj/machinery/light{
	dir = 1
	},
/turf/open/floor/mineral/plastitanium,
/area/shuttle/escape)
"bX" = (
/obj/machinery/vending/boozeomat/all_access,
/turf/open/floor/wood,
/area/shuttle/escape)
"bY" = (
/obj/machinery/vending/snack/random,
/turf/open/floor/mineral/titanium/white,
/area/shuttle/escape)
"bZ" = (
/obj/machinery/vending/wallmed,
/turf/closed/wall/mineral/plastitanium,
/area/shuttle/escape)
"cb" = (
/obj/machinery/vending/medical,
/turf/open/floor/mineral/titanium/blue,
/area/shuttle/escape)
"cc" = (
/obj/machinery/vending/wardrobe/atmos_wardrobe,
/turf/open/floor/mineral/titanium/yellow,
/area/shuttle/escape)
"cd" = (
/obj/machinery/vending/wardrobe/engi_wardrobe,
/turf/open/floor/mineral/titanium/yellow,
/area/shuttle/escape)
"ch" = (
/obj/machinery/door/window/westright{
	name = "Bar Door";
	req_access = "0";
	req_one_access = "25, 28"
	},
/turf/open/floor/wood,
/area/shuttle/escape)
"ci" = (
/obj/machinery/shieldgen,
/obj/machinery/light{
	dir = 8
	},
/turf/open/floor/mineral/titanium/yellow,
/area/shuttle/escape)
"cj" = (
/obj/machinery/light{
	dir = 8
	},
/obj/machinery/telecomms/receiver/preset_right,
/turf/open/floor/circuit/green/telecomms,
/area/shuttle/escape)
"ck" = (
/obj/machinery/light{
	dir = 4
	},
/turf/open/floor/circuit/green/telecomms,
/area/shuttle/escape)
"cl" = (
/obj/machinery/light,
/obj/machinery/portable_atmospherics/canister/air,
/turf/open/floor/mineral/plastitanium,
/area/shuttle/escape)
"cn" = (
/obj/machinery/light{
	dir = 1
	},
/turf/open/floor/mineral/plastitanium/red/brig,
/area/shuttle/escape)
"co" = (
/obj/machinery/light{
	dir = 4
	},
/turf/open/floor/mineral/titanium/white,
/area/shuttle/escape)
"cp" = (
/obj/structure/window/reinforced/spawner,
/obj/structure/chair{
	dir = 8
	},
/obj/machinery/light{
	dir = 4
	},
/turf/open/floor/mineral/plastitanium/red/brig,
/area/shuttle/escape)
"cq" = (
/obj/structure/chair/comfy/shuttle{
	dir = 4
	},
/turf/open/floor/mineral/titanium/white,
/area/shuttle/escape)
"cr" = (
/obj/machinery/light{
	dir = 1
	},
/turf/open/floor/mineral/titanium/white,
/area/shuttle/escape)
"cs" = (
/obj/machinery/modular_computer/console/preset/command{
	dir = 8
	},
/turf/open/floor/carpet/black,
/area/shuttle/escape)
"ct" = (
/obj/structure/AIcore/deactivated,
/turf/open/floor/carpet/black,
/area/shuttle/escape)
"cu" = (
/obj/machinery/modular_computer/console/preset/research{
	dir = 8
	},
/turf/open/floor/carpet/black,
/area/shuttle/escape)
"cv" = (
/obj/structure/chair/comfy/shuttle{
	dir = 4
	},
/obj/item/radio/intercom{
	pixel_x = -28
	},
/turf/open/floor/mineral/plastitanium/red/brig,
/area/shuttle/escape)
"cw" = (
/obj/machinery/light{
	dir = 1
	},
/obj/machinery/space_heater,
/turf/open/floor/mineral/titanium/yellow,
/area/shuttle/escape)
"cx" = (
/obj/machinery/space_heater,
/turf/open/floor/mineral/titanium/yellow,
/area/shuttle/escape)
"cy" = (
/obj/machinery/shower,
/turf/open/floor/mineral/titanium/yellow,
/area/shuttle/escape)
"cA" = (
/obj/machinery/recharger,
/obj/structure/table/reinforced,
/turf/open/floor/carpet/black,
/area/shuttle/escape)
"cD" = (
/obj/structure/table/reinforced,
/turf/open/floor/carpet/black,
/area/shuttle/escape)
"cE" = (
/obj/structure/table/optable,
/turf/open/floor/mineral/titanium/blue,
/area/shuttle/escape)
"cG" = (
/obj/machinery/vending/engivend,
/turf/open/floor/mineral/titanium/yellow,
/area/shuttle/escape)
"cH" = (
/obj/machinery/vending/tool,
/turf/open/floor/mineral/titanium/yellow,
/area/shuttle/escape)
"cI" = (
/obj/structure/table,
/turf/open/floor/wood,
/area/shuttle/escape)
"cJ" = (
/obj/structure/chair/office/dark{
	dir = 1
	},
/turf/open/floor/carpet/black,
/area/shuttle/escape)
"cK" = (
/obj/structure/chair/office/dark{
	dir = 4
	},
/turf/open/floor/carpet/black,
/area/shuttle/escape)
"cL" = (
/obj/structure/chair/office/dark{
	dir = 8
	},
/turf/open/floor/carpet/black,
/area/shuttle/escape)
"cN" = (
/obj/machinery/light,
/obj/structure/chair/comfy/beige{
	dir = 1
	},
/turf/open/floor/carpet/black,
/area/shuttle/escape)
"cO" = (
/obj/effect/turf_decal/caution/stand_clear/red{
	dir = 8
	},
/obj/effect/turf_decal/stripes/line{
	dir = 4
	},
/turf/open/floor/mineral/titanium/white,
/area/shuttle/escape)
"cP" = (
/obj/structure/window/reinforced/spawner,
/obj/structure/chair/comfy/shuttle{
	dir = 1
	},
/turf/open/floor/mineral/titanium/white,
/area/shuttle/escape)
"cQ" = (
/obj/machinery/light{
	dir = 8
	},
/obj/structure/window/reinforced/spawner/north,
/obj/structure/chair/comfy/shuttle,
/turf/open/floor/mineral/titanium/white,
/area/shuttle/escape)
"cS" = (
/obj/structure/chair/comfy/shuttle{
	dir = 1
	},
/turf/open/floor/mineral/titanium/white,
/area/shuttle/escape)
"cT" = (
/obj/structure/chair/stool/bar,
/turf/open/floor/mineral/titanium/white,
/area/shuttle/escape)
"cU" = (
/obj/structure/window/reinforced/spawner/north,
/obj/structure/chair/comfy/shuttle,
/turf/open/floor/mineral/titanium/white,
/area/shuttle/escape)
"cV" = (
/obj/structure/table/reinforced,
/obj/machinery/recharger,
/turf/open/floor/carpet/black,
/area/shuttle/escape)
"cW" = (
/obj/structure/table/reinforced,
/obj/item/aicard,
/obj/structure/window/spawner,
/turf/open/floor/carpet/black,
/area/shuttle/escape)
"cX" = (
/obj/structure/table/reinforced,
/obj/structure/window/spawner,
/turf/open/floor/carpet/black,
/area/shuttle/escape)
"cY" = (
/obj/structure/table/reinforced,
/obj/structure/window/spawner/north,
/turf/open/floor/carpet/black,
/area/shuttle/escape)
"da" = (
/obj/machinery/door/airlock/command/glass{
	name = "Centcom Flagship Bridge";
	req_access = list(16)
	},
/turf/open/floor/mineral/plastitanium,
/area/shuttle/escape)
"db" = (
/obj/machinery/shower,
/obj/item/radio/intercom{
	pixel_y = 28
	},
/turf/open/floor/mineral/titanium/yellow,
/area/shuttle/escape)
"dc" = (
/obj/item/radio/intercom{
	pixel_y = 28
	},
/turf/open/floor/mineral/plastitanium,
/area/shuttle/escape)
"dd" = (
/obj/item/radio/intercom{
	pixel_y = 28
	},
/turf/open/floor/mineral/titanium/white,
/area/shuttle/escape)
"dR" = (
/turf/open/floor/circuit/green/telecomms,
/area/shuttle/escape)
"eo" = (
/obj/effect/turf_decal/stripes/line{
	dir = 4
	},
/turf/open/floor/mineral/plastitanium,
/area/shuttle/escape)
"eE" = (
/obj/structure/window/reinforced/spawner,
/obj/structure/chair{
	dir = 8
	},
/turf/open/floor/mineral/plastitanium/red/brig,
/area/shuttle/escape)
"eT" = (
/obj/machinery/porta_turret/centcom_shuttle,
/turf/closed/wall/mineral/plastitanium/overspace,
/area/shuttle/escape)
"fC" = (
/obj/machinery/telecomms/server/presets/engineering,
/turf/open/floor/circuit/green/telecomms,
/area/shuttle/escape)
"gs" = (
/obj/effect/turf_decal/caution/stand_clear/red,
/obj/effect/turf_decal/stripes/line{
	dir = 1
	},
/turf/open/floor/mineral/titanium/white,
/area/shuttle/escape)
"jK" = (
/obj/structure/chair/office/dark,
/turf/open/floor/mineral/titanium/blue,
/area/shuttle/escape)
"kO" = (
/obj/effect/turf_decal/bot,
/mob/living/simple_animal/drone/snowflake/bardrone{
	desc = "A repair drone, an indestructible robot built to repair.";
	laws = "1. Repair the Shuttle.\n2. Talk to people.\n3. Don't get messed up in their affairs.";
	name = "EngiDrone"
	},
/turf/open/floor/mineral/plastitanium,
/area/shuttle/escape)
"mq" = (
/obj/machinery/door/airlock/external,
/obj/structure/fans/tiny,
/turf/open/floor/plating,
/area/shuttle/escape)
"nv" = (
/obj/item/bedsheet,
/obj/structure/bed,
/turf/open/floor/mineral/plastitanium/red/brig,
/area/shuttle/escape)
"ob" = (
/turf/open/floor/mech_bay_recharge_floor,
/area/shuttle/escape)
"rv" = (
/obj/structure/table,
/obj/item/restraints/handcuffs,
/obj/item/restraints/handcuffs,
/turf/open/floor/mineral/plastitanium/red/brig,
/area/shuttle/escape)
"sN" = (
/obj/effect/turf_decal/stripes/line{
	dir = 8
	},
/obj/effect/turf_decal/caution/red{
	dir = 4
	},
/turf/open/floor/mineral/plastitanium,
/area/shuttle/escape)
"uW" = (
/obj/machinery/status_display,
/turf/closed/wall/mineral/plastitanium,
/area/shuttle/escape)
"vG" = (
/obj/structure/table,
/obj/machinery/chem_dispenser/drinks{
	dir = 8
	},
/turf/open/floor/wood,
/area/shuttle/escape)
"xe" = (
/obj/structure/table,
/obj/item/storage/toolbox,
/obj/item/storage/toolbox,
/obj/item/storage/toolbox,
/obj/structure/window/reinforced/spawner,
/obj/structure/window/reinforced/spawner/north,
/obj/structure/window/reinforced/spawner/east,
/turf/open/floor/mineral/titanium/yellow,
/area/shuttle/escape)
"xV" = (
/obj/structure/table/reinforced,
/obj/machinery/door/window{
	base_state = "leftsecure";
	dir = 8;
	icon_state = "leftsecure";
	layer = 4.1;
	name = "Centcom Flagship Medbay Desk";
	obj_integrity = 300;
	pixel_x = -3;
	req_access_txt = "5"
	},
/turf/open/floor/mineral/titanium/white,
/area/shuttle/escape)
"yG" = (
/obj/structure/window/reinforced/spawner/east,
/obj/structure/chair/comfy/shuttle{
	dir = 8
	},
/turf/open/floor/mineral/titanium/white,
/area/shuttle/escape)
"yU" = (
/obj/structure/window/reinforced/spawner/west,
/obj/structure/window/reinforced/spawner,
/turf/open/floor/mineral/plastitanium/red/brig,
/area/shuttle/escape)
"ze" = (
/obj/structure/window/reinforced/spawner/east,
/turf/open/floor/mineral/plastitanium,
/area/shuttle/escape)
"AJ" = (
/obj/machinery/door/window/southright,
/turf/closed/wall/mineral/plastitanium,
/area/shuttle/escape)
"AV" = (
/obj/effect/turf_decal/bot,
/mob/living/simple_animal/drone/snowflake/bardrone,
/turf/open/floor/mineral/plastitanium,
/area/shuttle/escape)
"Bi" = (
/obj/structure/window/reinforced/spawner/west,
/obj/structure/chair/comfy/shuttle{
	dir = 4
	},
/turf/open/floor/mineral/titanium/white,
/area/shuttle/escape)
"Bw" = (
/obj/effect/turf_decal/caution/stand_clear/red{
	dir = 4
	},
/obj/effect/turf_decal/stripes/line{
	dir = 8
	},
/turf/open/floor/mineral/plastitanium,
/area/shuttle/escape)
"DP" = (
/obj/structure/window/reinforced/spawner/west,
/turf/open/floor/mineral/plastitanium/red/brig,
/area/shuttle/escape)
"Ec" = (
/turf/open/floor/mineral/plastitanium,
/area/shuttle/escape)
"Gi" = (
/obj/structure/chair/comfy/beige{
	dir = 1
	},
/turf/open/floor/carpet/black,
/area/shuttle/escape)
"Hg" = (
/obj/machinery/light{
	dir = 8
	},
/turf/open/floor/mineral/titanium/white,
/area/shuttle/escape)
"HE" = (
/obj/effect/turf_decal/caution/red,
/obj/effect/turf_decal/stripes/line{
	dir = 1
	},
/turf/open/floor/mineral/titanium/white,
/area/shuttle/escape)
"JZ" = (
/obj/structure/chair/comfy/shuttle{
	dir = 1
	},
/turf/open/floor/mineral/titanium/blue,
/area/shuttle/escape)
"KR" = (
/obj/machinery/door/airlock/command/glass{
	name = "Drone Storage"
	},
/turf/open/floor/mineral/plastitanium,
/area/shuttle/escape)
"Mt" = (
/obj/structure/table,
/obj/item/storage/toolbox/electrical,
/obj/item/storage/toolbox/electrical,
/obj/item/storage/toolbox/electrical,
/obj/structure/window/reinforced/spawner,
/obj/structure/window/reinforced/spawner/north,
/obj/structure/window/reinforced/spawner/east,
/turf/open/floor/mineral/titanium/yellow,
/area/shuttle/escape)
"Mu" = (
/obj/machinery/door/window/brigdoor/security/cell/westright{
	name = "Shuttle Cell Door";
	req_access_txt = "63"
	},
/turf/open/floor/mineral/plastitanium/red/brig,
/area/shuttle/escape)
"MR" = (
/turf/closed/wall/mineral/plastitanium/overspace,
/area/shuttle/escape)
"Or" = (
/obj/structure/table,
/obj/item/storage/toolbox/mechanical,
/obj/item/storage/toolbox/mechanical,
/obj/structure/window/reinforced/spawner,
/obj/structure/window/reinforced/spawner/north,
/obj/structure/window/reinforced/spawner/east,
/turf/open/floor/mineral/titanium/yellow,
/area/shuttle/escape)
"OB" = (
/obj/machinery/light{
	dir = 4
	},
/turf/open/floor/mineral/titanium/blue,
/area/shuttle/escape)
"OI" = (
/obj/machinery/light{
	dir = 8
	},
/obj/effect/turf_decal/bot,
/mob/living/simple_animal/drone/snowflake/bardrone{
	desc = "A Security drone, an indestructible robot built to keep the peace.";
	laws = "1. Keep the peace .\n2. Talk to people.\n3. Don't get messed up in their affairs.";
	name = "SecDrone"
	},
/turf/open/floor/mineral/plastitanium,
/area/shuttle/escape)
"ON" = (
/obj/machinery/suit_storage_unit/standard_unit,
/turf/open/floor/mineral/plastitanium,
/area/shuttle/escape)
"OO" = (
/obj/structure/table,
/obj/structure/window/reinforced/spawner/north,
/obj/structure/window/reinforced/spawner/east,
/obj/structure/window/reinforced/spawner,
/obj/item/storage/box/smart_metal_foam,
/obj/item/storage/box/smart_metal_foam,
/turf/open/floor/mineral/plastitanium,
/area/shuttle/escape)
"Px" = (
/obj/structure/window/reinforced/spawner,
/obj/machinery/recharge_station,
/turf/open/floor/mineral/titanium/yellow,
/area/shuttle/escape)
"Qk" = (
/obj/effect/fun_balloon/sentience/emergency_shuttle{
	invisibility = 100
	},
/obj/effect/turf_decal/bot,
/mob/living/simple_animal/drone/snowflake/bardrone{
	desc = "A Medical drone, an indestructible robot built to tend to people.";
	laws = "1. Heal people.\n2. Talk to people.\n3. Don't get messed up in their affairs.";
	name = "MediDrone"
	},
/turf/open/floor/mineral/plastitanium,
/area/shuttle/escape)
"SK" = (
/obj/machinery/computer/operating{
	dir = 2
	},
/turf/open/floor/mineral/titanium/blue,
/area/shuttle/escape)
"SP" = (
/obj/machinery/computer/mech_bay_power_console{
	dir = 2
	},
/obj/structure/window/reinforced/spawner/east,
/turf/open/floor/mineral/plastitanium,
/area/shuttle/escape)
"Ub" = (
/obj/structure/table,
/obj/machinery/chem_dispenser/drinks/beer{
	dir = 8
	},
/turf/open/floor/wood,
/area/shuttle/escape)
"Ud" = (
/obj/effect/turf_decal/stripes/line{
	dir = 8
	},
/turf/open/floor/mineral/titanium/white,
/area/shuttle/escape)
"UV" = (
/obj/machinery/door/window{
	name = "Centcom Flagship Engineering Storage";
	req_one_access_txt = "32;19"
	},
/turf/open/floor/mineral/titanium/yellow,
/area/shuttle/escape)
"VD" = (
/obj/effect/turf_decal/caution/red{
	dir = 1
	},
/obj/effect/turf_decal/stripes/line,
/turf/open/floor/mineral/titanium/blue,
/area/shuttle/escape)
"XG" = (
/obj/machinery/suit_storage_unit/standard_unit,
/obj/machinery/light{
	dir = 4
	},
/turf/open/floor/mineral/plastitanium,
/area/shuttle/escape)
"Zb" = (
/obj/machinery/door/window/southright{
	name = "Centcom Flagship Engineering Storage";
	req_one_access_txt = "32;19"
	},
/turf/open/floor/mineral/titanium/yellow,
/area/shuttle/escape)
"Zx" = (
/obj/machinery/mech_bay_recharge_port,
/turf/open/floor/mineral/plastitanium,
/area/shuttle/escape)

(1,1,1) = {"
aa
aa
aa
aa
aa
aa
aa
aa
aa
aa
aa
aa
aa
aa
aa
aa
aa
aa
eT
aL
ab
ab
ab
ab
ab
aU
ab
eT
aa
aa
aa
aa
aa
aa
aa
aa
aa
aa
aa
aa
aa
aa
aa
aa
aa
aa
"}
(2,1,1) = {"
aa
aa
aa
aa
aa
aa
aa
aa
aa
aa
aa
aa
aa
aa
aa
aa
aa
aa
ab
sN
aO
ON
ON
ON
aO
sN
aW
ab
aa
aa
aa
aa
aa
aa
aa
aa
aa
aa
aa
aa
aa
aa
aa
aa
aa
aa
"}
(3,1,1) = {"
aa
aa
aa
aa
aa
aa
aa
aa
aa
aa
aa
aa
aa
aa
aa
aa
aa
aa
ab
dc
Ec
Ec
Ec
Ec
Ec
Ec
Ec
ab
aa
aa
aa
aa
eT
ab
ab
ab
ab
ab
AJ
ab
ad
MR
aa
aa
aa
aa
"}
(4,1,1) = {"
aa
aa
aa
aa
aa
aa
aa
aa
aa
aa
aa
aa
aa
aa
aa
aa
aa
aa
ab
eo
XG
ON
ON
ON
XG
eo
aW
ab
aa
aa
aa
eT
ab
cG
cH
ci
bf
ab
OI
kO
ay
bK
bM
aa
aa
aa
"}
(5,1,1) = {"
aa
aa
eT
ab
ab
ab
eT
aa
aa
aa
aa
aa
aa
aa
aa
aa
eT
ab
ab
aN
ab
ab
ab
uW
ab
aN
ab
ab
ab
ab
ab
ab
cc
aZ
aZ
aZ
aZ
ab
Qk
AV
ay
bK
bM
aa
aa
aa
"}
(6,1,1) = {"
aa
eT
ay
cA
cV
cD
ay
eT
aa
aa
aa
aa
aa
aa
aa
eT
ay
bY
bY
Ud
cP
cQ
cS
cU
Hg
Ud
aq
cq
cq
bS
cq
ab
cd
aZ
aZ
Px
ab
ay
KR
ab
ay
ay
bK
bM
aa
aa
"}
(7,1,1) = {"
MR
ay
bP
an
cL
an
aw
ay
ab
ab
ab
ab
ab
ab
ab
ay
bY
aq
aq
aq
cP
cU
cS
cU
aq
aq
aq
aq
aq
aq
aq
am
cw
aZ
aZ
Px
Zx
Ec
Bw
Ec
bF
ay
bK
bM
aa
aa
"}
(8,1,1) = {"
ab
ae
an
an
an
an
an
an
da
gs
aq
aq
cq
cq
cq
aq
aq
aq
aq
aq
aq
aq
aq
aq
aq
aq
aq
yG
yG
yG
yG
ab
cx
aZ
aZ
Px
ob
Ec
Ec
Ec
bG
ay
ay
bK
bM
aa
"}
(9,1,1) = {"
ac
af
cJ
an
an
an
an
an
da
gs
aq
aq
co
aq
aq
aq
aq
aq
aq
aq
aq
aq
aq
aq
aq
aq
aq
Bi
Bi
Bi
Bi
ab
db
aZ
aZ
Px
SP
ze
Ec
Ec
Ec
Ec
ay
bK
bM
aa
"}
(10,1,1) = {"
ac
ag
an
an
aK
cY
an
Gi
uW
ac
uW
at
ab
ac
uW
az
ac
xV
ac
ab
aP
ay
aq
yG
yG
yG
aq
aq
aq
aq
bR
uW
cy
aZ
aZ
aZ
aZ
UV
Ec
by
by
Ec
ay
ay
bK
bM
"}
(11,1,1) = {"
ac
ah
cJ
an
cW
cY
an
Gi
ac
ar
as
as
cv
av
av
ab
JZ
aF
cE
SK
aF
ab
dd
Bi
Bi
Bi
aq
aq
aq
aq
aq
aY
aZ
aZ
aZ
Mt
xe
Or
Ec
bz
bz
Ec
Ec
ay
bK
bM
"}
(12,1,1) = {"
ac
ai
cJ
an
cX
cY
an
Gi
ac
as
as
as
as
as
as
ac
aA
aF
aF
aF
aF
am
aq
aq
aq
aq
aq
aq
aq
aq
aq
aY
aZ
aZ
aZ
aZ
aZ
Zb
Ec
bz
bz
Ec
Ec
ay
bK
bM
"}
(13,1,1) = {"
ac
aj
an
an
cX
cY
an
cN
ab
cn
as
as
as
as
rv
ac
aA
aF
aF
aF
VD
aT
HE
aq
aq
cT
cT
cT
aq
aq
bR
ab
ay
ac
ac
ay
bs
ay
bW
bB
by
Ec
ay
ay
bK
bM
"}
(14,1,1) = {"
ac
ak
cJ
an
an
an
an
Gi
ab
Mu
yU
Mu
yU
Mu
DP
ab
aB
aG
aF
aF
cb
uW
cr
aq
cT
aV
aV
aV
bN
bX
ch
ab
ba
bg
bd
cj
bg
ab
Ec
Ec
Ec
Ec
ay
bK
bM
aa
"}
(15,1,1) = {"
ab
al
an
an
an
an
an
Gi
ab
nv
eE
nv
cp
nv
ax
ab
aC
aH
aF
aF
aQ
ac
aq
aq
cT
aV
aX
aX
aX
aX
aX
ab
bp
bg
bh
bm
bg
ab
Ec
Ec
Ec
ay
ay
bK
bM
aa
"}
(16,1,1) = {"
MR
az
an
cK
cK
an
aw
ay
ab
ab
ab
ab
ab
ab
ab
ay
aD
aI
aF
jK
aR
ac
aq
aq
aq
aV
aX
aX
aX
aX
aX
ab
bc
bg
dR
dR
bg
ab
Ec
Ec
Ec
ay
bK
bM
aa
aa
"}
(17,1,1) = {"
aa
eT
ay
cs
ct
cu
ay
eT
aa
aa
aa
aa
aa
aa
aa
eT
ay
ao
aJ
OB
aS
ab
bY
cO
cO
br
aX
cI
vG
Ub
bV
ab
bq
bg
bw
fC
bg
ab
Ec
bD
ay
ay
bK
bM
aa
aa
"}
(18,1,1) = {"
aa
aa
eT
ab
ab
ab
eT
aa
aa
aa
aa
aa
aa
aa
aa
aa
eT
ab
ab
bZ
ab
ab
ab
mq
mq
ab
ab
ab
ab
ab
ab
ab
bo
bg
bg
bg
bg
ab
Ec
cl
ay
bK
bM
aa
aa
aa
"}
(19,1,1) = {"
aa
aa
aa
aa
aa
aa
aa
aa
aa
aa
aa
aa
aa
aa
aa
aa
aa
aa
aa
aa
aa
aa
ab
aM
aM
ab
aa
aa
aa
aa
aa
eT
ab
dR
dR
ck
dR
ab
OO
bD
ay
bK
bM
aa
aa
aa
"}
(20,1,1) = {"
aa
aa
aa
aa
aa
aa
aa
aa
aa
aa
aa
aa
aa
aa
aa
aa
aa
aa
aa
aa
aa
aa
ab
mq
mq
ab
aa
aa
aa
aa
aa
aa
eT
ab
ab
ab
ab
ab
ab
ab
ad
MR
aa
aa
aa
aa
"}
