//MAP CONVERTED BY dmm2tgm.py THIS HEADER COMMENT PREVENTS RECONVERSION, DO NOT REMOVE
"aa" = (
/turf/open/space,
/area/space)
"ab" = (
/obj/structure/shuttle/engine/propulsion{
	dir = 1
	},
/obj/effect/turf_decal/stripes/line{
	dir = 1
	},
/turf/open/floor/plating/airless,
/area/shuttle/escape)
"ac" = (
/turf/closed/wall/mineral/plastitanium,
/area/shuttle/escape)
"ad" = (
/obj/structure/window/reinforced,
/obj/structure/shuttle/engine/heater{
	dir = 1
	},
/obj/effect/turf_decal/stripes/line{
	dir = 1
	},
/turf/open/floor/plating/airless,
/area/shuttle/escape)
"ae" = (
/turf/closed/wall/mineral/titanium/nodiagonal,
/area/shuttle/escape)
"af" = (
/turf/closed/wall/mineral/titanium,
/area/shuttle/escape)
"ag" = (
/obj/structure/window/shuttle,
/obj/structure/grille,
/turf/open/floor/plating,
/area/shuttle/escape)
"ah" = (
/obj/item/clothing/suit/hazardvest{
	desc = "A high-visibility lifejacket complete with whistle and slot for oxygen tanks.";
	name = "emergency lifejacket"
	},
/obj/item/clothing/suit/hazardvest{
	desc = "A high-visibility lifejacket complete with whistle and slot for oxygen tanks.";
	name = "emergency lifejacket"
	},
/obj/item/clothing/suit/hazardvest{
	desc = "A high-visibility lifejacket complete with whistle and slot for oxygen tanks.";
	name = "emergency lifejacket"
	},
/obj/item/clothing/suit/hazardvest{
	desc = "A high-visibility lifejacket complete with whistle and slot for oxygen tanks.";
	name = "emergency lifejacket"
	},
/obj/item/clothing/suit/hazardvest{
	desc = "A high-visibility lifejacket complete with whistle and slot for oxygen tanks.";
	name = "emergency lifejacket"
	},
/obj/item/weapon/tank/internals/emergency_oxygen/double{
	pixel_x = 3
	},
/obj/item/weapon/tank/internals/emergency_oxygen/double{
	pixel_x = 3
	},
/obj/item/weapon/tank/internals/emergency_oxygen/double{
	pixel_x = 3
	},
/obj/item/weapon/tank/internals/emergency_oxygen/double{
	pixel_x = 3
	},
/obj/item/weapon/tank/internals/emergency_oxygen/double{
	pixel_x = 3
	},
/obj/item/clothing/mask/breath{
	pixel_x = -3;
	pixel_y = -3
	},
/obj/item/clothing/mask/breath{
	pixel_x = -3;
	pixel_y = -3
	},
/obj/item/clothing/mask/breath{
	pixel_x = -3;
	pixel_y = -3
	},
/obj/item/clothing/mask/breath{
	pixel_x = -3;
	pixel_y = -3
	},
/obj/item/clothing/mask/breath{
	pixel_x = -3;
	pixel_y = -3
	},
/obj/item/clothing/head/hardhat/orange{
	name = "protective hat";
	pixel_y = 9
	},
/obj/item/clothing/head/hardhat/orange{
	name = "protective hat";
	pixel_y = 9
	},
/obj/item/clothing/head/hardhat/orange{
	name = "protective hat";
	pixel_y = 9
	},
/obj/item/clothing/head/hardhat/orange{
	name = "protective hat";
	pixel_y = 9
	},
/obj/item/clothing/head/hardhat/orange{
	name = "protective hat";
	pixel_y = 9
	},
/obj/structure/closet/crate/internals,
/obj/effect/turf_decal/bot,
/turf/open/floor/plasteel,
/area/shuttle/escape)
"ai" = (
/turf/open/floor/plasteel/neutral/side{
	dir = 1
	},
/area/shuttle/escape)
"aj" = (
/obj/item/weapon/defibrillator/loaded,
/obj/structure/table/reinforced,
/turf/open/floor/plasteel/cmo,
/area/shuttle/escape)
"ak" = (
/obj/machinery/computer/operating,
/turf/open/floor/plasteel/cmo,
/area/shuttle/escape)
"al" = (
/obj/structure/table/optable,
/obj/item/weapon/surgical_drapes,
/turf/open/floor/plasteel/cmo,
/area/shuttle/escape)
"am" = (
/obj/item/weapon/scalpel{
	pixel_y = 12
	},
/obj/item/weapon/circular_saw,
/obj/item/weapon/retractor{
	pixel_x = 4
	},
/obj/item/weapon/hemostat{
	pixel_x = -4
	},
/obj/item/clothing/gloves/color/latex,
/obj/item/clothing/mask/surgical,
/obj/structure/table/reinforced,
/turf/open/floor/plasteel/cmo,
/area/shuttle/escape)
"an" = (
/obj/item/weapon/twohanded/required/kirbyplants{
	icon_state = "plant-21";
	layer = 4.1;
	pixel_x = -3;
	pixel_y = 3
	},
/turf/open/floor/plasteel/neutral/side{
	dir = 8;
	heat_capacity = 1e+006
	},
/area/shuttle/escape)
"ao" = (
/turf/open/floor/plasteel/neutral,
/area/shuttle/escape)
"ap" = (
/obj/item/weapon/twohanded/required/kirbyplants{
	icon_state = "plant-21";
	layer = 4.1;
	pixel_x = -3;
	pixel_y = 3
	},
/obj/machinery/light{
	dir = 4
	},
/turf/open/floor/plasteel/neutral/side{
	dir = 4
	},
/area/shuttle/escape)
"aq" = (
/obj/machinery/status_display,
/turf/closed/wall/mineral/titanium,
/area/shuttle/escape)
"ar" = (
/obj/item/weapon/reagent_containers/glass/bottle/epinephrine{
	pixel_x = 6
	},
/obj/item/weapon/reagent_containers/glass/bottle/charcoal{
	pixel_x = -3
	},
/obj/item/weapon/reagent_containers/glass/bottle/epinephrine{
	pixel_x = -3;
	pixel_y = 8
	},
/obj/item/weapon/reagent_containers/glass/bottle/charcoal{
	pixel_x = 6;
	pixel_y = 8
	},
/obj/item/weapon/reagent_containers/syringe/epinephrine{
	pixel_x = 3;
	pixel_y = -2
	},
/obj/item/weapon/reagent_containers/syringe/epinephrine{
	pixel_x = 4;
	pixel_y = 1
	},
/obj/item/weapon/reagent_containers/syringe/epinephrine{
	pixel_x = -2;
	pixel_y = 5
	},
/obj/item/weapon/reagent_containers/syringe/epinephrine{
	pixel_x = 2;
	pixel_y = 8
	},
/obj/structure/table/reinforced,
/obj/machinery/light{
	dir = 8
	},
/turf/open/floor/plasteel/cmo,
/area/shuttle/escape)
"as" = (
/obj/structure/chair/office/light{
	dir = 1
	},
/turf/open/floor/plasteel/cmo,
/area/shuttle/escape)
"at" = (
/obj/item/device/radio/intercom{
	name = "Station Intercom";
	pixel_x = 26;
	pixel_y = 58
	},
/turf/open/floor/plasteel/cmo,
/area/shuttle/escape)
"au" = (
/obj/structure/sink{
	dir = 4;
	pixel_x = 11
	},
/turf/open/floor/plasteel/cmo,
/area/shuttle/escape)
"av" = (
/obj/structure/chair{
	dir = 4
	},
/obj/effect/turf_decal/bot,
/turf/open/floor/plasteel,
/area/shuttle/escape)
"aw" = (
/obj/structure/chair{
	dir = 8
	},
/obj/effect/turf_decal/bot,
/turf/open/floor/plasteel,
/area/shuttle/escape)
"ax" = (
/obj/structure/flora/ausbushes/grassybush,
/obj/structure/flora/ausbushes/lavendergrass,
/obj/structure/flora/ausbushes/brflowers,
/obj/structure/flora/ausbushes/leafybush,
/obj/structure/window/shuttle,
/turf/open/floor/grass,
/area/shuttle/escape)
"ay" = (
/obj/machinery/computer/med_data,
/turf/open/floor/plasteel/whiteblue/side{
	dir = 1
	},
/area/shuttle/escape)
"az" = (
/obj/structure/chair/office/light{
	dir = 8
	},
/turf/open/floor/plasteel/whiteblue/side{
	icon_state = "whiteblue";
	dir = 1
	},
/area/shuttle/escape)
"aA" = (
/turf/open/floor/plasteel/whiteblue/side{
	icon_state = "whiteblue";
	dir = 1
	},
/area/shuttle/escape)
"aB" = (
/obj/item/weapon/storage/firstaid/toxin,
/obj/item/weapon/storage/firstaid/o2{
	pixel_x = 3;
	pixel_y = 3
	},
/obj/structure/table/reinforced,
/turf/open/floor/plasteel/whiteblue/side{
	dir = 5
	},
/area/shuttle/escape)
"aC" = (
/obj/machinery/ai_status_display,
/turf/closed/wall/mineral/titanium/nodiagonal,
/area/shuttle/escape)
"aD" = (
/obj/machinery/status_display,
/turf/closed/wall/mineral/titanium/nodiagonal,
/area/shuttle/escape)
"aE" = (
/obj/effect/turf_decal/delivery,
/turf/open/floor/plasteel,
/area/shuttle/escape)
"aF" = (
/obj/machinery/door/airlock/glass_medical{
	id_tag = null;
	name = "Escape Shuttle Infirmary";
	req_access_txt = "0"
	},
/obj/effect/turf_decal/stripes/line{
	dir = 8
	},
/turf/open/floor/plasteel,
/area/shuttle/escape)
"aG" = (
/obj/item/weapon/storage/firstaid/fire,
/obj/item/weapon/storage/firstaid/regular{
	pixel_x = 2;
	pixel_y = 3
	},
/obj/structure/table/reinforced,
/turf/open/floor/plasteel/whiteblue/side{
	dir = 4
	},
/area/shuttle/escape)
"aH" = (
/obj/structure/chair{
	dir = 4
	},
/obj/item/device/radio/intercom{
	name = "Station Intercom";
	pixel_x = -26
	},
/obj/effect/turf_decal/bot,
/turf/open/floor/plasteel,
/area/shuttle/escape)
"aI" = (
/obj/structure/flora/ausbushes/grassybush,
/obj/structure/flora/ausbushes/lavendergrass,
/obj/structure/flora/ausbushes/ywflowers,
/obj/structure/flora/ausbushes/genericbush,
/obj/structure/window/shuttle,
/turf/open/floor/grass,
/area/shuttle/escape)
"aJ" = (
/obj/machinery/shower{
	dir = 8;
	icon_state = "shower";
	name = "emergency shower"
	},
/turf/open/floor/plasteel/whiteblue/side{
	baseturf = /turf/open/floor/plating/lava/smooth/lava_land_surface;
	dir = 4
	},
/area/shuttle/escape)
"aK" = (
/obj/structure/extinguisher_cabinet,
/turf/closed/wall/mineral/titanium/nodiagonal,
/area/shuttle/escape)
"aL" = (
/obj/structure/bed/roller,
/obj/machinery/iv_drip,
/turf/open/floor/plasteel/whiteblue/side,
/area/shuttle/escape)
"aM" = (
/turf/open/floor/plasteel/whiteblue/side,
/area/shuttle/escape)
"aN" = (
/obj/structure/bed/roller,
/obj/machinery/iv_drip,
/obj/structure/extinguisher_cabinet{
	pixel_x = 26
	},
/obj/machinery/light/small{
	dir = 4
	},
/turf/open/floor/plasteel/whiteblue/side{
	dir = 6
	},
/area/shuttle/escape)
"aO" = (
/obj/machinery/door/airlock/shuttle{
	name = "Emergency Shuttle Airlock";
	req_access_txt = "0"
	},
/obj/effect/turf_decal/stripes/line{
	dir = 8
	},
/turf/open/floor/plasteel/white,
/area/shuttle/escape)
"aP" = (
/obj/structure/sign/bluecross_2,
/turf/closed/wall/mineral/titanium,
/area/shuttle/escape)
"aQ" = (
/obj/machinery/sleeper{
	dir = 4
	},
/turf/open/floor/plasteel/cmo,
/area/shuttle/escape)
"aR" = (
/turf/open/floor/plasteel/cmo,
/area/shuttle/escape)
"aS" = (
/obj/machinery/sleeper{
	dir = 8
	},
/turf/open/floor/plasteel/cmo,
/area/shuttle/escape)
"aT" = (
/obj/structure/sign/nanotrasen,
/turf/closed/wall/mineral/titanium,
/area/shuttle/escape)
"aU" = (
/obj/effect/turf_decal/bot,
/obj/machinery/light{
	dir = 8
	},
/turf/open/floor/plasteel,
/area/shuttle/escape)
"aV" = (
/obj/machinery/door/airlock/glass_medical{
	id_tag = null;
	name = "Escape Shuttle Infirmary";
	req_access_txt = "0"
	},
/obj/effect/turf_decal/stripes/line{
	dir = 2
	},
/turf/open/floor/plasteel,
/area/shuttle/escape)
"aW" = (
/obj/machinery/door/airlock/shuttle{
	name = "Emergency Shuttle Airlock"
	},
/obj/docking_port/mobile/emergency{
	dheight = 0;
	dwidth = 11;
	height = 18;
	name = "Delta emergency shuttle";
	width = 30;
	preferred_direction = 2;
	port_angle = 90
	},
/turf/open/floor/plating,
/area/shuttle/escape)
"aX" = (
/obj/structure/flora/ausbushes/grassybush,
/obj/structure/flora/ausbushes/lavendergrass,
/obj/structure/flora/ausbushes/ppflowers,
/obj/structure/flora/ausbushes/sunnybush,
/obj/structure/window/shuttle,
/turf/open/floor/grass,
/area/shuttle/escape)
"aY" = (
/obj/structure/extinguisher_cabinet{
	pixel_x = -26
	},
/obj/machinery/shieldgen,
/obj/effect/turf_decal/bot,
/turf/open/floor/plasteel,
/area/shuttle/escape)
"aZ" = (
/obj/structure/rack,
/obj/item/weapon/storage/toolbox/electrical{
	pixel_x = -3;
	pixel_y = 1
	},
/obj/item/weapon/storage/toolbox/mechanical{
	pixel_y = -1
	},
/obj/item/weapon/storage/toolbox/emergency{
	pixel_x = 3;
	pixel_y = -5
	},
/obj/effect/turf_decal/bot,
/obj/machinery/light/small{
	dir = 1
	},
/turf/open/floor/plasteel,
/area/shuttle/escape)
"ba" = (
/obj/structure/reagent_dispensers/fueltank,
/obj/item/device/radio/intercom{
	name = "Station Intercom";
	pixel_x = -26
	},
/obj/effect/turf_decal/bot,
/turf/open/floor/plasteel,
/area/shuttle/escape)
"bb" = (
/obj/effect/turf_decal/stripes/line{
	dir = 9
	},
/turf/open/floor/plasteel,
/area/shuttle/escape)
"bc" = (
/obj/effect/turf_decal/stripes/line{
	dir = 5
	},
/turf/open/floor/plasteel,
/area/shuttle/escape)
"bd" = (
/obj/structure/closet/crate/medical{
	name = "medical crate"
	},
/obj/item/weapon/storage/firstaid/regular,
/obj/item/weapon/storage/firstaid/o2{
	pixel_x = 3;
	pixel_y = 3
	},
/obj/item/weapon/storage/firstaid/toxin{
	pixel_x = -4;
	pixel_y = 3
	},
/obj/item/device/healthanalyzer{
	pixel_x = 3;
	pixel_y = 3
	},
/obj/item/weapon/lazarus_injector,
/obj/effect/turf_decal/bot,
/mob/living/simple_animal/bot/medbot{
	name = "\improper emergency medibot";
	pixel_x = -3;
	pixel_y = 2
	},
/turf/open/floor/plasteel,
/area/shuttle/escape)
"be" = (
/obj/structure/flora/ausbushes/grassybush,
/obj/structure/flora/ausbushes/lavendergrass,
/obj/structure/flora/ausbushes/ywflowers,
/obj/structure/flora/ausbushes/fernybush,
/obj/structure/window/shuttle,
/turf/open/floor/grass,
/area/shuttle/escape)
"bf" = (
/obj/structure/reagent_dispensers/watertank,
/obj/effect/turf_decal/bot,
/turf/open/floor/plasteel,
/area/shuttle/escape)
"bg" = (
/obj/effect/turf_decal/stripes/line{
	dir = 8
	},
/turf/open/floor/plasteel,
/area/shuttle/escape)
"bh" = (
/obj/effect/turf_decal/stripes/line{
	dir = 4
	},
/turf/open/floor/plasteel,
/area/shuttle/escape)
"bi" = (
/obj/structure/closet/crate{
	name = "emergency supplies crate"
	},
/obj/item/weapon/storage/toolbox/emergency,
/obj/item/weapon/storage/toolbox/emergency,
/obj/item/device/flashlight/flare{
	pixel_x = 3;
	pixel_y = 3
	},
/obj/item/device/flashlight/flare{
	pixel_x = -6;
	pixel_y = -2
	},
/obj/item/weapon/crowbar,
/obj/item/weapon/wrench,
/obj/item/device/radio,
/obj/effect/turf_decal/bot,
/turf/open/floor/plasteel,
/area/shuttle/escape)
"bj" = (
/obj/machinery/vending/wallmed{
	name = "Emergency NanoMed";
	req_access_txt = "0";
	use_power = 0
	},
/turf/closed/wall/mineral/titanium/nodiagonal,
/area/shuttle/escape)
"bk" = (
/obj/machinery/door/airlock/shuttle{
	name = "Emergency Shuttle Cargo"
	},
/obj/effect/turf_decal/stripes/line{
	dir = 8
	},
/turf/open/floor/plasteel,
/area/shuttle/escape)
"bl" = (
/obj/structure/rack,
/obj/item/clothing/suit/fire/firefighter,
/obj/item/weapon/tank/internals/oxygen/red,
/obj/item/clothing/mask/gas,
/obj/item/clothing/head/hardhat/red,
/obj/effect/turf_decal/bot,
/obj/machinery/light{
	dir = 8
	},
/turf/open/floor/plasteel,
/area/shuttle/escape)
"bm" = (
/obj/effect/turf_decal/stripes/line{
	dir = 10
	},
/turf/open/floor/plasteel,
/area/shuttle/escape)
"bn" = (
/obj/effect/turf_decal/stripes/line{
	dir = 6
	},
/turf/open/floor/plasteel,
/area/shuttle/escape)
"bo" = (
/turf/open/floor/plasteel/neutral/side,
/area/shuttle/escape)
"bp" = (
/obj/machinery/flasher{
	id = "shuttleflash";
	pixel_y = -26
	},
/obj/machinery/light,
/turf/open/floor/plasteel/neutral/side,
/area/shuttle/escape)
"bq" = (
/obj/structure/table,
/obj/item/weapon/clipboard,
/obj/item/weapon/folder/yellow,
/obj/item/weapon/pen,
/obj/item/hand_labeler_refill,
/obj/effect/turf_decal/bot,
/turf/open/floor/plasteel,
/area/shuttle/escape)
"br" = (
/obj/machinery/recharge_station,
/obj/effect/turf_decal/delivery,
/turf/open/floor/plasteel,
/area/shuttle/escape)
"bs" = (
/obj/structure/table,
/obj/machinery/cell_charger,
/obj/item/weapon/stock_parts/cell/high,
/obj/effect/turf_decal/bot,
/turf/open/floor/plasteel,
/area/shuttle/escape)
"bt" = (
/obj/machinery/door/airlock/glass_security{
	name = "Holding Area";
	req_access_txt = "2"
	},
/turf/open/floor/mineral/plastitanium/brig,
/area/shuttle/escape)
"bu" = (
/obj/machinery/door/airlock/glass_command{
	name = "Cockpit";
	req_access_txt = "19"
	},
/obj/effect/turf_decal/stripes/line{
	dir = 2
	},
/turf/open/floor/plasteel,
/area/shuttle/escape)
"bv" = (
/obj/machinery/door/airlock/shuttle{
	name = "Emergency Shuttle Airlock";
	req_access_txt = "2"
	},
/obj/effect/turf_decal/stripes/line{
	dir = 8
	},
/turf/open/floor/plasteel/white,
/area/shuttle/escape)
"bw" = (
/turf/open/floor/mineral/plastitanium/brig,
/area/shuttle/escape)
"bx" = (
/obj/structure/chair,
/turf/open/floor/mineral/plastitanium/brig,
/area/shuttle/escape)
"by" = (
/obj/structure/table/reinforced,
/obj/machinery/recharger,
/turf/open/floor/mineral/plastitanium/brig,
/area/shuttle/escape)
"bz" = (
/obj/item/weapon/twohanded/required/kirbyplants{
	icon_state = "plant-21";
	layer = 4.1
	},
/obj/machinery/button/flasher{
	id = "shuttleflash";
	pixel_x = -26;
	pixel_y = 24
	},
/turf/open/floor/plasteel/red/corner{
	dir = 1
	},
/area/shuttle/escape)
"bA" = (
/obj/item/weapon/twohanded/required/kirbyplants{
	icon_state = "plant-21";
	layer = 4.1
	},
/turf/open/floor/plasteel/neutral/corner{
	dir = 4
	},
/area/shuttle/escape)
"bB" = (
/obj/structure/table,
/obj/item/weapon/clipboard,
/obj/item/toy/figure/ninja,
/obj/effect/turf_decal/bot,
/turf/open/floor/plasteel,
/area/shuttle/escape)
"bC" = (
/obj/structure/chair,
/obj/effect/turf_decal/bot,
/turf/open/floor/plasteel,
/area/shuttle/escape)
"bD" = (
/obj/structure/chair,
/obj/machinery/status_display{
	pixel_y = 32
	},
/obj/effect/turf_decal/bot,
/turf/open/floor/plasteel,
/area/shuttle/escape)
"bE" = (
/obj/structure/chair{
	dir = 4
	},
/turf/open/floor/mineral/plastitanium/brig,
/area/shuttle/escape)
"bF" = (
/turf/open/floor/plasteel/red/corner{
	dir = 1
	},
/area/shuttle/escape)
"bG" = (
/obj/structure/extinguisher_cabinet{
	pixel_x = 26
	},
/obj/machinery/light{
	dir = 4
	},
/turf/open/floor/plasteel/neutral/corner{
	dir = 4
	},
/area/shuttle/escape)
"bH" = (
/turf/open/floor/plasteel,
/area/shuttle/escape)
"bI" = (
/turf/open/floor/plasteel/neutral/corner,
/area/shuttle/escape)
"bJ" = (
/obj/item/device/radio/intercom{
	name = "Station Intercom";
	pixel_y = 58
	},
/turf/open/floor/plasteel/neutral/side,
/area/shuttle/escape)
"bK" = (
/turf/open/floor/plasteel/neutral/corner{
	dir = 8
	},
/area/shuttle/escape)
"bL" = (
/obj/machinery/door/airlock/external{
	name = "Emergency Recovery Airlock"
	},
/obj/effect/turf_decal/stripes/line{
	dir = 8
	},
/turf/open/floor/plasteel,
/area/shuttle/escape)
"bM" = (
/obj/structure/chair{
	dir = 4
	},
/obj/machinery/status_display{
	pixel_x = -32
	},
/turf/open/floor/mineral/plastitanium/brig,
/area/shuttle/escape)
"bN" = (
/obj/structure/chair{
	dir = 8
	},
/turf/open/floor/mineral/plastitanium/brig,
/area/shuttle/escape)
"bO" = (
/obj/structure/table/reinforced,
/obj/item/weapon/storage/lockbox/loyalty,
/turf/open/floor/mineral/plastitanium/brig,
/area/shuttle/escape)
"bP" = (
/obj/structure/table/reinforced,
/obj/machinery/recharger,
/turf/open/floor/plasteel/red/corner{
	dir = 8
	},
/area/shuttle/escape)
"bQ" = (
/obj/structure/fireaxecabinet{
	pixel_x = 32
	},
/turf/open/floor/plasteel/neutral/corner,
/area/shuttle/escape)
"bR" = (
/obj/machinery/door/airlock/external{
	name = "Emergency Recovery Airlock"
	},
/obj/effect/turf_decal/stripes/line{
	dir = 2
	},
/turf/open/floor/plasteel,
/area/shuttle/escape)
"bS" = (
/turf/open/floor/plasteel/neutral/corner{
	dir = 4
	},
/area/shuttle/escape)
"bT" = (
/turf/open/floor/plasteel/neutral/corner{
	dir = 1
	},
/area/shuttle/escape)
"bU" = (
/obj/structure/chair{
	dir = 1
	},
/turf/open/floor/mineral/plastitanium/brig,
/area/shuttle/escape)
"bV" = (
/obj/structure/table/reinforced,
/obj/item/weapon/storage/box/zipties,
/obj/item/device/radio/intercom{
	name = "Station Intercom";
	pixel_y = -26
	},
/turf/open/floor/mineral/plastitanium/brig,
/area/shuttle/escape)
"bW" = (
/obj/structure/table/reinforced,
/obj/item/weapon/paper_bin,
/obj/item/weapon/pen,
/turf/open/floor/plasteel/red/corner{
	dir = 8
	},
/area/shuttle/escape)
"bX" = (
/turf/open/floor/plasteel/blue/side,
/area/shuttle/escape)
"bY" = (
/obj/machinery/door/airlock/command{
	name = "Emergency Recovery Airlock";
	req_access = null;
	req_access_txt = "19"
	},
/obj/effect/turf_decal/stripes/line{
	dir = 8
	},
/turf/open/floor/plasteel,
/area/shuttle/escape)
"bZ" = (
/obj/machinery/suit_storage_unit/standard_unit,
/obj/effect/turf_decal/delivery,
/turf/open/floor/plasteel,
/area/shuttle/escape)
"ca" = (
/obj/structure/table/reinforced,
/obj/machinery/recharger,
/turf/open/floor/plasteel/vault{
	dir = 4
	},
/area/shuttle/escape)
"cb" = (
/obj/item/weapon/twohanded/required/kirbyplants{
	icon_state = "plant-21";
	layer = 4.1;
	pixel_x = -3;
	pixel_y = 3
	},
/obj/machinery/light{
	dir = 1
	},
/turf/open/floor/plasteel/vault{
	icon_state = "vault";
	dir = 5
	},
/area/shuttle/escape)
"cc" = (
/turf/open/floor/plasteel/vault{
	icon_state = "vault";
	dir = 5
	},
/area/shuttle/escape)
"cd" = (
/obj/structure/table/reinforced,
/obj/item/weapon/storage/fancy/donut_box,
/turf/open/floor/plasteel/vault{
	dir = 4
	},
/area/shuttle/escape)
"ce" = (
/obj/machinery/computer/security,
/turf/open/floor/plasteel/darkred/side{
	icon_state = "darkred";
	dir = 9
	},
/area/shuttle/escape)
"cf" = (
/obj/structure/chair/office/dark{
	dir = 8
	},
/turf/open/floor/plasteel/vault{
	icon_state = "vault";
	dir = 5
	},
/area/shuttle/escape)
"cg" = (
/obj/item/device/radio/intercom{
	name = "Station Intercom";
	pixel_x = 26;
	pixel_y = 58
	},
/turf/open/floor/plasteel/vault{
	icon_state = "vault";
	dir = 5
	},
/area/shuttle/escape)
"ch" = (
/obj/structure/chair/office/dark{
	dir = 4
	},
/turf/open/floor/plasteel/vault{
	icon_state = "vault";
	dir = 5
	},
/area/shuttle/escape)
"ci" = (
/obj/machinery/computer/station_alert,
/turf/open/floor/plasteel/darkyellow/side{
	icon_state = "darkyellow";
	dir = 5
	},
/area/shuttle/escape)
"cj" = (
/obj/machinery/computer/secure_data,
/turf/open/floor/plasteel/darkred/side{
	icon_state = "darkred";
	dir = 10
	},
/area/shuttle/escape)
"ck" = (
/obj/structure/chair/office/dark{
	dir = 8
	},
/turf/open/floor/plasteel/vault,
/area/shuttle/escape)
"cl" = (
/obj/structure/chair/office/dark,
/turf/open/floor/plasteel/vault,
/area/shuttle/escape)
"cm" = (
/obj/structure/table/reinforced,
/obj/item/weapon/storage/firstaid/regular,
/turf/open/floor/plasteel/vault,
/area/shuttle/escape)
"cn" = (
/obj/structure/table/reinforced,
/obj/item/weapon/folder/blue,
/obj/item/weapon/pen,
/turf/open/floor/plasteel/vault,
/area/shuttle/escape)
"co" = (
/obj/structure/chair/office/dark{
	dir = 4
	},
/turf/open/floor/plasteel/vault,
/area/shuttle/escape)
"cp" = (
/obj/machinery/computer/atmos_alert,
/turf/open/floor/plasteel/darkyellow/side{
	icon_state = "darkyellow";
	dir = 6
	},
/area/shuttle/escape)
"cq" = (
/obj/structure/table/reinforced,
/obj/item/weapon/paper_bin,
/obj/item/weapon/pen,
/turf/open/floor/plasteel/vault{
	dir = 4
	},
/area/shuttle/escape)
"cr" = (
/obj/structure/table/reinforced,
/obj/item/weapon/folder/red,
/obj/item/weapon/restraints/handcuffs,
/obj/item/device/assembly/flash/handheld,
/turf/open/floor/plasteel/vault,
/area/shuttle/escape)
"cs" = (
/obj/machinery/computer/crew,
/turf/open/floor/plasteel/darkblue/side,
/area/shuttle/escape)
"ct" = (
/obj/machinery/computer/med_data,
/turf/open/floor/plasteel/darkblue/side{
	dir = 6
	},
/area/shuttle/escape)
"cu" = (
/obj/machinery/computer/emergency_shuttle,
/turf/open/floor/plasteel/darkblue/side{
	dir = 10
	},
/area/shuttle/escape)
"cv" = (
/obj/machinery/computer/communications,
/turf/open/floor/plasteel/darkblue/side,
/area/shuttle/escape)
"cw" = (
/obj/structure/table/reinforced,
/obj/item/weapon/storage/toolbox/mechanical,
/turf/open/floor/plasteel/vault,
/area/shuttle/escape)
"cx" = (
/obj/structure/table/reinforced,
/obj/machinery/cell_charger,
/obj/item/weapon/stock_parts/cell/high,
/turf/open/floor/plasteel/vault{
	dir = 4
	},
/area/shuttle/escape)
"cy" = (
/obj/machinery/light{
	dir = 1
	},
/turf/open/floor/plasteel/neutral/side{
	dir = 1
	},
/area/shuttle/escape)
"cz" = (
/obj/machinery/light{
	dir = 1
	},
/turf/open/floor/plasteel/neutral/side{
	dir = 1
	},
/area/shuttle/escape)
"cA" = (
/obj/item/weapon/twohanded/required/kirbyplants{
	icon_state = "plant-21";
	layer = 4.1;
	pixel_x = -3;
	pixel_y = 3
	},
/obj/machinery/light{
	dir = 8
	},
/turf/open/floor/plasteel/neutral/side{
	dir = 8;
	heat_capacity = 1e+006
	},
/area/shuttle/escape)
"cB" = (
/obj/structure/chair{
	dir = 8
	},
/obj/effect/turf_decal/bot,
/obj/machinery/light{
	dir = 4
	},
/turf/open/floor/plasteel,
/area/shuttle/escape)
"cC" = (
/obj/effect/turf_decal/bot,
/turf/open/floor/plasteel,
/area/shuttle/escape)
"cD" = (
/obj/effect/turf_decal/bot,
/turf/open/floor/plasteel,
/area/shuttle/escape)
"cE" = (
/obj/item/weapon/twohanded/required/kirbyplants{
	icon_state = "plant-21";
	layer = 4.1;
	pixel_x = -3;
	pixel_y = 3
	},
/obj/machinery/light{
	dir = 8
	},
/turf/open/floor/plasteel/neutral/side{
	dir = 8;
	heat_capacity = 1e+006
	},
/area/shuttle/escape)
"cF" = (
/obj/machinery/light,
/turf/open/floor/plasteel,
/area/shuttle/escape)
"cG" = (
/obj/structure/chair{
	dir = 1
	},
/obj/machinery/light,
/turf/open/floor/mineral/plastitanium/brig,
/area/shuttle/escape)
"cH" = (
/obj/effect/turf_decal/bot,
/obj/machinery/light/small,
/turf/open/floor/plasteel,
/area/shuttle/escape)

(1,1,1) = {"
aa
ac
ae
af
af
ag
ag
af
af
aO
aT
aW
af
ag
ag
ag
af
aO
af
bv
af
af
af
af
aa
aa
aa
aa
aa
"}
(2,1,1) = {"
ab
ad
af
ah
cA
av
av
aH
an
aE
aU
aE
an
av
av
av
cA
aE
af
bw
bE
bM
bU
af
aa
aa
aa
aa
aa
"}
(3,1,1) = {"
ab
ad
ag
ai
ao
ao
ao
ao
ao
ao
ao
ao
ao
ao
ao
ao
ao
bo
bt
bw
bw
bw
bU
ag
aa
aa
aa
aa
aa
"}
(4,1,1) = {"
ab
ad
ag
ai
ao
aw
aw
aw
aw
aw
ao
aw
aw
aw
aw
aw
ao
bo
af
bx
bw
bw
cG
af
aa
aa
aa
aa
aa
"}
(5,1,1) = {"
ac
ac
af
ai
ao
ax
aC
aI
aK
ax
ao
aX
aK
be
aD
aX
ao
bo
ag
bx
bw
bN
bU
af
af
aT
ag
af
af
"}
(6,1,1) = {"
ab
ad
af
cy
ao
av
av
av
av
av
ao
av
av
av
av
av
ao
bo
af
by
bw
bO
bV
af
ca
ce
cj
cq
af
"}
(7,1,1) = {"
ab
ad
ag
ai
ao
ao
ao
ao
ao
ao
ao
ao
ao
ao
ao
ao
ao
bp
af
af
bt
ag
aT
af
cb
cf
ck
cr
ag
"}
(8,1,1) = {"
ac
ac
af
cy
ao
aw
aw
aw
aw
aw
ao
aw
aw
aw
aw
aw
ao
bo
ag
bz
bF
bP
bW
aq
cc
cc
cl
cs
ag
"}
(9,1,1) = {"
ab
ad
ag
ai
ao
ax
aD
aI
aK
ax
ao
aX
aC
be
bj
aX
ao
bo
bu
ai
ao
ao
bX
bu
cc
cc
cm
ct
ag
"}
(10,1,1) = {"
ab
ad
ag
ai
ao
av
av
av
av
av
ao
av
av
av
av
av
ao
bo
bu
ai
ao
ao
bX
bu
cc
cc
cn
cu
ag
"}
(11,1,1) = {"
ac
ac
af
ai
ao
ao
ao
ao
ao
ao
ao
ao
ao
ao
ao
ao
ao
bo
ag
bA
bG
bQ
bI
aq
cc
cg
cl
cv
ag
"}
(12,1,1) = {"
ab
ad
ag
ah
ap
aw
aE
aE
aw
aw
cB
aw
aw
aw
aE
aE
ap
ah
af
aT
af
af
bY
af
cb
ch
co
cw
ag
"}
(13,1,1) = {"
ab
ad
af
af
aq
ag
aF
aF
ag
aP
af
af
af
af
bk
bk
af
af
af
bB
bH
bR
cH
af
cd
ci
cp
cx
af
"}
(14,1,1) = {"
ac
ac
af
aj
ar
ay
aE
aE
aL
aQ
af
aY
ba
bf
aE
aE
bl
bq
af
bC
cF
ae
af
af
af
aT
ag
af
af
"}
(15,1,1) = {"
ab
ad
ag
ak
as
az
ao
ao
aM
aR
aV
aE
bb
bg
bg
bg
bm
br
af
bD
bI
bS
bZ
af
aa
aa
aa
aa
aa
"}
(16,1,1) = {"
ab
ad
ag
al
at
aA
ao
ao
aM
aR
aV
aE
bc
bh
bh
bh
bn
br
af
bC
bJ
ai
bZ
ag
aa
aa
aa
aa
aa
"}
(17,1,1) = {"
ab
ad
af
am
au
aB
aG
aJ
aN
aS
aP
aZ
bd
bi
cC
cC
ah
bs
af
ah
bK
bT
bZ
af
aa
aa
aa
aa
aa
"}
(18,1,1) = {"
aa
ac
ae
af
ag
ag
ag
ag
af
af
aT
af
ag
ag
ag
ag
ag
af
af
ag
bL
bL
ag
af
aa
aa
aa
aa
aa
"}
