//MAP CONVERTED BY dmm2tgm.py THIS HEADER COMMENT PREVENTS RECONVERSION, DO NOT REMOVE
"a" = (
/obj/basic/structure/shuttle/engine/propulsion{
	dir = 8
	},
/turf/closed/wall/mineral/titanium,
/area/shuttle/escape)
"b" = (
/turf/closed/wall/mineral/titanium,
/area/shuttle/escape)
"c" = (
/obj/basic/effect/spawner/structure/window/shuttle,
/turf/open/floor/plating,
/area/shuttle/escape)
"d" = (
/turf/template_noop,
/area/template_noop)
"e" = (
/obj/basic/machinery/door/airlock/titanium{
	name = "Shuttle Airlock"
	},
/turf/open/floor/mineral/titanium/blue,
/area/shuttle/escape)
"f" = (
/obj/basic/structure/chair/comfy/shuttle,
/turf/open/floor/mineral/titanium/blue,
/area/shuttle/escape)
"g" = (
/turf/open/floor/mineral/titanium/blue,
/area/shuttle/escape)
"i" = (
/obj/basic/machinery/light/directional/west,
/turf/open/floor/mineral/titanium/blue,
/area/shuttle/escape)
"j" = (
/obj/basic/structure/chair/comfy/shuttle{
	dir = 1
	},
/turf/open/floor/mineral/titanium/blue,
/area/shuttle/escape)
"k" = (
/obj/basic/machinery/computer/emergency_shuttle{
	dir = 8
	},
/obj/basic/machinery/light/small/directional/east,
/turf/open/floor/mineral/titanium/blue,
/area/shuttle/escape)
"m" = (
/obj/basic/machinery/door/airlock/titanium{
	name = "Shuttle Airlock"
	},
/obj/basic/docking_port/mobile/emergency{
	port_direction = 2;
	preferred_direction = 4
	},
/turf/open/floor/mineral/titanium/blue,
/area/shuttle/escape)

(1,1,1) = {"
a
e
b
m
a
d
d
d
a
e
b
e
a
"}
(2,1,1) = {"
b
f
i
j
b
d
d
d
b
f
i
j
b
"}
(3,1,1) = {"
c
f
g
j
c
d
d
d
c
f
g
j
c
"}
(4,1,1) = {"
b
f
g
j
b
d
d
d
b
f
g
j
b
"}
(5,1,1) = {"
b
b
k
b
b
d
d
d
b
b
k
b
b
"}
(6,1,1) = {"
d
b
c
b
d
d
d
d
d
b
c
b
d
"}
