//MAP CONVERTED BY dmm2tgm.py THIS HEADER COMMENT PREVENTS RECONVERSION, DO NOT REMOVE
//Model dictionary trimmed on: 11-07-2017 21:23 (UTC)
"aa" = (
/turf/open/space,
/area/space)
"ab" = (
/obj/structure/sign/radiation,
/turf/closed/wall/mineral/titanium,
/area/shuttle/escape)
"ac" = (
/obj/structure/grille,
/obj/structure/window/shuttle,
/turf/open/floor/plating,
/area/shuttle/escape)
"ad" = (
/turf/closed/wall/mineral/titanium,
/area/shuttle/escape)
"ae" = (
/obj/structure/closet/radiation{
	anchored = 1
	},
/obj/item/clothing/glasses/meson/engine,
/turf/open/floor/mineral/titanium/yellow,
/area/shuttle/escape)
"af" = (
/obj/structure/chair,
/turf/open/floor/mineral/titanium/yellow,
/area/shuttle/escape)
"ag" = (
/turf/open/floor/mineral/titanium/yellow,
/area/shuttle/escape)
"ah" = (
/obj/structure/chair{
	dir = 1
	},
/turf/open/floor/mineral/titanium/yellow,
/area/shuttle/escape)
"ai" = (
/obj/machinery/shower{
	dir = 8
	},
/turf/open/floor/noslip,
/area/shuttle/escape)
"aj" = (
/obj/structure/reflector/single/anchored,
/obj/effect/turf_decal/stripes/line{
	dir = 8
	},
/turf/open/floor/plating,
/area/shuttle/escape)
"ak" = (
/obj/structure/reflector/box/anchored,
/turf/open/floor/plating,
/area/shuttle/escape)
"al" = (
/obj/structure/reflector/single{
	icon_state = "reflector";
	dir = 8;
	anchored = 1
	},
/obj/effect/turf_decal/stripes/line{
	dir = 4
	},
/turf/open/floor/plating,
/area/shuttle/escape)
"am" = (
/obj/machinery/shower{
	dir = 4
	},
/turf/open/floor/noslip,
/area/shuttle/escape)
"an" = (
/obj/machinery/status_display,
/turf/closed/wall/mineral/titanium,
/area/shuttle/escape)
"ao" = (
/obj/structure/chair{
	dir = 8
	},
/turf/open/floor/mineral/titanium/yellow,
/area/shuttle/escape)
"ap" = (
/obj/effect/turf_decal/stripes/line{
	dir = 8
	},
/turf/open/floor/plating,
/area/shuttle/escape)
"aq" = (
/turf/open/floor/plating,
/area/shuttle/escape)
"ar" = (
/obj/effect/turf_decal/stripes/line{
	dir = 4
	},
/turf/open/floor/plating,
/area/shuttle/escape)
"as" = (
/obj/structure/chair{
	dir = 4
	},
/turf/open/floor/mineral/titanium/yellow,
/area/shuttle/escape)
"at" = (
/turf/closed/wall/mineral/titanium/nodiagonal,
/area/shuttle/escape)
"au" = (
/turf/open/floor/mineral/titanium/yellow,
/turf/closed/wall/mineral/titanium/interior,
/area/shuttle/escape)
"av" = (
/obj/machinery/door/airlock/titanium{
	name = "Emergency Shuttle Airlock"
	},
/turf/open/floor/plating,
/area/shuttle/escape)
"aw" = (
/obj/machinery/power/supermatter_shard/hugbox{
	anchored = 1;
	base_icon_state = "darkmatter";
	explosion_power = 20;
	gasefficency = 0.15;
	icon_state = "darkmatter";
	name = "anchored supermatter crystal"
	},
/turf/open/floor/plating,
/area/shuttle/escape)
"ax" = (
/obj/structure/table/reinforced,
/obj/item/weapon/storage/firstaid/toxin,
/obj/item/weapon/crowbar/red,
/obj/item/weapon/storage/box/snappops{
	pixel_x = 4;
	pixel_y = -4
	},
/turf/open/floor/mineral/titanium/yellow,
/area/shuttle/escape)
"ay" = (
/obj/structure/reagent_dispensers/fueltank,
/turf/open/floor/mineral/titanium/yellow,
/area/shuttle/escape)
"az" = (
/obj/machinery/door/airlock/titanium{
	name = "Emergency Shuttle Airlock"
	},
/obj/docking_port/mobile/emergency{
	name = "Hyperfractal Gigashuttle";
	timid = 1
	},
/turf/open/floor/plating,
/area/shuttle/escape)
"aA" = (
/obj/structure/sign/radiation,
/turf/closed/wall/mineral/titanium/nodiagonal,
/area/shuttle/escape)
"aB" = (
/obj/machinery/door/airlock/external{
	name = "Emergency Launch Catwalk";
	req_access = null;
	req_access_txt = "10;13"
	},
/turf/open/floor/plating,
/area/shuttle/escape)
"aC" = (
/turf/open/floor/plating/airless,
/area/shuttle/escape)
"aD" = (
/obj/structure/reflector/single/anchored,
/turf/open/floor/plating/airless,
/area/shuttle/escape)
"aE" = (
/obj/structure/reflector/double/anchored,
/turf/open/floor/plating/airless,
/area/shuttle/escape)
"aF" = (
/obj/structure/reflector/double{
	icon_state = "reflector_double";
	dir = 1;
	anchored = 1
	},
/turf/open/floor/plating/airless,
/area/shuttle/escape)
"aG" = (
/obj/structure/reflector/single{
	icon_state = "reflector";
	dir = 8;
	anchored = 1
	},
/turf/open/floor/plating/airless,
/area/shuttle/escape)
"aH" = (
/obj/effect/turf_decal/stripes/line{
	dir = 9
	},
/turf/open/floor/plating/airless,
/area/shuttle/escape)
"aI" = (
/obj/effect/turf_decal/stripes/line{
	dir = 1
	},
/turf/open/floor/plating/airless,
/area/shuttle/escape)
"aJ" = (
/obj/effect/turf_decal/stripes/line{
	dir = 5
	},
/turf/open/floor/plating/airless,
/area/shuttle/escape)
"aK" = (
/obj/effect/turf_decal/stripes/line{
	dir = 8
	},
/turf/open/floor/plating/airless,
/area/shuttle/escape)
"aL" = (
/obj/machinery/power/supermatter_shard/hugbox{
	anchored = 1;
	name = "anchored supermatter shard"
	},
/turf/open/floor/plating/airless,
/area/shuttle/escape)
"aM" = (
/obj/effect/turf_decal/stripes/line{
	dir = 4
	},
/turf/open/floor/plating/airless,
/area/shuttle/escape)
"aN" = (
/obj/effect/turf_decal/stripes/line{
	dir = 10
	},
/turf/open/floor/plating/airless,
/area/shuttle/escape)
"aO" = (
/obj/effect/turf_decal/stripes/line{
	dir = 2
	},
/turf/open/floor/plating/airless,
/area/shuttle/escape)
"aP" = (
/obj/effect/turf_decal/stripes/line{
	dir = 6
	},
/turf/open/floor/plating/airless,
/area/shuttle/escape)
"aQ" = (
/obj/machinery/power/emitter/energycannon{
	dir = 1
	},
/turf/open/floor/plating/airless,
/area/shuttle/escape)
"aR" = (
/obj/structure/chair,
/obj/effect/turf_decal/stripes/line{
	dir = 1
	},
/turf/open/floor/plating/airless,
/area/shuttle/escape)
"aS" = (
/obj/structure/shuttle/engine/heater,
/turf/open/floor/plating/airless,
/area/shuttle/escape)
"aT" = (
/obj/machinery/computer/emergency_shuttle,
/turf/open/floor/plating/airless,
/area/shuttle/escape)
"aU" = (
/obj/structure/shuttle/engine/propulsion,
/turf/open/floor/plating/airless,
/area/shuttle/escape)
"aV" = (
/obj/structure/grille,
/turf/open/floor/plating,
/area/shuttle/escape)
"aW" = (
/obj/structure/grille,
/obj/effect/turf_decal/stripes/line{
	dir = 8
	},
/turf/open/floor/plating,
/area/shuttle/escape)
"aX" = (
/obj/structure/grille,
/obj/effect/turf_decal/stripes/line{
	dir = 4
	},
/turf/open/floor/plating,
/area/shuttle/escape)
"aY" = (
/obj/structure/closet/radiation{
	anchored = 1
	},
/obj/item/clothing/glasses/meson/engine,
/obj/machinery/light{
	dir = 8
	},
/turf/open/floor/mineral/titanium/yellow,
/area/shuttle/escape)
"aZ" = (
/obj/structure/closet/radiation{
	anchored = 1
	},
/obj/item/clothing/glasses/meson/engine,
/obj/machinery/light{
	dir = 4
	},
/turf/open/floor/mineral/titanium/yellow,
/area/shuttle/escape)
"ba" = (
/obj/effect/turf_decal/stripes/line{
	dir = 8
	},
/obj/machinery/light{
	dir = 8
	},
/turf/open/floor/plating,
/area/shuttle/escape)
"bb" = (
/obj/effect/turf_decal/stripes/line{
	dir = 4
	},
/obj/machinery/light{
	dir = 4
	},
/turf/open/floor/plating,
/area/shuttle/escape)

(1,1,1) = {"
aa
aa
aa
aa
aa
aa
at
av
ab
az
at
aa
aa
aa
aa
aa
aa
aa
aa
aa
aa
aa
"}
(2,1,1) = {"
ad
ad
ac
ab
an
ac
au
ag
ax
ag
an
aa
aa
aD
aC
aH
aK
aN
aq
aQ
aS
aU
"}
(3,1,1) = {"
ab
ae
ae
aY
ae
ae
ae
ag
ag
ag
ac
aa
aa
aq
aa
aI
aL
aO
aq
aQ
aS
aU
"}
(4,1,1) = {"
ac
af
ag
ai
ao
ao
ao
ao
ao
ao
aA
at
aa
aq
aa
aJ
aM
aP
aa
aC
aa
aa
"}
(5,1,1) = {"
ac
ae
ah
aj
ap
ap
ap
aW
ap
ap
ba
ac
aq
aE
aa
aa
aC
aa
aa
aH
aK
aN
"}
(6,1,1) = {"
ac
ae
ah
ak
aq
aq
aV
aw
aV
aq
aq
aB
aC
aC
aC
aC
aC
aC
aC
aR
aT
aO
"}
(7,1,1) = {"
ac
ae
ah
al
ar
ar
ar
aX
ar
ar
bb
ac
aq
aF
aa
aa
aC
aa
aa
aJ
aM
aP
"}
(8,1,1) = {"
ac
af
ag
am
as
as
as
as
as
as
aA
at
aa
aq
aa
aH
aK
aN
aa
aC
aa
aa
"}
(9,1,1) = {"
ab
ae
ae
aZ
ae
ae
ae
ag
ag
ag
ac
aa
aa
aq
aa
aI
aL
aO
aq
aQ
aS
aU
"}
(10,1,1) = {"
ad
ad
ac
ab
an
ac
au
ag
ay
ag
an
aa
aa
aG
aC
aJ
aM
aP
aq
aQ
aS
aU
"}
(11,1,1) = {"
aa
aa
aa
aa
aa
aa
at
av
ab
av
at
aa
aa
aa
aa
aa
aa
aa
aa
aa
aa
aa
"}
