//MAP CONVERTED BY dmm2tgm.py THIS HEADER COMMENT PREVENTS RECONVERSION, DO NOT REMOVE
"aa" = (
/turf/template_noop,
/area/template_noop)
"ac" = (
/obj/basic/effect/spawner/structure/window/shuttle,
/turf/open/floor/plating,
/area/shuttle/escape)
"ad" = (
/turf/closed/wall/mineral/titanium,
/area/shuttle/escape)
"af" = (
/obj/basic/machinery/door/airlock/titanium{
	name = "Emergency Shuttle Airlock"
	},
/turf/open/floor/mineral/titanium/blue,
/area/shuttle/escape)
"ag" = (
/obj/basic/structure/sign/warning/nosmoking,
/turf/closed/wall/mineral/titanium,
/area/shuttle/escape)
"ah" = (
/obj/basic/machinery/door/airlock/titanium{
	name = "Emergency Shuttle Airlock"
	},
/obj/basic/docking_port/mobile/emergency{
	dir = 2;
	dwidth = 5;
	height = 14;
	name = "Meta emergency shuttle";
	width = 25
	},
/turf/open/floor/mineral/titanium/blue,
/area/shuttle/escape)
"al" = (
/obj/basic/structure/table,
/obj/basic/item/phone{
	pixel_x = -3;
	pixel_y = 3
	},
/obj/basic/item/cigbutt/cigarbutt{
	pixel_x = 5;
	pixel_y = -1
	},
/turf/open/floor/mineral/titanium/blue,
/area/shuttle/escape)
"am" = (
/obj/basic/machinery/computer/crew,
/turf/open/floor/mineral/titanium/blue,
/area/shuttle/escape)
"an" = (
/obj/basic/machinery/computer/security,
/turf/open/floor/mineral/titanium/blue,
/area/shuttle/escape)
"ao" = (
/obj/basic/structure/table,
/obj/basic/item/storage/firstaid/regular,
/turf/open/floor/mineral/titanium/blue,
/area/shuttle/escape)
"ap" = (
/obj/basic/structure/closet/emcloset,
/turf/open/floor/mineral/titanium/blue,
/area/shuttle/escape)
"aq" = (
/turf/open/floor/mineral/titanium/blue,
/area/shuttle/escape)
"ar" = (
/obj/basic/structure/chair/comfy/shuttle,
/turf/open/floor/mineral/titanium/blue,
/area/shuttle/escape)
"as" = (
/obj/basic/item/radio/intercom/directional/north,
/obj/basic/structure/chair/comfy/shuttle,
/obj/basic/machinery/light/directional/north,
/turf/open/floor/mineral/titanium/blue,
/area/shuttle/escape)
"at" = (
/obj/basic/item/clothing/suit/hazardvest{
	desc = "A high-visibility lifejacket complete with whistle and slot for oxygen tanks.";
	name = "emergency lifejacket"
	},
/obj/basic/item/clothing/suit/hazardvest{
	desc = "A high-visibility lifejacket complete with whistle and slot for oxygen tanks.";
	name = "emergency lifejacket"
	},
/obj/basic/item/clothing/suit/hazardvest{
	desc = "A high-visibility lifejacket complete with whistle and slot for oxygen tanks.";
	name = "emergency lifejacket"
	},
/obj/basic/item/clothing/suit/hazardvest{
	desc = "A high-visibility lifejacket complete with whistle and slot for oxygen tanks.";
	name = "emergency lifejacket"
	},
/obj/basic/item/clothing/suit/hazardvest{
	desc = "A high-visibility lifejacket complete with whistle and slot for oxygen tanks.";
	name = "emergency lifejacket"
	},
/obj/basic/item/tank/internals/emergency_oxygen{
	pixel_x = 3
	},
/obj/basic/item/tank/internals/emergency_oxygen{
	pixel_x = 3
	},
/obj/basic/item/tank/internals/emergency_oxygen{
	pixel_x = 3
	},
/obj/basic/item/tank/internals/emergency_oxygen{
	pixel_x = 3
	},
/obj/basic/item/tank/internals/emergency_oxygen{
	pixel_x = 3
	},
/obj/basic/item/clothing/mask/breath{
	pixel_x = -3;
	pixel_y = -3
	},
/obj/basic/item/clothing/mask/breath{
	pixel_x = -3;
	pixel_y = -3
	},
/obj/basic/item/clothing/mask/breath{
	pixel_x = -3;
	pixel_y = -3
	},
/obj/basic/item/clothing/mask/breath{
	pixel_x = -3;
	pixel_y = -3
	},
/obj/basic/item/clothing/mask/breath{
	pixel_x = -3;
	pixel_y = -3
	},
/obj/basic/item/clothing/head/hardhat/orange{
	name = "protective hat";
	pixel_y = 9
	},
/obj/basic/item/clothing/head/hardhat/orange{
	name = "protective hat";
	pixel_y = 9
	},
/obj/basic/item/clothing/head/hardhat/orange{
	name = "protective hat";
	pixel_y = 9
	},
/obj/basic/item/clothing/head/hardhat/orange{
	name = "protective hat";
	pixel_y = 9
	},
/obj/basic/item/clothing/head/hardhat/orange{
	name = "protective hat";
	pixel_y = 9
	},
/obj/basic/structure/closet/crate{
	name = "lifejackets"
	},
/turf/open/floor/mineral/titanium/blue,
/area/shuttle/escape)
"au" = (
/obj/basic/structure/shuttle/engine/propulsion{
	dir = 8
	},
/turf/open/floor/plating/airless,
/area/shuttle/escape)
"av" = (
/obj/basic/structure/shuttle/engine/heater{
	dir = 8
	},
/obj/basic/structure/window/reinforced{
	dir = 4
	},
/turf/open/floor/plating/airless,
/area/shuttle/escape)
"aw" = (
/obj/basic/structure/table,
/obj/basic/item/storage/fancy/donut_box,
/turf/open/floor/mineral/titanium/blue,
/area/shuttle/escape)
"ax" = (
/obj/basic/structure/chair/office{
	dir = 1
	},
/turf/open/floor/mineral/titanium/blue,
/area/shuttle/escape)
"ay" = (
/obj/basic/structure/table,
/obj/basic/item/restraints/handcuffs{
	pixel_y = 3
	},
/obj/basic/machinery/light/directional/east,
/turf/open/floor/mineral/titanium/blue,
/area/shuttle/escape)
"aA" = (
/obj/basic/structure/tank_dispenser/oxygen{
	layer = 2.7;
	pixel_x = -1;
	pixel_y = 2
	},
/turf/open/floor/mineral/titanium/blue,
/area/shuttle/escape)
"aB" = (
/obj/basic/machinery/computer/communications{
	dir = 4
	},
/turf/open/floor/mineral/titanium/blue,
/area/shuttle/escape)
"aC" = (
/obj/basic/structure/chair/office,
/turf/open/floor/mineral/titanium/blue,
/area/shuttle/escape)
"aE" = (
/obj/basic/structure/chair/comfy/shuttle{
	dir = 1
	},
/turf/open/floor/mineral/titanium/blue,
/area/shuttle/escape)
"aF" = (
/obj/basic/machinery/computer/emergency_shuttle{
	dir = 4
	},
/turf/open/floor/mineral/titanium/blue,
/area/shuttle/escape)
"aG" = (
/obj/basic/structure/chair/office{
	dir = 8
	},
/turf/open/floor/mineral/titanium/blue,
/area/shuttle/escape)
"aH" = (
/obj/basic/machinery/door/airlock/command/glass{
	name = "Cockpit";
	req_access_txt = "19"
	},
/turf/open/floor/mineral/titanium,
/area/shuttle/escape)
"aL" = (
/obj/basic/machinery/computer/station_alert{
	dir = 4
	},
/turf/open/floor/mineral/titanium/blue,
/area/shuttle/escape)
"aN" = (
/obj/basic/machinery/holopad,
/obj/basic/machinery/status_display/evac/directional/east,
/turf/open/floor/mineral/titanium,
/area/shuttle/escape)
"aO" = (
/obj/basic/structure/table,
/obj/basic/item/storage/toolbox/emergency{
	pixel_y = 3
	},
/turf/open/floor/mineral/titanium/blue,
/area/shuttle/escape)
"aP" = (
/obj/basic/structure/table,
/obj/basic/machinery/recharger{
	active_power_usage = 0;
	idle_power_usage = 0;
	pixel_y = 4;
	use_power = 0
	},
/turf/open/floor/mineral/titanium/blue,
/area/shuttle/escape)
"aQ" = (
/obj/basic/structure/table,
/obj/basic/item/paper_bin{
	pixel_x = -2;
	pixel_y = 8
	},
/obj/basic/item/radio/intercom/directional/south,
/turf/open/floor/mineral/titanium/blue,
/area/shuttle/escape)
"aR" = (
/obj/basic/structure/table,
/obj/basic/item/folder/blue,
/obj/basic/structure/extinguisher_cabinet/directional/south,
/turf/open/floor/mineral/titanium/blue,
/area/shuttle/escape)
"aS" = (
/obj/basic/item/radio/intercom/directional/south,
/obj/basic/structure/chair/comfy/shuttle{
	dir = 1
	},
/obj/basic/machinery/light/directional/south,
/turf/open/floor/mineral/titanium/blue,
/area/shuttle/escape)
"aT" = (
/obj/basic/structure/table,
/obj/basic/item/stack/medical/gauze,
/obj/basic/item/stack/medical/bruise_pack,
/obj/basic/item/stack/medical/ointment,
/obj/basic/machinery/light/directional/east,
/turf/open/floor/mineral/titanium/blue,
/area/shuttle/escape)
"aW" = (
/obj/basic/machinery/door/airlock/command{
	name = "Emergency Recovery Airlock";
	req_access_txt = "19"
	},
/obj/basic/effect/decal/cleanable/dirt,
/turf/open/floor/iron,
/area/shuttle/escape)
"aY" = (
/obj/basic/machinery/door/airlock/security/glass{
	name = "Brig";
	req_access_txt = "2"
	},
/turf/open/floor/mineral/plastitanium/red/brig,
/area/shuttle/escape/brig)
"aZ" = (
/obj/basic/machinery/door/airlock/medical/glass{
	name = "Escape Shuttle Infirmary"
	},
/turf/open/floor/mineral/titanium/white,
/area/shuttle/escape)
"ba" = (
/obj/basic/structure/sign/departments/medbay/alt,
/turf/closed/wall/mineral/titanium,
/area/shuttle/escape)
"bb" = (
/obj/basic/machinery/door/airlock/titanium{
	name = "Emergency Shuttle Cargo Bay Airlock"
	},
/obj/basic/effect/turf_decal/delivery,
/turf/open/floor/iron,
/area/shuttle/escape)
"bd" = (
/obj/basic/structure/chair/comfy/shuttle{
	dir = 4
	},
/obj/basic/effect/decal/cleanable/dirt,
/turf/open/floor/iron,
/area/shuttle/escape)
"be" = (
/obj/basic/effect/decal/cleanable/dirt,
/turf/open/floor/iron,
/area/shuttle/escape)
"bf" = (
/obj/basic/machinery/door/airlock/external{
	name = "Emergency Recovery Airlock"
	},
/obj/basic/effect/decal/cleanable/dirt,
/turf/open/floor/iron,
/area/shuttle/escape)
"bh" = (
/obj/basic/structure/chair/comfy/shuttle{
	dir = 4
	},
/turf/open/floor/mineral/plastitanium/red/brig,
/area/shuttle/escape/brig)
"bi" = (
/obj/basic/structure/chair/comfy/shuttle,
/turf/open/floor/mineral/plastitanium/red/brig,
/area/shuttle/escape/brig)
"bj" = (
/obj/basic/structure/table,
/obj/basic/item/defibrillator/loaded,
/turf/open/floor/mineral/titanium,
/area/shuttle/escape)
"bk" = (
/obj/basic/machinery/shower,
/turf/open/floor/mineral/titanium/white,
/area/shuttle/escape)
"bl" = (
/obj/basic/machinery/stasis,
/turf/open/floor/mineral/titanium,
/area/shuttle/escape)
"bm" = (
/obj/basic/structure/rack,
/obj/basic/item/crowbar,
/obj/basic/item/wrench,
/obj/basic/item/weldingtool,
/obj/basic/item/wirecutters,
/obj/basic/item/stack/cable_coil,
/obj/basic/effect/turf_decal/stripes/line{
	dir = 4
	},
/turf/open/floor/iron,
/area/shuttle/escape)
"bn" = (
/obj/basic/structure/reagent_dispensers/watertank,
/obj/basic/effect/turf_decal/delivery,
/turf/open/floor/iron,
/area/shuttle/escape)
"bo" = (
/obj/basic/structure/reagent_dispensers/fueltank,
/obj/basic/effect/turf_decal/delivery,
/obj/basic/machinery/light/directional/north,
/turf/open/floor/iron,
/area/shuttle/escape)
"bp" = (
/obj/basic/effect/turf_decal/delivery,
/turf/open/floor/iron,
/area/shuttle/escape)
"bq" = (
/obj/basic/machinery/recharge_station,
/obj/basic/effect/turf_decal/delivery,
/turf/open/floor/iron,
/area/shuttle/escape)
"bs" = (
/obj/basic/structure/chair/comfy/shuttle{
	dir = 8
	},
/turf/open/floor/mineral/plastitanium/red/brig,
/area/shuttle/escape/brig)
"bu" = (
/obj/basic/structure/table,
/obj/basic/item/reagent_containers/glass/bottle/epinephrine{
	pixel_x = 6
	},
/obj/basic/item/reagent_containers/glass/bottle/multiver{
	pixel_x = -3
	},
/obj/basic/item/reagent_containers/glass/bottle/epinephrine{
	pixel_x = -3;
	pixel_y = 8
	},
/obj/basic/item/reagent_containers/glass/bottle/multiver{
	pixel_x = 6;
	pixel_y = 8
	},
/obj/basic/item/reagent_containers/syringe/epinephrine{
	pixel_x = 3;
	pixel_y = -2
	},
/obj/basic/item/reagent_containers/syringe/epinephrine{
	pixel_x = 4;
	pixel_y = 1
	},
/obj/basic/item/reagent_containers/syringe/epinephrine{
	pixel_x = -2;
	pixel_y = 5
	},
/obj/basic/item/reagent_containers/syringe/epinephrine{
	pixel_x = 2;
	pixel_y = 8
	},
/turf/open/floor/mineral/titanium,
/area/shuttle/escape)
"bv" = (
/obj/basic/structure/rack,
/obj/basic/item/storage/toolbox/electrical{
	pixel_x = -3;
	pixel_y = 1
	},
/obj/basic/item/storage/toolbox/mechanical{
	pixel_y = -1
	},
/obj/basic/item/storage/toolbox/emergency{
	pixel_x = 3;
	pixel_y = -5
	},
/obj/basic/effect/turf_decal/stripes/line{
	dir = 4
	},
/turf/open/floor/iron,
/area/shuttle/escape)
"bw" = (
/obj/basic/item/cigbutt,
/obj/basic/effect/decal/cleanable/dirt,
/turf/open/floor/iron,
/area/shuttle/escape)
"by" = (
/obj/basic/machinery/suit_storage_unit/standard_unit,
/obj/basic/effect/decal/cleanable/dirt,
/turf/open/floor/iron,
/area/shuttle/escape)
"bz" = (
/obj/basic/structure/table/optable,
/obj/basic/item/surgical_drapes,
/obj/basic/machinery/light/directional/west,
/obj/basic/machinery/status_display/evac/directional/west,
/turf/open/floor/mineral/titanium,
/area/shuttle/escape)
"bA" = (
/obj/basic/effect/turf_decal/stripes/line{
	dir = 4
	},
/turf/open/floor/iron,
/area/shuttle/escape)
"bC" = (
/obj/basic/structure/reagent_dispensers/watertank,
/obj/basic/effect/decal/cleanable/dirt,
/turf/open/floor/iron,
/area/shuttle/escape)
"bD" = (
/obj/basic/structure/table,
/obj/basic/item/folder/red{
	pixel_x = 3
	},
/obj/basic/item/folder/white{
	pixel_x = -4;
	pixel_y = 2
	},
/obj/basic/item/radio/intercom/directional/south,
/obj/basic/item/book/manual/wiki/security_space_law{
	pixel_x = -4;
	pixel_y = 4
	},
/turf/open/floor/mineral/plastitanium/red/brig,
/area/shuttle/escape/brig)
"bE" = (
/obj/basic/structure/table,
/obj/basic/item/restraints/handcuffs{
	pixel_y = 3
	},
/turf/open/floor/mineral/plastitanium/red/brig,
/area/shuttle/escape/brig)
"bF" = (
/obj/basic/structure/table,
/obj/basic/machinery/recharger{
	active_power_usage = 0;
	idle_power_usage = 0;
	use_power = 0
	},
/turf/open/floor/mineral/plastitanium/red/brig,
/area/shuttle/escape/brig)
"bG" = (
/obj/basic/structure/table,
/obj/basic/item/storage/box/handcuffs{
	pixel_x = 2;
	pixel_y = 2
	},
/turf/open/floor/mineral/plastitanium/red/brig,
/area/shuttle/escape/brig)
"bH" = (
/obj/basic/structure/table,
/obj/basic/item/scalpel{
	pixel_y = 12
	},
/obj/basic/item/circular_saw,
/obj/basic/item/retractor{
	pixel_x = 4
	},
/obj/basic/item/hemostat{
	pixel_x = -4
	},
/obj/basic/item/clothing/gloves/color/latex,
/obj/basic/item/clothing/mask/surgical,
/obj/basic/item/radio/intercom/directional/west,
/obj/basic/item/surgicaldrill,
/obj/basic/item/cautery,
/turf/open/floor/mineral/titanium,
/area/shuttle/escape)
"bI" = (
/obj/basic/structure/sink,
/turf/open/floor/mineral/titanium/white,
/area/shuttle/escape)
"bJ" = (
/obj/basic/structure/table,
/obj/basic/item/storage/firstaid/fire,
/obj/basic/item/storage/firstaid/regular{
	pixel_x = 2;
	pixel_y = 3
	},
/turf/open/floor/mineral/titanium,
/area/shuttle/escape)
"bK" = (
/obj/basic/structure/table,
/obj/basic/item/storage/firstaid/toxin,
/obj/basic/item/storage/firstaid/o2{
	pixel_x = 3;
	pixel_y = 3
	},
/turf/open/floor/mineral/titanium,
/area/shuttle/escape)
"bM" = (
/obj/basic/structure/rack,
/obj/basic/item/tank/internals/oxygen/red,
/obj/basic/item/clothing/suit/fire/firefighter,
/obj/basic/item/clothing/mask/gas,
/obj/basic/item/clothing/head/hardhat/red,
/obj/basic/effect/turf_decal/stripes/line{
	dir = 4
	},
/turf/open/floor/iron,
/area/shuttle/escape)
"bN" = (
/obj/basic/machinery/space_heater,
/obj/basic/structure/extinguisher_cabinet/directional/south,
/obj/basic/effect/turf_decal/bot,
/turf/open/floor/iron,
/area/shuttle/escape)
"bO" = (
/obj/basic/structure/closet/crate{
	name = "emergency supplies crate"
	},
/obj/basic/item/storage/toolbox/emergency,
/obj/basic/item/storage/toolbox/emergency,
/obj/basic/item/flashlight/flare{
	pixel_x = 3;
	pixel_y = 3
	},
/obj/basic/item/flashlight/flare{
	pixel_x = -6;
	pixel_y = -2
	},
/obj/basic/item/crowbar,
/obj/basic/item/wrench,
/obj/basic/item/radio,
/obj/basic/effect/turf_decal/bot,
/turf/open/floor/iron,
/area/shuttle/escape)
"bP" = (
/obj/basic/structure/closet/crate/medical,
/obj/basic/item/storage/firstaid/regular,
/obj/basic/item/storage/firstaid/o2{
	pixel_x = 3;
	pixel_y = 3
	},
/obj/basic/item/storage/firstaid/toxin{
	pixel_x = -4;
	pixel_y = 3
	},
/obj/basic/item/healthanalyzer{
	pixel_x = 3;
	pixel_y = 3
	},
/obj/basic/item/lazarus_injector,
/obj/basic/effect/turf_decal/bot,
/mob/living/simple_animal/bot/medbot{
	name = "\improper emergency medibot";
	pixel_x = -3;
	pixel_y = 2
	},
/turf/open/floor/iron,
/area/shuttle/escape)
"bQ" = (
/obj/basic/item/radio/intercom/directional/south,
/obj/basic/machinery/portable_atmospherics/canister/oxygen,
/obj/basic/effect/turf_decal/bot,
/turf/open/floor/iron,
/area/shuttle/escape)
"bR" = (
/obj/basic/structure/table,
/obj/basic/item/clipboard,
/obj/basic/item/folder/yellow,
/obj/basic/item/pen,
/obj/basic/item/hand_labeler_refill,
/obj/basic/effect/turf_decal/bot,
/turf/open/floor/iron,
/area/shuttle/escape)
"bT" = (
/turf/closed/wall/mineral/titanium/nodiagonal,
/area/shuttle/escape)
"bU" = (
/turf/open/floor/mineral/plastitanium/red/brig,
/area/shuttle/escape/brig)
"bV" = (
/obj/basic/structure/chair/comfy/shuttle,
/obj/basic/machinery/light/directional/north,
/turf/open/floor/mineral/titanium/blue,
/area/shuttle/escape)
"bW" = (
/obj/basic/item/clothing/suit/hazardvest{
	desc = "A high-visibility lifejacket complete with whistle and slot for oxygen tanks.";
	name = "emergency lifejacket"
	},
/obj/basic/item/clothing/suit/hazardvest{
	desc = "A high-visibility lifejacket complete with whistle and slot for oxygen tanks.";
	name = "emergency lifejacket"
	},
/obj/basic/item/clothing/suit/hazardvest{
	desc = "A high-visibility lifejacket complete with whistle and slot for oxygen tanks.";
	name = "emergency lifejacket"
	},
/obj/basic/item/clothing/suit/hazardvest{
	desc = "A high-visibility lifejacket complete with whistle and slot for oxygen tanks.";
	name = "emergency lifejacket"
	},
/obj/basic/item/clothing/suit/hazardvest{
	desc = "A high-visibility lifejacket complete with whistle and slot for oxygen tanks.";
	name = "emergency lifejacket"
	},
/obj/basic/item/tank/internals/emergency_oxygen{
	pixel_x = 3
	},
/obj/basic/item/tank/internals/emergency_oxygen{
	pixel_x = 3
	},
/obj/basic/item/tank/internals/emergency_oxygen{
	pixel_x = 3
	},
/obj/basic/item/tank/internals/emergency_oxygen{
	pixel_x = 3
	},
/obj/basic/item/tank/internals/emergency_oxygen{
	pixel_x = 3
	},
/obj/basic/item/clothing/mask/breath{
	pixel_x = -3;
	pixel_y = -3
	},
/obj/basic/item/clothing/mask/breath{
	pixel_x = -3;
	pixel_y = -3
	},
/obj/basic/item/clothing/mask/breath{
	pixel_x = -3;
	pixel_y = -3
	},
/obj/basic/item/clothing/mask/breath{
	pixel_x = -3;
	pixel_y = -3
	},
/obj/basic/item/clothing/mask/breath{
	pixel_x = -3;
	pixel_y = -3
	},
/obj/basic/item/clothing/head/hardhat/orange{
	name = "protective hat";
	pixel_y = 9
	},
/obj/basic/item/clothing/head/hardhat/orange{
	name = "protective hat";
	pixel_y = 9
	},
/obj/basic/item/clothing/head/hardhat/orange{
	name = "protective hat";
	pixel_y = 9
	},
/obj/basic/item/clothing/head/hardhat/orange{
	name = "protective hat";
	pixel_y = 9
	},
/obj/basic/item/clothing/head/hardhat/orange{
	name = "protective hat";
	pixel_y = 9
	},
/obj/basic/structure/closet/crate{
	name = "lifejackets"
	},
/obj/basic/machinery/light/directional/east,
/turf/open/floor/mineral/titanium/blue,
/area/shuttle/escape)
"bX" = (
/obj/basic/machinery/light/directional/west,
/obj/basic/machinery/status_display/evac/directional/west,
/turf/open/floor/mineral/titanium/blue,
/area/shuttle/escape)
"bY" = (
/obj/basic/machinery/light/directional/east,
/turf/open/floor/mineral/titanium/blue,
/area/shuttle/escape)
"ca" = (
/obj/basic/structure/chair/comfy/shuttle{
	dir = 1
	},
/obj/basic/machinery/light/directional/south,
/turf/open/floor/mineral/titanium/blue,
/area/shuttle/escape)
"cb" = (
/obj/basic/machinery/light/small/directional/east,
/obj/basic/effect/decal/cleanable/dirt,
/turf/open/floor/iron,
/area/shuttle/escape)
"cc" = (
/obj/basic/machinery/light/directional/east,
/obj/basic/effect/decal/cleanable/dirt,
/turf/open/floor/iron,
/area/shuttle/escape)
"cd" = (
/obj/basic/structure/chair/comfy/shuttle{
	dir = 8
	},
/obj/basic/machinery/light/directional/east,
/obj/basic/structure/reagent_dispensers/peppertank/directional/east,
/turf/open/floor/mineral/plastitanium/red/brig,
/area/shuttle/escape/brig)
"qi" = (
/obj/basic/structure/chair/comfy/shuttle,
/obj/basic/machinery/vending/wallmed/directional/north{
	use_power = 0
	},
/turf/open/floor/mineral/titanium/blue,
/area/shuttle/escape)
"sd" = (
/obj/basic/structure/chair/comfy/shuttle,
/obj/basic/structure/extinguisher_cabinet/directional/north,
/turf/open/floor/mineral/titanium/blue,
/area/shuttle/escape)
"tZ" = (
/obj/basic/structure/chair/comfy/shuttle{
	dir = 4
	},
/obj/basic/machinery/status_display/evac/directional/west,
/turf/open/floor/mineral/plastitanium/red/brig,
/area/shuttle/escape/brig)
"Lk" = (
/obj/basic/structure/chair/comfy/shuttle{
	dir = 1
	},
/obj/basic/structure/extinguisher_cabinet/directional/south,
/turf/open/floor/mineral/titanium/blue,
/area/shuttle/escape)
"LY" = (
/turf/open/floor/mineral/titanium,
/area/shuttle/escape)
"Sb" = (
/obj/basic/structure/chair/comfy/shuttle{
	dir = 1
	},
/obj/basic/machinery/vending/wallmed/directional/south{
	use_power = 0
	},
/turf/open/floor/mineral/titanium/blue,
/area/shuttle/escape)
"TZ" = (
/obj/basic/structure/chair/comfy/shuttle{
	dir = 4
	},
/obj/basic/effect/decal/cleanable/dirt,
/obj/basic/structure/extinguisher_cabinet/directional/north,
/turf/open/floor/iron,
/area/shuttle/escape)
"Vs" = (
/turf/open/floor/mineral/titanium/white,
/area/shuttle/escape)

(1,1,1) = {"
aa
aa
au
au
au
ad
au
au
ad
au
au
au
aa
aa
"}
(2,1,1) = {"
aa
ad
av
av
av
ad
av
av
ad
av
av
av
ad
aa
"}
(3,1,1) = {"
ad
ad
ad
ad
ad
ad
ad
ad
ad
ad
ad
ad
ad
ad
"}
(4,1,1) = {"
ac
al
aw
aB
aF
aL
aO
aP
ad
TZ
bd
bd
bC
ac
"}
(5,1,1) = {"
ac
am
aq
aC
aG
ax
aq
aQ
ad
be
cc
be
be
bf
"}
(6,1,1) = {"
ac
an
ax
LY
LY
LY
aC
aR
ad
bf
bT
be
be
bf
"}
(7,1,1) = {"
ac
ao
ay
LY
LY
LY
bY
aq
aW
cb
ad
by
by
ac
"}
(8,1,1) = {"
ad
ad
ad
ad
aH
ad
ad
ad
ad
ad
ad
ad
ad
ad
"}
(9,1,1) = {"
ad
ap
bX
aq
LY
aq
bX
ap
ad
bh
bh
tZ
bD
ad
"}
(10,1,1) = {"
ac
LY
LY
LY
LY
LY
LY
LY
aY
bU
bU
bU
bE
ac
"}
(11,1,1) = {"
ad
ar
LY
aE
ac
ar
LY
aE
ac
bi
bU
bU
bF
ac
"}
(12,1,1) = {"
af
LY
LY
aE
ad
qi
LY
aE
ad
bi
cd
bs
bG
ad
"}
(13,1,1) = {"
ad
bV
LY
aE
ac
ar
LY
aS
ad
ad
ad
ad
ad
ad
"}
(14,1,1) = {"
af
LY
LY
Lk
ad
ar
LY
aE
ad
bj
bu
bz
bH
ad
"}
(15,1,1) = {"
ag
ar
LY
aE
ac
ar
LY
aE
ac
bk
Vs
Vs
bI
ac
"}
(16,1,1) = {"
ac
ar
LY
LY
LY
LY
LY
LY
aZ
Vs
Vs
Vs
bJ
ac
"}
(17,1,1) = {"
ac
ar
LY
aE
ac
ar
LY
aE
ac
bl
bl
Vs
bK
ad
"}
(18,1,1) = {"
ac
ar
LY
aE
ad
sd
LY
aE
ba
ad
ac
aZ
ba
ad
"}
(19,1,1) = {"
ad
as
LY
aE
ac
ar
LY
ca
ad
bm
bv
bA
bM
ad
"}
(20,1,1) = {"
ah
LY
LY
Sb
ad
ar
LY
aE
ac
bn
bw
be
bN
ad
"}
(21,1,1) = {"
ad
ar
LY
aE
ac
ar
LY
Lk
ad
bo
be
be
bO
ac
"}
(22,1,1) = {"
af
LY
LY
LY
LY
LY
LY
LY
bb
bp
be
bw
bP
ac
"}
(23,1,1) = {"
ad
LY
LY
LY
LY
LY
LY
LY
bb
bp
be
be
bQ
ad
"}
(24,1,1) = {"
ad
bW
aA
at
LY
aN
LY
aT
ag
bq
bp
bp
bR
ad
"}
(25,1,1) = {"
ad
ad
ac
ad
ac
ad
ac
ad
ad
ad
ac
ac
ad
ad
"}
