//MAP CONVERTED BY dmm2tgm.py THIS HEADER COMMENT PREVENTS RECONVERSION, DO NOT REMOVE 
"aa" = (
/turf/open/space,
/area/space)
"ab" = (
/turf/closed/wall/shuttle/smooth,
/area/shuttle/escape)
"ac" = (
/obj/structure/grille,
/obj/structure/window/shuttle/tinted,
/turf/open/floor/plating,
/area/shuttle/escape)
"ad" = (
/turf/open/floor/plasteel/green,
/area/shuttle/escape)
"ae" = (
/turf/open/floor/plasteel/darkgreen,
/area/shuttle/escape)
"af" = (
/obj/machinery/power/emitter/energycannon/magical,
/turf/open/floor/plasteel/darkgreen,
/area/shuttle/escape)
"ag" = (
/obj/structure/table/abductor/wabbajack/left,
/turf/open/floor/plasteel/darkgreen,
/area/shuttle/escape)
"ah" = (
/obj/structure/table/abductor/wabbajack/right,
/turf/open/floor/plasteel/darkgreen,
/area/shuttle/escape)
"ai" = (
/obj/structure/sign/biohazard,
/turf/closed/wall/shuttle{
	tag = "icon-swall8";
	icon_state = "swall8"
	},
/area/shuttle/escape)
"aj" = (
/obj/structure/barricade/wooden,
/obj/machinery/door/airlock/shuttle,
/turf/open/floor/plasteel/cult,
/area/shuttle/escape)
"ak" = (
/obj/structure/chair{
	dir = 4
	},
/turf/open/floor/plasteel/shuttle/red,
/area/shuttle/escape)
"al" = (
/turf/open/floor/plasteel/shuttle/red,
/area/shuttle/escape)
"am" = (
/obj/structure/chair{
	dir = 8
	},
/turf/open/floor/plasteel/shuttle/red,
/area/shuttle/escape)
"an" = (
/obj/structure/table/wood,
/obj/item/candle/infinite,
/turf/open/floor/plasteel/cult,
/area/shuttle/escape)
"ao" = (
/obj/structure/barricade/wooden,
/turf/open/floor/plasteel/cult,
/area/shuttle/escape)
"ap" = (
/turf/open/floor/plasteel/cult,
/area/shuttle/escape)
"aq" = (
/turf/open/floor/plasteel/shuttle{
	icon_state = "shuttlefloor3"
	},
/area/shuttle/escape)
"ar" = (
/obj/structure/table,
/obj/item/weapon/storage/firstaid/fire,
/obj/item/weapon/storage/firstaid/regular{
	pixel_x = 2;
	pixel_y = 3
	},
/obj/item/weapon/crowbar,
/turf/open/floor/plasteel/shuttle{
	icon_state = "shuttlefloor3"
	},
/area/shuttle/escape)
"as" = (
/obj/structure/grille,
/obj/structure/window/shuttle,
/turf/open/floor/plating,
/area/shuttle/escape)
"at" = (
/obj/machinery/flasher{
	id = "shuttle_flasher";
	pixel_x = -24;
	pixel_y = 6
	},
/obj/machinery/button/flasher{
	id = "shuttle_flasher";
	pixel_x = -24;
	pixel_y = -6
	},
/obj/structure/chair{
	dir = 4
	},
/turf/open/floor/plasteel/shuttle/red,
/area/shuttle/escape)
"au" = (
/obj/structure/chair/wood,
/turf/open/floor/plasteel/cult,
/area/shuttle/escape)
"av" = (
/obj/structure/chair,
/turf/open/floor/plasteel/shuttle{
	icon_state = "shuttlefloor3"
	},
/area/shuttle/escape)
"aw" = (
/obj/structure/chair{
	dir = 8
	},
/turf/open/floor/plasteel/shuttle{
	icon_state = "shuttlefloor3"
	},
/area/shuttle/escape)
"ax" = (
/obj/machinery/door/airlock/shuttle{
	name = "Emergency Shuttle Airlock";
	req_access_txt = "2"
	},
/turf/open/floor/plating,
/area/shuttle/escape)
"ay" = (
/obj/structure/table,
/obj/item/weapon/paper_bin,
/obj/item/weapon/pen{
	pixel_x = -2;
	pixel_y = 4
	},
/turf/open/floor/plasteel/shuttle{
	icon_state = "shuttlefloor3"
	},
/area/shuttle/escape)
"az" = (
/obj/machinery/computer/emergency_shuttle,
/turf/open/floor/plasteel/shuttle{
	icon_state = "shuttlefloor3"
	},
/area/shuttle/escape)
"aA" = (
/obj/structure/table,
/obj/item/weapon/coin/mythril,
/turf/open/floor/plasteel/shuttle{
	icon_state = "shuttlefloor3"
	},
/area/shuttle/escape)
"aB" = (
/obj/machinery/door/airlock/glass{
	name = "Emergency Shuttle Brig";
	req_access_txt = "2"
	},
/turf/open/floor/plasteel/shuttle,
/area/shuttle/escape)
"aC" = (
/obj/machinery/door/airlock/shuttle,
/turf/open/floor/plasteel/shuttle{
	icon_state = "shuttlefloor3"
	},
/area/shuttle/escape)
"aD" = (
/obj/machinery/door/airlock/shuttle{
	name = "Emergency Shuttle Airlock"
	},
/obj/docking_port/mobile/emergency{
	timid = 1;
	name = "NT Lepton Violet"
	},
/turf/open/floor/plating,
/area/shuttle/escape)
"aE" = (
/turf/open/floor/plasteel/shuttle,
/area/shuttle/escape)
"aF" = (
/obj/machinery/door/window/eastleft,
/turf/open/floor/plasteel/shuttle{
	icon_state = "shuttlefloor3"
	},
/area/shuttle/escape)
"aG" = (
/obj/structure/extinguisher_cabinet{
	pixel_x = 27;
	pixel_y = 0
	},
/obj/structure/table/glass,
/obj/item/weapon/storage/box/syringes{
	pixel_x = 3;
	pixel_y = 3
	},
/obj/item/weapon/storage/box/beakers,
/turf/open/floor/plasteel/shuttle{
	icon_state = "shuttlefloor3"
	},
/area/shuttle/escape)
"aH" = (
/turf/closed/wall/shuttle{
	icon_state = "swall3";
	dir = 2
	},
/area/shuttle/escape)
"aI" = (
/obj/structure/chair{
	dir = 4
	},
/turf/open/floor/plasteel/shuttle{
	icon_state = "shuttlefloor3"
	},
/area/shuttle/escape)
"aJ" = (
/obj/structure/chair{
	dir = 8
	},
/obj/structure/window/reinforced{
	dir = 4
	},
/turf/open/floor/plasteel/shuttle{
	icon_state = "shuttlefloor3"
	},
/area/shuttle/escape)
"aK" = (
/obj/machinery/sleeper{
	icon_state = "sleeper-open";
	dir = 4
	},
/turf/open/floor/plasteel/shuttle{
	icon_state = "shuttlefloor3"
	},
/area/shuttle/escape)
"aL" = (
/obj/structure/table/reinforced,
/turf/open/floor/plasteel/shuttle{
	icon_state = "shuttlefloor3"
	},
/area/shuttle/escape)
"aM" = (
/obj/machinery/chem_dispenser,
/turf/open/floor/plasteel/shuttle{
	icon_state = "shuttlefloor3"
	},
/area/shuttle/escape)
"aN" = (
/obj/structure/table,
/obj/item/weapon/storage/toolbox/mechanical,
/obj/item/weapon/storage/firstaid/regular{
	pixel_x = -1;
	pixel_y = 1
	},
/obj/item/weapon/wrench/medical,
/turf/open/floor/plasteel/shuttle{
	icon_state = "shuttlefloor3"
	},
/area/shuttle/escape)
"aO" = (
/turf/open/floor/plating,
/area/shuttle/escape)
"aP" = (
/obj/structure/chair/office/light{
	dir = 8
	},
/turf/open/floor/plasteel/shuttle{
	icon_state = "shuttlefloor3"
	},
/area/shuttle/escape)
"aQ" = (
/obj/machinery/chem_heater,
/turf/open/floor/plasteel/shuttle{
	icon_state = "shuttlefloor3"
	},
/area/shuttle/escape)
"aR" = (
/obj/machinery/chem_master,
/turf/open/floor/plasteel/shuttle{
	icon_state = "shuttlefloor3"
	},
/area/shuttle/escape)
"aS" = (
/obj/machinery/door/window/eastright,
/turf/open/floor/plasteel/shuttle{
	icon_state = "shuttlefloor3"
	},
/area/shuttle/escape)
"aT" = (
/obj/structure/table/glass,
/obj/item/weapon/reagent_containers/glass/bottle/epinephrine{
	pixel_x = 2;
	pixel_y = 2
	},
/obj/item/weapon/reagent_containers/glass/bottle/charcoal,
/turf/open/floor/plasteel/shuttle{
	icon_state = "shuttlefloor3"
	},
/area/shuttle/escape)
"aU" = (
/obj/machinery/door/airlock/glass,
/turf/open/floor/plasteel/shuttle,
/area/shuttle/escape)
"aV" = (
/obj/machinery/door/airlock/shuttle{
	name = "Emergency Shuttle Airlock"
	},
/turf/open/floor/plating,
/area/shuttle/escape)
"aW" = (
/turf/open/floor/plasteel/yellow,
/area/shuttle/escape)
"aX" = (
/turf/closed/wall/shuttle{
	tag = "icon-wall3 (WEST)";
	icon_state = "wall3";
	dir = 8
	},
/area/shuttle/escape)
"aY" = (
/turf/open/floor/plasteel/whitered,
/area/shuttle/escape)
"aZ" = (
/turf/closed/wall/shuttle{
	tag = "icon-swall_s9";
	icon_state = "swall_s9"
	},
/area/shuttle/escape)
"ba" = (
/obj/structure/cult/forge{
	desc = "A engine used in powering the shuttle.";
	name = "magma engine"
	},
/turf/open/floor/plasteel/yellow,
/area/shuttle/escape)
"bb" = (
/turf/closed/wall/shuttle{
	tag = "icon-gwall_space";
	icon_state = "gwall_space"
	},
/area/shuttle/escape)
"bc" = (
/turf/closed/wall/shuttle{
	tag = "icon-gwall_space (EAST)";
	icon_state = "gwall_space";
	dir = 4
	},
/area/shuttle/escape)
"bd" = (
/obj/structure/cult/forge{
	desc = "A engine used in powering the shuttle.";
	name = "magma engine"
	},
/turf/open/floor/plasteel/whitered,
/area/shuttle/escape)
"be" = (
/obj/structure/window/reinforced{
	dir = 1
	},
/turf/open/floor/plating/lava/smooth/airless,
/area/shuttle/escape)
"bf" = (
/obj/structure/shuttle/engine/heater,
/turf/open/floor/plating/lava/smooth/airless,
/area/shuttle/escape)
"bg" = (
/obj/structure/shuttle/engine/propulsion,
/turf/open/floor/plating/airless,
/area/shuttle/escape)
"bv" = (
/turf/closed/wall/shuttle{
	tag = "icon-swall_s5";
	icon_state = "swall_s5"
	},
/area/shuttle/escape)
"bu" = (
/turf/closed/wall/shuttle{
	tag = "icon-swall1";
	icon_state = "swall1"
	},
/area/shuttle/escape)
"bt" = (
/turf/closed/wall/shuttle{
	tag = "icon-swallc3";
	icon_state = "swallc3"
	},
/area/shuttle/escape)
"bs" = (
/turf/closed/wall/shuttle{
	tag = "icon-swall2";
	icon_state = "swall2"
	},
/area/shuttle/escape)
"br" = (
/turf/closed/wall/shuttle{
	tag = "icon-swall11";
	icon_state = "swall11"
	},
/area/shuttle/escape)
"bq" = (
/turf/closed/wall/shuttle{
	tag = "icon-swall8";
	icon_state = "swall8"
	},
/area/shuttle/escape)
"bp" = (
/turf/closed/wall/shuttle{
	tag = "icon-swall4";
	icon_state = "swall4"
	},
/area/shuttle/escape)
"bo" = (
/obj/structure/sign/biohazard,
/turf/closed/wall/shuttle{
	tag = "icon-swall4";
	icon_state = "swall4"
	},
/area/shuttle/escape)
"bn" = (
/turf/closed/wall/shuttle{
	tag = "icon-swall14";
	icon_state = "swall14"
	},
/area/shuttle/escape)
"bm" = (
/turf/closed/wall/shuttle{
	tag = "icon-swall12";
	icon_state = "swall12"
	},
/area/shuttle/escape)
"bl" = (
/turf/closed/wall/shuttle{
	tag = "icon-swall13";
	icon_state = "swall13"
	},
/area/shuttle/escape)
"bk" = (
/turf/closed/wall/shuttle{
	tag = "icon-swall_f5";
	icon_state = "swall_f5"
	},
/area/shuttle/escape)
"bj" = (
/turf/closed/wall/shuttle{
	tag = "icon-swall_f9";
	icon_state = "swall_f9"
	},
/area/shuttle/escape)
"bi" = (
/turf/closed/wall/shuttle{
	tag = "icon-swall_s10";
	icon_state = "swall_s10"
	},
/area/shuttle/escape)
"bh" = (
/turf/closed/wall/shuttle{
	tag = "icon-swall_s6";
	icon_state = "swall_s6"
	},
/area/shuttle/escape)

(1,1,1) = {"
aa
aa
aa
aa
bh
aH
aH
ax
bp
aD
bs
as
as
as
bt
aV
ab
aV
bs
aH
bv
aa
"}
(2,1,1) = {"
aa
bh
aH
aH
bl
ak
at
al
as
aE
aI
aI
aI
aE
bm
aE
aI
aW
ba
be
aX
bb
"}
(3,1,1) = {"
bh
bj
ag
ae
bm
al
al
al
aB
aE
aE
aE
aE
aE
bq
aE
aE
aW
aW
be
bf
bg
"}
(4,1,1) = {"
ac
ad
ae
ad
bm
am
am
am
as
aE
aJ
aJ
aJ
aE
aU
aE
aE
aE
aE
be
bf
bg
"}
(5,1,1) = {"
ac
ae
ad
ae
bn
aH
aH
aH
bl
aq
aK
aN
aK
aq
bp
aw
aw
aw
aw
be
bf
bg
"}
(6,1,1) = {"
ac
af
ad
ae
ai
an
au
ay
bm
aq
aq
aq
aq
aq
bn
aH
aH
aH
bu
be
bf
bg
"}
(7,1,1) = {"
ac
ae
ad
ae
aj
ao
au
az
bm
aF
aJ
aq
aJ
aS
as
aI
aI
aI
aI
be
bf
bg
"}
(8,1,1) = {"
ac
ad
ae
ad
bo
ap
av
aA
bq
aq
aL
aO
aL
aq
aU
aE
aE
aE
aE
be
bf
bg
"}
(9,1,1) = {"
bi
bk
ah
ae
bm
aq
aq
aq
aC
aq
aq
aP
aq
aq
as
av
aE
aY
aY
be
bf
bg
"}
(10,1,1) = {"
aa
bi
aH
aH
bl
ar
aw
aw
bp
aG
aM
aQ
aR
aT
as
av
aE
aY
bd
be
aX
bc
"}
(11,1,1) = {"
aa
aa
aa
aa
bi
as
aH
as
br
aH
aH
as
as
as
br
aH
aH
as
aH
aH
aZ
aa
"}
