//MAP CONVERTED BY dmm2tgm.py THIS HEADER COMMENT PREVENTS RECONVERSION, DO NOT REMOVE
"aa" = (
/turf/open/space,
/area/shuttle/transport)
"ab" = (
/obj/structure/shuttle/engine/propulsion{
	icon_state = "propulsion_l";
	dir = 4
	},
/turf/open/floor/plating/airless,
/area/shuttle/transport)
"ac" = (
/obj/structure/shuttle/engine/heater{
	icon_state = "heater";
	dir = 8
	},
/turf/open/floor/plating/airless,
/area/shuttle/transport)
"ad" = (
/turf/closed/wall/mineral/titanium,
/area/shuttle/transport)
"ae" = (
/turf/open/space,
/area/space)
"af" = (
/turf/closed/wall/r_wall,
/area/shuttle/transport)
"ag" = (
/turf/open/floor/plating/airless,
/area/shuttle/transport)
"ah" = (
/obj/structure/foamedmetal,
/turf/open/space,
/area/shuttle/transport)
"ai" = (
/obj/machinery/vending/liberationstation,
/turf/open/floor/mineral/titanium/blue,
/area/shuttle/transport)
"aj" = (
/obj/machinery/door/airlock/vault,
/turf/open/floor/plating/airless,
/area/shuttle/transport)
"ak" = (
/turf/open/floor/mineral/titanium/blue,
/area/shuttle/transport)
"al" = (
/obj/machinery/computer/shuttle/ferry/request,
/turf/open/floor/mineral/titanium/blue,
/area/shuttle/transport)
"am" = (
/obj/structure/grille{
	density = 0;
	icon_state = "brokengrille"
	},
/turf/open/floor/plating/airless,
/area/shuttle/transport)
"an" = (
/obj/structure/window/reinforced{
	dir = 8
	},
/obj/machinery/vending/autodrobe,
/turf/open/floor/mineral/titanium/blue,
/area/shuttle/transport)
"ao" = (
/obj/structure/mirror/magic/badmin{
	pixel_x = 30
	},
/turf/open/floor/mineral/titanium/blue,
/area/shuttle/transport)
"ap" = (
/turf/closed/wall,
/area/shuttle/transport)
"aq" = (
/obj/structure/window/reinforced{
	dir = 8
	},
/obj/machinery/vending/clothing,
/turf/open/floor/mineral/titanium/blue,
/area/shuttle/transport)
"ar" = (
/obj/structure/chair,
/turf/open/floor/wood,
/area/shuttle/transport)
"as" = (
/obj/structure/emergency_shield,
/turf/open/space,
/area/shuttle/transport)
"at" = (
/obj/machinery/door/airlock,
/turf/open/floor/plasteel/shuttle,
/area/shuttle/transport)
"au" = (
/turf/open/floor/wood,
/area/shuttle/transport)
"av" = (
/obj/machinery/door/airlock/wood,
/turf/open/floor/wood,
/area/shuttle/transport)
"aw" = (
/obj/structure/grille,
/obj/structure/window/shuttle,
/turf/closed/wall/shuttle/smooth,
/area/shuttle/transport)
"ax" = (
/turf/closed/wall/shuttle{
	icon_state = "swall12";
	dir = 2
	},
/area/shuttle/transport)
"ay" = (
/obj/structure/window/shuttle,
/obj/structure/grille,
/turf/open/floor/plating,
/area/shuttle/transport)
"az" = (
/obj/structure/grille,
/obj/structure/window/shuttle,
/turf/open/floor/plating,
/area/shuttle/transport)
"aA" = (
/turf/closed/wall/shuttle{
	icon_state = "swall_s10";
	dir = 2
	},
/area/shuttle/transport)
"aB" = (
/obj/structure/grille{
	density = 0;
	icon_state = "brokengrille"
	},
/obj/structure/window/fulltile,
/turf/open/floor/plasteel/shuttle,
/area/shuttle/transport)
"aC" = (
/obj/structure/table/wood,
/obj/structure/window/reinforced{
	dir = 4
	},
/turf/open/floor/wood,
/area/shuttle/transport)
"aD" = (
/turf/open/floor/carpet,
/area/shuttle/transport)
"aE" = (
/turf/open/floor/bluespace,
/area/shuttle/transport)
"aF" = (
/obj/machinery/vending/sovietsoda,
/turf/open/floor/mineral/titanium/blue,
/area/shuttle/transport)
"aG" = (
/obj/machinery/vending/snack,
/turf/open/floor/mineral/titanium/blue,
/area/shuttle/transport)
"aH" = (
/obj/machinery/newscaster{
	pixel_y = 30
	},
/turf/open/floor/mineral/titanium/blue,
/area/shuttle/transport)
"aI" = (
/obj/structure/bed,
/obj/item/weapon/bedsheet/wiz,
/turf/open/floor/mineral/titanium/blue,
/area/shuttle/transport)
"aJ" = (
/obj/structure/chair,
/turf/open/floor/mineral/titanium/blue,
/area/shuttle/transport)
"aK" = (
/obj/structure/table/wood,
/obj/item/device/flashlight/lamp/green,
/turf/open/floor/mineral/titanium/blue,
/area/shuttle/transport)
"aL" = (
/turf/closed/wall/rust,
/area/shuttle/transport)
"aM" = (
/turf/closed/wall/mineral/titanium/nodiagonal,
/area/shuttle/transport)
"aN" = (
/obj/machinery/power/grounding_rod{
	anchored = 1
	},
/turf/open/floor/mineral/titanium/blue,
/area/shuttle/transport)
"aO" = (
/obj/machinery/door/airlock/titanium,
/obj/docking_port/mobile{
	dir = 8;
	dwidth = 8;
	height = 27;
	id = "ferry";
	name = "The Lighthouse";
	roundstart_move = "ferry_away";
	timid = 1;
	port_angle = 180;
	width = 16
	},
/turf/open/floor/mineral/titanium/blue,
/area/shuttle/transport)
"aP" = (
/obj/machinery/vending/magivend,
/turf/open/floor/mineral/titanium/blue,
/area/shuttle/transport)
"aQ" = (
/obj/structure/grille,
/obj/structure/window/fulltile,
/turf/open/floor/plasteel/shuttle,
/area/shuttle/transport)
"aR" = (
/obj/structure/chair/office/dark{
	dir = 4
	},
/turf/open/floor/wood,
/area/shuttle/transport)
"aS" = (
/obj/structure/table/wood,
/obj/item/toy/crayon/spraycan,
/turf/open/floor/wood,
/area/shuttle/transport)
"aT" = (
/obj/structure/bed,
/obj/item/weapon/bedsheet/centcom,
/turf/open/floor/mineral/titanium/blue,
/area/shuttle/transport)
"aU" = (
/obj/structure/bed,
/obj/item/weapon/bedsheet/rainbow,
/turf/open/floor/mineral/titanium/blue,
/area/shuttle/transport)
"aV" = (
/obj/structure/closet/crate,
/turf/open/floor/mineral/titanium/blue,
/area/shuttle/transport)
"aW" = (
/obj/structure/chair{
	dir = 1
	},
/turf/open/floor/mineral/titanium/blue,
/area/shuttle/transport)
"aX" = (
/obj/structure/window/fulltile,
/turf/open/floor/mineral/titanium/blue,
/area/shuttle/transport)
"aY" = (
/obj/structure/grille,
/obj/structure/window/reinforced/fulltile,
/turf/closed/wall/shuttle/smooth,
/area/shuttle/transport)
"aZ" = (
/turf/closed/wall/mineral/titanium/overspace,
/area/shuttle/transport)
"ba" = (
/obj/machinery/conveyor{
	dir = 1;
	id = "garbage"
	},
/turf/open/floor/wood,
/area/shuttle/transport)
"bb" = (
/obj/machinery/conveyor{
	dir = 1;
	id = "garbage";
	layer = 2.5
	},
/turf/open/floor/wood,
/area/shuttle/transport)
"bc" = (
/obj/structure/table/wood,
/obj/structure/window/reinforced{
	dir = 4
	},
/obj/item/weapon/vending_refill/snack,
/turf/open/floor/wood,
/area/shuttle/transport)
"bd" = (
/obj/item/weapon/twohanded/required/kirbyplants/dead{
	desc = "It doesn't look very healthy...";
	name = "potted plant"
	},
/turf/open/floor/wood,
/area/shuttle/transport)
"be" = (
/obj/machinery/conveyor{
	dir = 4;
	id = "garbage"
	},
/turf/open/floor/wood,
/area/shuttle/transport)
"bf" = (
/obj/machinery/conveyor{
	dir = 4;
	id = "garbage"
	},
/obj/structure/plasticflaps,
/turf/open/floor/wood,
/area/shuttle/transport)
"bg" = (
/obj/machinery/conveyor{
	dir = 10;
	id = "garbage";
	verted = -1
	},
/turf/open/floor/wood,
/area/shuttle/transport)
"bh" = (
/obj/structure/foamedmetal,
/turf/open/floor/plating/airless,
/area/shuttle/transport)
"bi" = (
/obj/structure/shuttle/engine/heater,
/turf/open/floor/plating/airless,
/area/shuttle/transport)
"bj" = (
/obj/structure/shuttle/engine/propulsion{
	icon_state = "propulsion_r"
	},
/turf/open/floor/plating/airless,
/area/shuttle/transport)

(1,1,1) = {"
aa
af
aa
ag
aa
aa
ag
ag
aa
aa
aa
aa
aa
aa
ab
aa
"}
(2,1,1) = {"
aa
af
af
aj
af
af
aa
ag
aa
aa
ab
aa
aa
aa
ac
aa
"}
(3,1,1) = {"
ab
af
ag
ag
am
af
aa
ag
aa
ag
ac
ag
aa
ag
ag
aa
"}
(4,1,1) = {"
ac
af
ah
ah
an
aq
as
aB
as
as
aX
ah
ah
ah
bi
bj
"}
(5,1,1) = {"
ad
aM
ai
ak
ao
ak
ak
ak
ak
aP
aX
ba
be
bh
bi
bj
"}
(6,1,1) = {"
ae
ad
aM
al
ap
ap
at
ap
aL
aQ
ap
aL
be
bh
aM
ad
"}
(7,1,1) = {"
ae
ae
ad
ad
aM
ar
au
au
au
au
au
aL
bf
aM
ad
ae
"}
(8,1,1) = {"
ae
ae
ae
ae
ad
ar
au
au
au
aR
au
bb
bg
ad
ae
ae
"}
(9,1,1) = {"
ae
ae
ae
ae
ap
ap
av
aC
aC
aS
aC
bc
aM
ad
ae
ae
"}
(10,1,1) = {"
ae
ae
ae
ae
ae
ap
au
aD
aD
aD
aD
bd
ad
ae
ae
ae
"}
(11,1,1) = {"
ae
ae
ae
ae
ae
ap
ap
aD
aD
aD
aD
aM
ad
ae
ae
ae
"}
(12,1,1) = {"
ae
ae
ae
ae
ae
ae
ap
aD
aD
aD
aD
ad
ae
ae
ae
ae
"}
(13,1,1) = {"
ae
ae
ae
ae
ae
ae
ap
aE
aN
aE
aM
ad
ae
ae
ae
ae
"}
(14,1,1) = {"
ae
ae
ae
ae
ae
ae
aw
aE
aN
aE
ad
ae
ae
ae
ae
ae
"}
(15,1,1) = {"
ae
ae
ae
ae
ae
ae
aw
aE
aE
aE
ad
ae
ae
ae
ae
ae
"}
(16,1,1) = {"
ae
ae
ae
ae
ae
ae
ad
ak
aE
ak
aY
ae
ae
ae
ae
ae
"}
(17,1,1) = {"
ae
ae
ae
ae
ae
ae
ad
aF
aE
aT
aw
ae
ae
ae
ae
ae
"}
(18,1,1) = {"
ae
ae
ae
ae
ae
ae
ad
aG
aE
aU
ad
ae
ae
ae
ae
ae
"}
(19,1,1) = {"
ae
ae
ae
ae
ae
ae
ad
aH
aE
aV
ad
ae
ae
ae
ae
ae
"}
(20,1,1) = {"
ae
ae
ae
ae
ae
ae
ay
aI
aE
aW
ay
ae
ae
ae
ae
ae
"}
(21,1,1) = {"
ae
ae
ae
ae
ae
ae
ad
ak
aE
aW
ad
ae
ae
ae
ae
ae
"}
(22,1,1) = {"
ae
ae
ae
ae
ae
ae
ad
aJ
aE
aW
ad
ae
ae
ae
ae
ae
"}
(23,1,1) = {"
ae
ae
ae
ae
ae
ae
ad
aJ
aE
aW
ad
ae
ae
ae
ae
ae
"}
(24,1,1) = {"
ae
ae
ae
ae
ae
ae
az
aJ
aE
aW
az
ae
ae
ae
ae
ae
"}
(25,1,1) = {"
ae
ae
ae
ae
ae
ae
ad
aJ
aE
aW
ad
ae
ae
ae
ae
ae
"}
(26,1,1) = {"
ae
ae
ae
ae
ae
ae
ad
aK
aE
aW
ad
ae
ae
ae
ae
ae
"}
(27,1,1) = {"
ae
ae
ae
ae
ae
ae
ad
ay
aO
ay
ad
ae
ae
ae
ae
ae
"}
