//MAP CONVERTED BY dmm2tgm.py THIS HEADER COMMENT PREVENTS RECONVERSION, DO NOT REMOVE
"aJ" = (
/obj/machinery/suit_storage_unit/standard_unit{
	mask_type = /obj/item/clothing/mask/gas;
	storage_type = /obj/item/tank/internals/oxygen/yellow
	},
/obj/effect/turf_decal/siding/red{
	dir = 8
	},
/turf/open/floor/pod/dark,
/area/shuttle/hunter/russian)
"bg" = (
/obj/effect/turf_decal/bot,
/obj/structure/closet/crate/secure/weapon{
	name = "surplus crate"
	},
/obj/item/ammo_box/a762,
/obj/item/ammo_box/a762,
/obj/item/ammo_box/a762,
/obj/item/ammo_box/a762,
/obj/machinery/light/small/directional/west,
/turf/open/floor/pod/dark,
/area/shuttle/hunter/russian)
"bi" = (
/obj/machinery/computer/shuttle/hunter{
	dir = 8
	},
/turf/open/floor/mineral/plastitanium/red,
/area/shuttle/hunter/russian)
"bK" = (
/obj/structure/cable,
/obj/machinery/atmospherics/pipe/smart/manifold4w/supply/hidden{
	dir = 4
	},
/obj/effect/decal/cleanable/generic,
/turf/open/floor/mineral/plastitanium/red,
/area/shuttle/hunter/russian)
"bO" = (
/obj/effect/turf_decal/stripes/line,
/obj/machinery/light/small/directional/west,
/turf/open/floor/plating,
/area/shuttle/hunter/russian)
"bP" = (
/obj/effect/turf_decal/arrows{
	dir = 4
	},
/obj/machinery/atmospherics/pipe/smart/manifold4w/supply/hidden{
	dir = 4
	},
/turf/open/floor/mineral/plastitanium/red,
/area/shuttle/hunter/russian)
"cr" = (
/obj/effect/turf_decal/bot,
/obj/structure/reagent_dispensers/fueltank,
/obj/item/weldingtool/largetank,
/turf/open/floor/pod/dark,
/area/shuttle/hunter/russian)
"cM" = (
/obj/effect/turf_decal/siding/red/corner{
	dir = 1
	},
/turf/closed/wall/mineral/titanium/survival,
/area/shuttle/hunter/russian)
"cU" = (
/obj/machinery/atmospherics/pipe/smart/manifold4w/supply/hidden{
	dir = 4
	},
/obj/effect/decal/cleanable/dirt,
/turf/open/floor/mineral/plastitanium/red,
/area/shuttle/hunter/russian)
"cZ" = (
/obj/effect/decal/cleanable/dirt,
/obj/machinery/atmospherics/pipe/smart/manifold4w/supply/hidden{
	dir = 4
	},
/turf/open/floor/mineral/plastitanium/red,
/area/shuttle/hunter/russian)
"eL" = (
/obj/machinery/power/shuttle_engine/propulsion{
	dir = 8
	},
/turf/open/floor/plating/airless,
/area/shuttle/hunter/russian)
"eQ" = (
/obj/effect/mob_spawn/ghost_role/human/fugitive/russian{
	dir = 1
	},
/obj/effect/turf_decal/bot_red,
/obj/effect/decal/cleanable/dirt,
/turf/open/floor/pod/dark,
/area/shuttle/hunter/russian)
"fa" = (
/obj/effect/turf_decal/bot,
/obj/effect/decal/cleanable/dirt,
/obj/machinery/portable_atmospherics/canister/oxygen,
/obj/structure/sign/poster/contraband/communist_state{
	pixel_x = -32
	},
/turf/open/floor/pod/dark,
/area/shuttle/hunter/russian)
"fN" = (
/obj/effect/turf_decal/bot,
/obj/effect/decal/cleanable/dirt,
/obj/machinery/fugitive_capture,
/obj/structure/sign/poster/contraband/bountyhunters{
	pixel_x = -32
	},
/turf/open/floor/pod/dark,
/area/shuttle/hunter/russian)
"gp" = (
/obj/machinery/airalarm/all_access{
	dir = 4;
	pixel_x = 24
	},
/obj/machinery/suit_storage_unit/standard_unit{
	mask_type = /obj/item/clothing/mask/gas;
	storage_type = /obj/item/tank/internals/oxygen/yellow
	},
/obj/machinery/light/small/directional/east,
/obj/effect/turf_decal/siding/red{
	dir = 10
	},
/turf/open/floor/pod/dark,
/area/shuttle/hunter/russian)
"gv" = (
/obj/machinery/atmospherics/pipe/smart/manifold4w/supply/hidden{
	dir = 4
	},
/obj/structure/sign/poster/contraband/soviet_propaganda{
	pixel_x = -32
	},
/turf/open/floor/mineral/plastitanium,
/area/shuttle/hunter/russian)
"gU" = (
/obj/machinery/door/airlock/external/glass/ruin{
	id_tag = "russia_ship_bolt_n"
	},
/obj/effect/mapping_helpers/airlock/cutaiwire,
/obj/effect/mapping_helpers/airlock/cyclelink_helper{
	dir = 1
	},
/obj/effect/mapping_helpers/airlock/locked,
/turf/open/floor/pod/light,
/area/shuttle/hunter/russian)
"ho" = (
/obj/effect/decal/cleanable/dirt,
/obj/effect/decal/cleanable/blood/old,
/turf/open/floor/mineral/plastitanium,
/area/shuttle/hunter/russian)
"iV" = (
/turf/template_noop,
/area/template_noop)
"jL" = (
/obj/machinery/light/small/directional/south,
/obj/effect/turf_decal/stripes/line,
/obj/effect/decal/cleanable/dirt,
/obj/structure/rack,
/obj/item/binoculars,
/obj/machinery/button/door/directional/south{
	id = "russia_ship_bolt_s";
	name = "External Bolt Control";
	normaldoorcontrol = 1;
	specialfunctions = 4
	},
/turf/open/floor/mineral/plastitanium,
/area/shuttle/hunter/russian)
"jO" = (
/obj/machinery/door/airlock/security/glass{
	name = "Ship Support Systems"
	},
/obj/structure/cable,
/obj/machinery/atmospherics/pipe/smart/manifold4w/supply/hidden{
	dir = 4
	},
/obj/effect/mapping_helpers/airlock/cutaiwire,
/turf/open/floor/pod/light,
/area/shuttle/hunter/russian)
"kL" = (
/obj/effect/turf_decal/bot,
/obj/effect/decal/cleanable/dirt,
/obj/machinery/light/small/directional/west,
/obj/structure/kitchenspike,
/turf/open/floor/pod/dark,
/area/shuttle/hunter/russian)
"lx" = (
/obj/structure/table,
/obj/effect/turf_decal/siding/red{
	dir = 10
	},
/obj/machinery/light/small/directional/east,
/obj/item/storage/fancy/cigarettes/cigars,
/obj/item/storage/fancy/cigarettes/cigars/cohiba{
	pixel_y = 2
	},
/obj/item/lighter,
/turf/open/floor/pod/dark,
/area/shuttle/hunter/russian)
"lS" = (
/obj/machinery/computer/crew/syndie{
	dir = 8
	},
/turf/open/floor/mineral/plastitanium/red,
/area/shuttle/hunter/russian)
"pa" = (
/obj/machinery/atmospherics/pipe/smart/manifold4w/supply/hidden{
	dir = 4
	},
/obj/effect/decal/cleanable/dirt,
/turf/open/floor/mineral/plastitanium,
/area/shuttle/hunter/russian)
"pB" = (
/obj/machinery/door/airlock/external/glass/ruin{
	id_tag = "russia_ship_bolt_s"
	},
/obj/effect/mapping_helpers/airlock/cutaiwire,
/obj/effect/mapping_helpers/airlock/cyclelink_helper,
/obj/effect/mapping_helpers/airlock/locked,
/turf/open/floor/pod/light,
/area/shuttle/hunter/russian)
"qF" = (
/obj/machinery/atmospherics/pipe/smart/manifold4w/supply/hidden{
	dir = 4
	},
/obj/effect/turf_decal/siding/red,
/obj/effect/decal/cleanable/dirt,
/obj/machinery/meter,
/turf/open/floor/pod/dark,
/area/shuttle/hunter/russian)
"sR" = (
/obj/structure/cable,
/obj/machinery/atmospherics/pipe/smart/manifold4w/supply/hidden{
	dir = 4
	},
/obj/effect/turf_decal/siding/red,
/obj/effect/decal/cleanable/dirt,
/turf/open/floor/pod/dark,
/area/shuttle/hunter/russian)
"tj" = (
/turf/open/floor/mineral/plastitanium,
/area/shuttle/hunter/russian)
"uc" = (
/obj/machinery/atmospherics/pipe/smart/manifold4w/supply/hidden{
	dir = 4
	},
/obj/effect/mapping_helpers/airlock/cutaiwire,
/obj/machinery/door/airlock/security/glass{
	name = "Cockpit Access"
	},
/turf/open/floor/pod/light,
/area/shuttle/hunter/russian)
"vZ" = (
/obj/machinery/atmospherics/components/unary/vent_pump/on{
	dir = 1
	},
/obj/effect/turf_decal/stripes/line,
/turf/open/floor/mineral/plastitanium/red,
/area/shuttle/hunter/russian)
"wz" = (
/obj/effect/turf_decal/bot,
/obj/structure/reagent_dispensers/watertank,
/obj/machinery/light/small/directional/west,
/obj/item/soap,
/turf/open/floor/pod/dark,
/area/shuttle/hunter/russian)
"wF" = (
/obj/effect/turf_decal/bot_red,
/obj/effect/turf_decal/siding/red,
/obj/effect/decal/cleanable/dirt,
/obj/effect/mob_spawn/ghost_role/human/fugitive/russian/leader,
/turf/open/floor/pod/dark,
/area/shuttle/hunter/russian)
"xd" = (
/obj/effect/turf_decal/siding/red{
	dir = 1
	},
/obj/effect/decal/cleanable/dirt,
/turf/open/floor/pod/dark,
/area/shuttle/hunter/russian)
"ya" = (
/obj/machinery/door/airlock/security/glass{
	name = "Cargo Hold Access"
	},
/obj/machinery/atmospherics/pipe/smart/manifold4w/supply/hidden{
	dir = 4
	},
/obj/effect/mapping_helpers/airlock/cutaiwire,
/turf/open/floor/pod/light,
/area/shuttle/hunter/russian)
"yo" = (
/obj/effect/turf_decal/bot,
/obj/structure/mecha_wreckage/ripley,
/obj/item/book/manual/ripley_build_and_repair,
/turf/open/floor/pod/dark,
/area/shuttle/hunter/russian)
"yp" = (
/obj/structure/chair/comfy/shuttle{
	dir = 4
	},
/obj/effect/decal/cleanable/dirt,
/turf/open/floor/mineral/plastitanium/red,
/area/shuttle/hunter/russian)
"yr" = (
/obj/effect/mob_spawn/ghost_role/human/fugitive/russian{
	dir = 1
	},
/obj/effect/turf_decal/bot_red,
/obj/machinery/light/small/directional/south,
/turf/open/floor/pod/dark,
/area/shuttle/hunter/russian)
"zr" = (
/obj/effect/decal/cleanable/dirt/dust,
/obj/machinery/light/small/directional/north,
/obj/effect/turf_decal/stripes/line{
	dir = 1
	},
/obj/structure/rack,
/obj/item/wrench,
/obj/item/crowbar,
/obj/machinery/button/door/directional/north{
	id = "russia_ship_bolt_n";
	name = "External Bolt Control";
	normaldoorcontrol = 1;
	specialfunctions = 4
	},
/turf/open/floor/mineral/plastitanium,
/area/shuttle/hunter/russian)
"zQ" = (
/obj/machinery/atmospherics/components/tank/air,
/obj/effect/turf_decal/stripes/line,
/obj/machinery/light/small/directional/north,
/turf/open/floor/plating,
/area/shuttle/hunter/russian)
"Aq" = (
/obj/machinery/atmospherics/components/unary/vent_pump/on,
/obj/effect/turf_decal/stripes/line{
	dir = 1
	},
/turf/open/floor/mineral/plastitanium/red,
/area/shuttle/hunter/russian)
"CB" = (
/obj/machinery/atmospherics/components/unary/vent_pump/on{
	dir = 8
	},
/obj/effect/turf_decal/siding/red{
	dir = 1
	},
/obj/effect/decal/cleanable/dirt,
/turf/open/floor/pod/dark,
/area/shuttle/hunter/russian)
"Dh" = (
/obj/machinery/light/small/directional/north,
/obj/effect/turf_decal/stripes/line{
	dir = 1
	},
/obj/effect/decal/cleanable/dirt,
/obj/structure/closet/crate/critter{
	anchorable = 0;
	anchored = 1;
	desc = "A large wood and steel-reinforced crate.";
	name = "voytek's crate"
	},
/mob/living/simple_animal/hostile/bear{
	desc = "A very friendly yet still extremely menacing space-bear. Comrade until the end.";
	name = "Voytek"
	},
/obj/machinery/firealarm/directional/north,
/turf/open/floor/mineral/plastitanium,
/area/shuttle/hunter/russian)
"Dr" = (
/obj/effect/turf_decal/siding/red/corner{
	dir = 8
	},
/turf/closed/wall/mineral/titanium/survival,
/area/shuttle/hunter/russian)
"DK" = (
/obj/effect/turf_decal/bot,
/obj/effect/decal/cleanable/dirt,
/obj/structure/closet/crate/cardboard,
/obj/item/storage/box/drinkingglasses,
/obj/machinery/light/small/directional/west,
/obj/effect/decal/cleanable/dirt,
/obj/item/reagent_containers/cup/glass/bottle/vodka,
/obj/item/reagent_containers/cup/glass/bottle/vodka,
/obj/item/reagent_containers/cup/glass/bottle/vodka,
/obj/item/reagent_containers/cup/glass/bottle/vodka,
/obj/item/crowbar/large/old,
/obj/item/lighter/greyscale,
/turf/open/floor/pod/dark,
/area/shuttle/hunter/russian)
"Ej" = (
/obj/machinery/power/apc/auto_name/directional/east,
/obj/structure/cable,
/obj/machinery/suit_storage_unit/standard_unit{
	mask_type = /obj/item/clothing/mask/gas;
	storage_type = /obj/item/tank/internals/oxygen/yellow
	},
/obj/machinery/light/small/directional/east,
/obj/effect/turf_decal/siding/red{
	dir = 9
	},
/turf/open/floor/pod/dark,
/area/shuttle/hunter/russian)
"EK" = (
/obj/machinery/power/shuttle_engine/heater{
	dir = 8
	},
/obj/structure/window/reinforced/survival_pod{
	dir = 4
	},
/turf/open/floor/plating/airless,
/area/shuttle/hunter/russian)
"Fy" = (
/obj/structure/cable,
/obj/effect/turf_decal/stripes/line,
/obj/machinery/power/smes/engineering{
	charge = 1e+006
	},
/turf/open/floor/plating,
/area/shuttle/hunter/russian)
"FG" = (
/obj/effect/turf_decal/bot,
/obj/structure/closet/crate,
/obj/item/tank/internals/emergency_oxygen/engi,
/obj/item/tank/internals/emergency_oxygen/engi,
/obj/effect/decal/cleanable/dirt,
/obj/item/tank/internals/emergency_oxygen/engi,
/obj/item/clothing/mask/breath,
/obj/item/clothing/mask/breath,
/obj/item/clothing/mask/breath,
/obj/item/crowbar,
/obj/item/crowbar,
/turf/open/floor/pod/dark,
/area/shuttle/hunter/russian)
"FK" = (
/obj/machinery/light/small/directional/south,
/obj/effect/turf_decal/stripes/line,
/obj/effect/decal/cleanable/dirt,
/obj/machinery/firealarm/directional/south,
/obj/structure/closet/crate{
	icon_state = "crateopen"
	},
/turf/open/floor/mineral/plastitanium,
/area/shuttle/hunter/russian)
"Gh" = (
/obj/effect/decal/cleanable/dirt,
/turf/open/floor/mineral/plastitanium,
/area/shuttle/hunter/russian)
"Gu" = (
/obj/structure/cable,
/obj/machinery/atmospherics/pipe/smart/manifold4w/supply/hidden{
	dir = 4
	},
/turf/open/floor/mineral/plastitanium/red,
/area/shuttle/hunter/russian)
"IV" = (
/obj/structure/table,
/obj/item/reagent_containers/cup/glass/drinkingglass/shotglass{
	pixel_x = -4;
	pixel_y = 5
	},
/obj/item/reagent_containers/cup/glass/drinkingglass/shotglass{
	pixel_x = -4;
	pixel_y = 3
	},
/obj/item/reagent_containers/cup/glass/bottle/vodka/badminka{
	pixel_x = 6
	},
/obj/item/reagent_containers/cup/glass/drinkingglass/shotglass{
	pixel_x = -4
	},
/obj/effect/turf_decal/siding/red{
	dir = 9
	},
/obj/machinery/light/small/directional/east,
/turf/open/floor/pod/dark,
/area/shuttle/hunter/russian)
"Jh" = (
/obj/effect/turf_decal/stripes/line,
/obj/structure/rack,
/obj/item/storage/toolbox/mechanical{
	pixel_y = 4
	},
/obj/item/stack/sheet/mineral/plasma{
	amount = 10
	},
/obj/item/multitool,
/obj/machinery/light/small/directional/north,
/turf/open/floor/plating,
/area/shuttle/hunter/russian)
"JN" = (
/obj/machinery/computer/camera_advanced/syndie{
	dir = 8
	},
/turf/open/floor/mineral/plastitanium/red,
/area/shuttle/hunter/russian)
"JS" = (
/obj/docking_port/mobile{
	shuttle_id = "huntership";
	movement_force = list("KNOCKDOWN" = 0, "THROW" = 0);
	name = "hunter shuttle";
	rechargeTime = 1800
	},
/obj/docking_port/stationary{
	dwidth = 11;
	height = 16;
	shuttle_id = "pirate_home";
	name = "Deep Space";
	width = 17
	},
/obj/machinery/door/airlock/external/glass/ruin{
	id_tag = "russia_ship_bolt_s"
	},
/obj/effect/mapping_helpers/airlock/cutaiwire,
/obj/effect/mapping_helpers/airlock/cyclelink_helper{
	dir = 1
	},
/obj/effect/mapping_helpers/airlock/locked,
/turf/open/floor/plating,
/area/shuttle/hunter/russian)
"JU" = (
/obj/effect/decal/cleanable/dirt,
/obj/effect/turf_decal/loading_area{
	dir = 8
	},
/turf/open/floor/mineral/plastitanium,
/area/shuttle/hunter/russian)
"Ke" = (
/obj/effect/turf_decal/siding/red{
	dir = 1
	},
/obj/structure/mirror/directional/south,
/obj/structure/dresser,
/obj/item/razor{
	pixel_x = 5;
	pixel_y = 8
	},
/obj/machinery/light/small/directional/west,
/turf/open/floor/pod/dark,
/area/shuttle/hunter/russian)
"Lg" = (
/obj/structure/chair/comfy/shuttle{
	dir = 4
	},
/turf/open/floor/mineral/plastitanium/red,
/area/shuttle/hunter/russian)
"Lk" = (
/obj/machinery/atmospherics/components/unary/vent_pump/on{
	dir = 8
	},
/obj/effect/turf_decal/siding/red,
/obj/effect/decal/cleanable/dirt,
/turf/open/floor/pod/dark,
/area/shuttle/hunter/russian)
"LQ" = (
/obj/effect/turf_decal/siding/red,
/obj/effect/decal/cleanable/generic,
/turf/open/floor/pod/dark,
/area/shuttle/hunter/russian)
"LW" = (
/obj/effect/spawner/structure/window/survival_pod,
/turf/open/floor/plating,
/area/shuttle/hunter/russian)
"Me" = (
/turf/closed/wall/mineral/titanium/survival,
/area/shuttle/hunter/russian)
"MO" = (
/obj/effect/turf_decal/siding/red{
	dir = 1
	},
/obj/effect/decal/cleanable/dirt,
/obj/machinery/airalarm/all_access{
	dir = 1;
	pixel_y = 24
	},
/turf/open/floor/pod/dark,
/area/shuttle/hunter/russian)
"Nr" = (
/obj/machinery/atmospherics/pipe/smart/manifold4w/supply/hidden{
	dir = 4
	},
/obj/effect/mapping_helpers/airlock/cutaiwire,
/obj/machinery/door/airlock/security/glass{
	name = "Cargo Hold Access"
	},
/turf/open/floor/pod/light,
/area/shuttle/hunter/russian)
"QG" = (
/obj/machinery/door/airlock/external/glass/ruin{
	id_tag = "russia_ship_bolt_n"
	},
/obj/effect/mapping_helpers/airlock/cutaiwire,
/obj/effect/mapping_helpers/airlock/cyclelink_helper,
/obj/effect/mapping_helpers/airlock/locked,
/turf/open/floor/plating,
/area/shuttle/hunter/russian)
"Se" = (
/obj/effect/turf_decal/stripes/line{
	dir = 1
	},
/obj/machinery/light/small/directional/west,
/turf/open/floor/plating,
/area/shuttle/hunter/russian)
"SL" = (
/obj/machinery/atmospherics/pipe/smart/manifold4w/supply/hidden{
	dir = 4
	},
/obj/effect/turf_decal/siding/red{
	dir = 1
	},
/obj/effect/decal/cleanable/dirt,
/turf/open/floor/pod/dark,
/area/shuttle/hunter/russian)
"Th" = (
/obj/effect/mob_spawn/ghost_role/human/fugitive/russian{
	dir = 1
	},
/obj/effect/turf_decal/bot_red,
/obj/effect/decal/cleanable/dirt,
/obj/structure/sign/poster/contraband/kss13{
	pixel_y = -32
	},
/turf/open/floor/pod/dark,
/area/shuttle/hunter/russian)
"Ut" = (
/obj/machinery/door/airlock/security/glass{
	name = "Crew Storage"
	},
/obj/machinery/atmospherics/pipe/smart/manifold4w/supply/hidden{
	dir = 4
	},
/obj/effect/mapping_helpers/airlock/cutaiwire,
/turf/open/floor/pod/light,
/area/shuttle/hunter/russian)
"Uu" = (
/obj/effect/turf_decal/siding/red{
	dir = 1
	},
/obj/structure/closet/crate/secure/gear{
	name = "commandant's crate"
	},
/obj/effect/decal/cleanable/dirt,
/obj/item/gun/ballistic/automatic/pistol,
/obj/item/ammo_box/magazine/m9mm,
/obj/item/ammo_box/a762,
/obj/item/crowbar,
/turf/open/floor/pod/dark,
/area/shuttle/hunter/russian)
"UD" = (
/obj/machinery/atmospherics/components/unary/vent_pump/on{
	dir = 8
	},
/obj/structure/chair/comfy/shuttle{
	dir = 4
	},
/obj/effect/decal/cleanable/dirt,
/turf/open/floor/mineral/plastitanium/red,
/area/shuttle/hunter/russian)
"UV" = (
/obj/effect/turf_decal/arrows{
	dir = 4
	},
/obj/machinery/atmospherics/pipe/smart/manifold4w/supply/hidden{
	dir = 4
	},
/obj/effect/decal/cleanable/ash,
/turf/open/floor/mineral/plastitanium/red,
/area/shuttle/hunter/russian)
"Ww" = (
/obj/machinery/suit_storage_unit/standard_unit{
	mask_type = /obj/item/clothing/mask/gas;
	storage_type = /obj/item/tank/internals/oxygen/yellow
	},
/obj/effect/turf_decal/siding/red,
/obj/machinery/light/small/directional/west,
/turf/open/floor/pod/dark,
/area/shuttle/hunter/russian)
"WG" = (
/obj/structure/cable,
/obj/machinery/power/terminal{
	dir = 8
	},
/obj/machinery/power/port_gen/pacman{
	anchored = 1
	},
/obj/effect/turf_decal/stripes/line,
/obj/effect/decal/cleanable/dirt,
/obj/machinery/airalarm/all_access{
	dir = 1;
	pixel_y = 24
	},
/turf/open/floor/plating,
/area/shuttle/hunter/russian)
"WL" = (
/obj/machinery/door/airlock/security/glass{
	name = "Cockpit Access"
	},
/obj/machinery/atmospherics/pipe/smart/manifold4w/supply/hidden{
	dir = 4
	},
/obj/effect/mapping_helpers/airlock/cutaiwire,
/turf/open/floor/pod/light,
/area/shuttle/hunter/russian)
"Xu" = (
/obj/effect/turf_decal/bot,
/obj/structure/closet/crate/medical,
/obj/item/storage/medkit/ancient,
/obj/item/storage/medkit/ancient,
/obj/effect/decal/cleanable/dirt,
/turf/open/floor/pod/dark,
/area/shuttle/hunter/russian)
"XW" = (
/obj/machinery/atmospherics/pipe/smart/manifold4w/supply/hidden{
	dir = 4
	},
/turf/open/floor/mineral/plastitanium/red,
/area/shuttle/hunter/russian)
"Ys" = (
/obj/machinery/atmospherics/pipe/smart/manifold4w/supply/hidden{
	dir = 4
	},
/obj/machinery/airalarm/all_access{
	dir = 8;
	pixel_x = -24
	},
/obj/effect/decal/cleanable/dirt,
/turf/open/floor/mineral/plastitanium,
/area/shuttle/hunter/russian)
"Zf" = (
/obj/machinery/atmospherics/components/unary/vent_pump/on{
	dir = 4
	},
/turf/open/floor/mineral/plastitanium,
/area/shuttle/hunter/russian)
"Zu" = (
/obj/machinery/computer/camera_advanced/shuttle_docker/syndicate/hunter{
	dir = 8;
	x_offset = 0;
	y_offset = 3
	},
/obj/effect/decal/cleanable/dirt,
/turf/open/floor/mineral/plastitanium/red,
/area/shuttle/hunter/russian)
"ZG" = (
/obj/effect/decal/cleanable/dirt,
/turf/open/floor/mineral/plastitanium/red,
/area/shuttle/hunter/russian)

(1,1,1) = {"
iV
iV
iV
iV
iV
iV
Me
eL
eL
Me
iV
iV
iV
iV
iV
iV
"}
(2,1,1) = {"
Me
eL
eL
Me
Me
Me
Me
EK
EK
Me
Me
Me
Me
eL
eL
Me
"}
(3,1,1) = {"
Me
EK
EK
Me
Me
fa
DK
Xu
FG
bg
fN
Me
Me
EK
EK
Me
"}
(4,1,1) = {"
Me
zQ
qF
LW
kL
tj
Gh
Zf
Gh
ho
JU
wz
LW
xd
yr
Me
"}
(5,1,1) = {"
Me
Fy
sR
jO
Gu
Gu
bK
cU
XW
cZ
XW
XW
Ut
SL
eQ
Me
"}
(6,1,1) = {"
Me
WG
Lk
LW
cr
XW
Ej
aJ
aJ
gp
XW
yo
LW
CB
Th
Me
"}
(7,1,1) = {"
Me
Jh
LQ
Me
Me
ya
Me
LW
LW
Me
Nr
Me
Me
MO
yr
Me
"}
(8,1,1) = {"
Me
Me
Me
Me
Dh
XW
Me
iV
iV
Me
XW
jL
Me
Me
Me
Me
"}
(9,1,1) = {"
iV
QG
Se
gU
Aq
cU
LW
iV
iV
LW
cU
vZ
pB
bO
JS
iV
"}
(10,1,1) = {"
iV
Me
Me
Me
zr
UV
Me
iV
iV
Me
bP
FK
Me
Me
Me
iV
"}
(11,1,1) = {"
iV
iV
iV
Me
Me
WL
Me
LW
LW
Me
uc
Me
Me
iV
iV
iV
"}
(12,1,1) = {"
iV
iV
iV
Me
Ww
XW
Ys
pa
pa
gv
XW
Ke
Me
iV
iV
iV
"}
(13,1,1) = {"
iV
iV
iV
LW
wF
ZG
Lg
yp
UD
Lg
ZG
Uu
LW
iV
iV
iV
"}
(14,1,1) = {"
iV
iV
iV
Me
Dr
lx
lS
bi
Zu
JN
IV
cM
Me
iV
iV
iV
"}
(15,1,1) = {"
iV
iV
iV
iV
Me
Me
LW
LW
LW
LW
Me
Me
iV
iV
iV
iV
"}
