//MAP CONVERTED BY dmm2tgm.py THIS HEADER COMMENT PREVENTS RECONVERSION, DO NOT REMOVE
"ah" = (
/obj/item/stack/spacecash/c1,
/obj/machinery/atmospherics/pipe/smart/manifold4w/supply/hidden,
/turf/open/floor/plating,
/area/shuttle/hunter)
"am" = (
/obj/structure/closet/secure_closet/freezer/meat/open,
/obj/effect/decal/cleanable/dirt,
/obj/item/reagent_containers/hypospray/medipen/gore,
/obj/item/reagent_containers/hypospray/medipen/gore,
/turf/open/floor/iron/freezer,
/area/shuttle/hunter)
"aV" = (
/obj/effect/decal/cleanable/dirt,
/obj/effect/decal/cleanable/generic,
/obj/machinery/light/small/directional/east,
/turf/open/floor/engine,
/area/shuttle/hunter)
"bx" = (
/obj/effect/decal/cleanable/dirt,
/obj/item/broken_bottle,
/obj/machinery/atmospherics/pipe/smart/manifold4w/supply/hidden,
/turf/open/floor/iron,
/area/shuttle/hunter)
"bK" = (
/obj/machinery/atmospherics/components/unary/vent_pump/on,
/turf/open/floor/iron/kitchen/small,
/area/shuttle/hunter)
"bV" = (
/obj/machinery/computer/monitor{
	dir = 1
	},
/obj/effect/turf_decal/box/white,
/turf/open/floor/iron/dark/textured,
/area/shuttle/hunter)
"bX" = (
/obj/item/reagent_containers/blood,
/obj/machinery/light/directional/north,
/turf/open/floor/engine,
/area/shuttle/hunter)
"cp" = (
/obj/effect/mapping_helpers/broken_floor,
/obj/machinery/atmospherics/pipe/smart/manifold4w/supply/hidden,
/turf/open/floor/iron,
/area/shuttle/hunter)
"cM" = (
/obj/effect/decal/cleanable/dirt,
/obj/machinery/atmospherics/pipe/smart/manifold4w/supply/hidden,
/turf/open/floor/iron/grimy,
/area/shuttle/hunter)
"do" = (
/turf/open/floor/iron/stairs{
	dir = 4
	},
/area/shuttle/hunter)
"dq" = (
/obj/effect/mob_spawn/ghost_role/human/fugitive/bounty/psyker/seer{
	dir = 8
	},
/turf/open/floor/engine,
/area/shuttle/hunter)
"eq" = (
/obj/effect/decal/cleanable/dirt,
/obj/structure/rack,
/obj/structure/bedsheetbin,
/obj/machinery/light/dim/directional/south,
/turf/open/floor/iron/grimy,
/area/shuttle/hunter)
"eO" = (
/obj/machinery/light/cold/directional/west,
/turf/open/floor/carpet/black,
/area/shuttle/hunter)
"eZ" = (
/obj/structure/toiletbong{
	dir = 4
	},
/obj/effect/decal/cleanable/dirt,
/obj/effect/decal/cleanable/vomit/old,
/turf/open/floor/iron/freezer,
/area/shuttle/hunter)
"gj" = (
/obj/structure/table/wood/fancy/blue,
/obj/item/book/codex_gigas{
	pixel_y = 2
	},
/turf/open/floor/glass,
/area/shuttle/hunter)
"gl" = (
/obj/machinery/washing_machine,
/obj/effect/turf_decal/box/white,
/turf/open/floor/iron/dark/textured,
/area/shuttle/hunter)
"gA" = (
/obj/machinery/power/smes/engineering{
	charge = 1e+006
	},
/obj/structure/cable,
/obj/effect/decal/cleanable/dirt,
/turf/open/floor/plating,
/area/shuttle/hunter)
"gE" = (
/obj/effect/turf_decal/tile/dark_blue/diagonal_edge,
/obj/structure/table/reinforced/plasmarglass,
/obj/item/ammo_box/c38/match{
	pixel_x = -5;
	pixel_y = 4
	},
/obj/item/ammo_box/c38/match{
	pixel_x = -1;
	pixel_y = 4
	},
/obj/item/ammo_box/c38/match{
	pixel_x = 3;
	pixel_y = 4
	},
/obj/item/ammo_box/c38/match{
	pixel_x = -8
	},
/obj/item/ammo_box/c38/match{
	pixel_x = -4
	},
/obj/item/ammo_box/c38/match,
/turf/open/floor/iron/white/diagonal,
/area/shuttle/hunter)
"gW" = (
/obj/docking_port/stationary{
	dwidth = 11;
	height = 16;
	name = "Deep Space";
	shuttle_id = "pirate_home";
	width = 17
	},
/obj/docking_port/mobile{
	movement_force = list("KNOCKDOWN" = 0, "THROW" = 0);
	name = "hunter shuttle";
	rechargeTime = 1800;
	shuttle_id = "huntership"
	},
/turf/open/floor/catwalk_floor,
/area/shuttle/hunter)
"gY" = (
/obj/structure/curtain/bounty,
/turf/open/floor/grass,
/area/shuttle/hunter)
"ht" = (
/obj/effect/turf_decal/siding/thinplating_new/dark{
	dir = 1
	},
/turf/open/floor/grass,
/area/shuttle/hunter)
"hE" = (
/obj/effect/turf_decal/tile/dark_blue/diagonal_centre,
/obj/machinery/atmospherics/pipe/smart/manifold4w/supply/hidden,
/turf/open/floor/iron/white/diagonal,
/area/shuttle/hunter)
"jl" = (
/obj/machinery/atmospherics/pipe/smart/manifold4w/supply/hidden,
/obj/effect/decal/cleanable/dirt,
/turf/open/floor/carpet/black,
/area/shuttle/hunter)
"js" = (
/obj/machinery/atmospherics/pipe/smart/manifold4w/supply/hidden,
/obj/structure/cable,
/obj/effect/decal/cleanable/dirt,
/obj/effect/decal/cleanable/oil,
/turf/open/floor/plating,
/area/shuttle/hunter)
"jB" = (
/obj/machinery/atmospherics/pipe/smart/manifold4w/supply/hidden,
/turf/open/floor/iron/stairs{
	dir = 8
	},
/area/shuttle/hunter)
"ke" = (
/obj/effect/decal/cleanable/dirt,
/obj/effect/decal/cleanable/oil,
/obj/machinery/atmospherics/pipe/smart/manifold4w/supply/hidden,
/turf/open/floor/plating,
/area/shuttle/hunter)
"kN" = (
/obj/effect/decal/cleanable/dirt,
/obj/effect/decal/cleanable/generic,
/obj/structure/closet/crate/bin,
/obj/item/reagent_containers/syringe/contraband,
/obj/item/reagent_containers/syringe/contraband,
/obj/item/reagent_containers/syringe/contraband,
/obj/item/reagent_containers/syringe/contraband,
/obj/item/reagent_containers/syringe/contraband,
/obj/item/reagent_containers/syringe/contraband,
/obj/item/reagent_containers/syringe/contraband,
/obj/item/reagent_containers/syringe/contraband,
/obj/item/reagent_containers/syringe/contraband,
/obj/item/reagent_containers/syringe/contraband,
/obj/item/reagent_containers/syringe/contraband,
/obj/item/reagent_containers/syringe/contraband,
/obj/item/reagent_containers/syringe/contraband,
/obj/item/reagent_containers/syringe/contraband,
/obj/item/reagent_containers/syringe/contraband,
/obj/item/reagent_containers/syringe/contraband,
/obj/item/reagent_containers/syringe/contraband,
/obj/item/reagent_containers/syringe/contraband,
/turf/open/floor/iron,
/area/shuttle/hunter)
"lu" = (
/turf/open/floor/iron/kitchen/small,
/area/shuttle/hunter)
"lD" = (
/obj/machinery/atmospherics/pipe/smart/manifold4w/supply/hidden,
/obj/machinery/computer/slot_machine,
/obj/effect/decal/cleanable/wrapping,
/turf/open/floor/iron/grimy,
/area/shuttle/hunter)
"lI" = (
/obj/effect/turf_decal/tile/dark_blue/diagonal_centre,
/turf/open/floor/iron/white/diagonal,
/area/shuttle/hunter)
"mz" = (
/obj/effect/decal/cleanable/dirt,
/obj/structure/etherealball,
/turf/open/floor/engine,
/area/shuttle/hunter)
"mP" = (
/obj/effect/mapping_helpers/broken_floor,
/obj/item/storage/pill_bottle,
/turf/open/floor/plating,
/area/shuttle/hunter)
"mR" = (
/turf/open/floor/iron/stairs/right,
/area/shuttle/hunter)
"na" = (
/turf/closed/wall,
/area/shuttle/hunter)
"nc" = (
/obj/structure/cable,
/obj/effect/decal/cleanable/fuel_pool,
/obj/machinery/atmospherics/pipe/smart/manifold4w/supply/hidden,
/turf/open/floor/plating,
/area/shuttle/hunter)
"nk" = (
/obj/effect/mapping_helpers/broken_floor,
/turf/open/floor/plating,
/area/shuttle/hunter)
"no" = (
/obj/effect/turf_decal/siding/thinplating_new/dark{
	dir = 1
	},
/obj/structure/flora/bush/flowers_yw/style_random,
/turf/open/floor/grass,
/area/shuttle/hunter)
"nq" = (
/obj/structure/flora/bush/fullgrass/style_random,
/turf/open/floor/grass,
/area/shuttle/hunter)
"nB" = (
/obj/machinery/door/airlock/grunge{
	name = "Intelligence Training Room"
	},
/obj/effect/mapping_helpers/airlock/cutaiwire,
/obj/machinery/atmospherics/pipe/smart/manifold4w/supply/hidden,
/turf/open/floor/plating,
/area/shuttle/hunter)
"oL" = (
/obj/structure/lattice,
/turf/template_noop,
/area/shuttle/hunter)
"oN" = (
/obj/structure/chair/comfy/black{
	dir = 1
	},
/turf/open/floor/glass,
/area/shuttle/hunter)
"pb" = (
/obj/structure/chair/office/light{
	dir = 8
	},
/turf/open/floor/iron/kitchen/small,
/area/shuttle/hunter)
"pf" = (
/obj/item/stack/sheet/mineral/plasma/thirty,
/obj/effect/mapping_helpers/burnt_floor,
/turf/open/floor/plating,
/area/shuttle/hunter)
"pO" = (
/turf/open/floor/catwalk_floor,
/area/shuttle/hunter)
"qa" = (
/obj/effect/turf_decal/siding/thinplating_new/dark{
	dir = 1
	},
/obj/structure/flora/bush/flowers_pp/style_random,
/turf/open/floor/grass,
/area/shuttle/hunter)
"qz" = (
/obj/structure/curtain/cloth/fancy/mechanical{
	icon_state = "bounty-open";
	icon_type = "bounty";
	id = "fortune_tell"
	},
/turf/open/floor/glass,
/area/shuttle/hunter)
"rn" = (
/obj/machinery/door/airlock/grunge{
	name = "Sanctuary In The Garden Of Mind"
	},
/obj/effect/mapping_helpers/airlock/cutaiwire,
/turf/open/floor/plating,
/area/shuttle/hunter)
"rF" = (
/obj/structure/chair/office/light,
/turf/open/floor/iron/kitchen/small,
/area/shuttle/hunter)
"rS" = (
/obj/effect/mapping_helpers/broken_floor,
/turf/open/floor/iron,
/area/shuttle/hunter)
"sn" = (
/obj/machinery/door/airlock/grunge{
	name = "Fortune Telling"
	},
/obj/effect/mapping_helpers/airlock/cutaiwire,
/turf/open/floor/carpet/black,
/area/shuttle/hunter)
"sB" = (
/obj/machinery/light/small/directional/north,
/obj/machinery/atmospherics/components/unary/vent_pump/on{
	dir = 4
	},
/turf/open/floor/carpet/black,
/area/shuttle/hunter)
"sW" = (
/obj/machinery/atmospherics/pipe/smart/manifold4w/supply/hidden,
/turf/open/floor/iron/grimy,
/area/shuttle/hunter)
"td" = (
/obj/effect/decal/cleanable/dirt,
/obj/machinery/light/directional/east,
/obj/structure/sign/warning/vacuum/external/directional/east,
/turf/open/floor/iron/grimy,
/area/shuttle/hunter)
"tH" = (
/obj/effect/mapping_helpers/broken_floor,
/obj/machinery/atmospherics/pipe/smart/manifold4w/supply/hidden,
/turf/open/floor/plating,
/area/shuttle/hunter)
"tO" = (
/turf/open/floor/glass,
/area/shuttle/hunter)
"tT" = (
/obj/machinery/computer/camera_advanced/shuttle_docker/syndicate/hunter/psyker{
	dir = 4
	},
/obj/effect/turf_decal/box/white,
/turf/open/floor/iron/dark/textured,
/area/shuttle/hunter)
"uy" = (
/obj/machinery/atmospherics/pipe/smart/manifold4w/supply/hidden,
/obj/effect/decal/cleanable/dirt,
/turf/open/floor/iron/grimy,
/area/shuttle/hunter)
"uH" = (
/obj/machinery/light/cold/directional/east,
/turf/open/floor/carpet/black,
/area/shuttle/hunter)
"vu" = (
/obj/effect/mapping_helpers/airlock/cutaiwire,
/obj/machinery/door/airlock/grunge{
	name = "Bridge"
	},
/obj/machinery/atmospherics/pipe/smart/manifold4w/supply/hidden,
/turf/open/floor/iron,
/area/shuttle/hunter)
"vw" = (
/obj/effect/spawner/structure/window/reinforced/plasma,
/obj/machinery/door/poddoor/preopen{
	id = "psyker_bridge";
	name = "External Blast Door"
	},
/turf/open/floor/plating,
/area/shuttle/hunter)
"ws" = (
/obj/effect/turf_decal/tile/dark_blue/diagonal_edge,
/obj/structure/table/reinforced/plasmarglass,
/obj/item/storage/box/lethalshot{
	pixel_x = -2;
	pixel_y = 4
	},
/obj/item/storage/box/lethalshot{
	pixel_y = 2
	},
/obj/item/storage/box/lethalshot{
	pixel_x = 2
	},
/obj/item/gun/ballistic/shotgun/lethal{
	pixel_y = 4
	},
/turf/open/floor/iron/white/diagonal,
/area/shuttle/hunter)
"xa" = (
/obj/structure/cable,
/obj/machinery/power/terminal{
	dir = 8
	},
/obj/machinery/power/port_gen/pacman{
	anchored = 1
	},
/turf/open/floor/plating,
/area/shuttle/hunter)
"xp" = (
/obj/machinery/power/shuttle_engine/heater{
	dir = 4
	},
/obj/structure/window/reinforced/plasma/spawner/directional/west,
/turf/open/floor/plating/airless,
/area/shuttle/hunter)
"xs" = (
/obj/structure/table/wood/fancy/blue,
/obj/structure/tank_holder{
	anchored = 1;
	desc = "A metallic frame that can hold crystal balls. Comes with lights!";
	light_color = "#0074FF";
	light_power = 2;
	light_range = 3;
	name = "ball holder";
	pixel_y = 12
	},
/obj/item/food/gumball{
	alpha = 175;
	desc = "A colorful, sugary crystal ball.";
	name = "crystal ball";
	pixel_y = 8
	},
/turf/open/floor/glass,
/area/shuttle/hunter)
"xt" = (
/obj/effect/decal/cleanable/dirt,
/obj/machinery/door/airlock/maintenance_hatch{
	name = "Maintenance"
	},
/obj/effect/mapping_helpers/airlock/cutaiwire,
/turf/open/floor/plating,
/area/shuttle/hunter)
"yd" = (
/turf/template_noop,
/area/template_noop)
"yg" = (
/obj/effect/turf_decal/tile/dark_blue/diagonal_edge,
/turf/open/floor/iron/white/diagonal,
/area/shuttle/hunter)
"yq" = (
/obj/machinery/power/shuttle_engine/propulsion/left{
	dir = 4
	},
/turf/open/floor/plating/airless,
/area/shuttle/hunter)
"ys" = (
/turf/open/floor/grass,
/area/shuttle/hunter)
"yO" = (
/obj/structure/displaycase/noalert{
	start_showpiece_type = /obj/item/food/drug/moon_rock
	},
/turf/open/floor/iron/kitchen/small,
/area/shuttle/hunter)
"zi" = (
/obj/structure/railing{
	dir = 5
	},
/obj/effect/decal/cleanable/dirt,
/obj/item/kirbyplants/fern,
/turf/open/floor/plating,
/area/shuttle/hunter)
"zm" = (
/obj/structure/table/wood/fancy/blue,
/obj/item/trash/candle{
	pixel_y = 7
	},
/turf/open/floor/glass,
/area/shuttle/hunter)
"zq" = (
/obj/structure/table/wood/fancy/blue,
/obj/item/toy/cards/deck/tarot{
	pixel_y = 6
	},
/turf/open/floor/glass,
/area/shuttle/hunter)
"zX" = (
/obj/structure/tank_dispenser/oxygen,
/obj/machinery/light/small/directional/north,
/turf/open/floor/plating,
/area/shuttle/hunter)
"zY" = (
/obj/effect/turf_decal/box/white,
/obj/machinery/fugitive_capture/psyker,
/turf/open/floor/iron/dark/textured,
/area/shuttle/hunter)
"AF" = (
/obj/effect/decal/cleanable/dirt,
/turf/open/floor/engine,
/area/shuttle/hunter)
"AH" = (
/obj/structure/rack,
/obj/item/storage/toolbox/mechanical,
/obj/item/storage/belt/utility,
/turf/open/floor/plating,
/area/shuttle/hunter)
"AZ" = (
/obj/machinery/atmospherics/components/unary/vent_pump/on,
/turf/open/floor/iron/grimy,
/area/shuttle/hunter)
"BY" = (
/obj/structure/table/wood/fancy/blue,
/obj/machinery/button/curtain{
	id = "fortune_tell";
	name = "Fortune Telling Curtains";
	pixel_y = 3
	},
/turf/open/floor/glass,
/area/shuttle/hunter)
"BZ" = (
/obj/structure/rack,
/obj/effect/decal/cleanable/dirt,
/obj/item/reagent_containers/cup/glass/bottle/hooch{
	pixel_x = -1;
	pixel_y = 11
	},
/obj/item/reagent_containers/cup/glass/ice/prison{
	pixel_x = 7;
	pixel_y = 2
	},
/obj/structure/sign/departments/security/directional/south,
/obj/item/reagent_containers/cup/glass/bottle/vodka/badminka{
	pixel_x = -3;
	pixel_y = 6
	},
/obj/item/reagent_containers/cup/glass/shaker{
	pixel_x = 9;
	pixel_y = 1
	},
/turf/open/floor/plating,
/area/shuttle/hunter)
"Ck" = (
/turf/open/floor/carpet/black,
/area/shuttle/hunter)
"CW" = (
/turf/closed/wall/r_wall,
/area/shuttle/hunter)
"De" = (
/obj/structure/curtain/cloth/fancy/mechanical/start_closed{
	icon_state = "bounty-closed";
	icon_type = "bounty";
	id = "fortune_tell"
	},
/obj/structure/fans/tiny,
/turf/open/floor/carpet/black,
/area/shuttle/hunter)
"Di" = (
/obj/machinery/door/airlock/external/glass/ruin{
	id_tag = "psykerexternal"
	},
/obj/effect/mapping_helpers/airlock/cutaiwire,
/obj/effect/mapping_helpers/airlock/locked,
/obj/effect/mapping_helpers/airlock/cyclelink_helper{
	dir = 4
	},
/turf/open/floor/plating,
/area/shuttle/hunter)
"Dw" = (
/obj/effect/turf_decal/tile/dark_blue/diagonal_centre,
/obj/machinery/atmospherics/components/unary/vent_pump/on{
	dir = 1
	},
/turf/open/floor/iron/white/diagonal,
/area/shuttle/hunter)
"Ea" = (
/obj/machinery/door/airlock/grunge{
	name = "Gear Storage"
	},
/obj/effect/mapping_helpers/airlock/cutaiwire,
/obj/machinery/atmospherics/pipe/smart/manifold4w/supply/hidden,
/turf/open/floor/iron/grimy,
/area/shuttle/hunter)
"En" = (
/obj/effect/decal/cleanable/dirt,
/obj/item/reagent_containers/syringe/contraband,
/obj/machinery/light/broken/directional/east,
/turf/open/floor/iron,
/area/shuttle/hunter)
"EM" = (
/obj/machinery/door/airlock/grunge{
	name = "Gear Storage"
	},
/obj/effect/mapping_helpers/airlock/cutaiwire,
/turf/open/floor/iron/grimy,
/area/shuttle/hunter)
"Gv" = (
/obj/machinery/power/apc/auto_name/directional/west,
/obj/structure/cable,
/obj/machinery/space_heater,
/obj/effect/decal/cleanable/dirt,
/obj/effect/decal/cleanable/cobweb,
/obj/effect/mapping_helpers/apc/cut_AI_wire,
/turf/open/floor/plating,
/area/shuttle/hunter)
"GS" = (
/obj/effect/turf_decal/box/white,
/obj/machinery/computer/shuttle/hunter{
	dir = 4
	},
/turf/open/floor/iron/dark/textured,
/area/shuttle/hunter)
"GT" = (
/obj/effect/turf_decal/tile/dark_blue/diagonal_edge,
/obj/machinery/atmospherics/pipe/smart/manifold4w/supply/hidden,
/turf/open/floor/iron/white/diagonal,
/area/shuttle/hunter)
"Hd" = (
/obj/effect/decal/cleanable/dirt,
/obj/machinery/light/small/directional/north,
/obj/machinery/atmospherics/pipe/smart/manifold4w/supply/hidden,
/turf/open/floor/plating,
/area/shuttle/hunter)
"Hp" = (
/obj/structure/rack,
/obj/item/paper/crumpled/fluff/fortune_teller,
/turf/open/floor/carpet/black,
/area/shuttle/hunter)
"Hq" = (
/obj/structure/chair/comfy/carp,
/turf/open/floor/glass,
/area/shuttle/hunter)
"HI" = (
/obj/effect/decal/cleanable/dirt,
/turf/open/floor/plating,
/area/shuttle/hunter)
"HO" = (
/obj/effect/mapping_helpers/broken_floor,
/obj/structure/bed/maint,
/turf/open/floor/iron,
/area/shuttle/hunter)
"Id" = (
/obj/machinery/atmospherics/pipe/smart/manifold4w/supply/hidden,
/turf/open/floor/iron/stairs/left,
/area/shuttle/hunter)
"Ih" = (
/obj/structure/rack,
/obj/item/stack/spacecash/c10,
/obj/item/stack/spacecash/c10,
/obj/item/stack/spacecash/c1,
/obj/item/stack/spacecash/c1,
/obj/item/stack/spacecash/c1,
/obj/item/stack/spacecash/c20,
/obj/item/stack/spacecash/c20,
/obj/effect/decal/cleanable/dirt,
/turf/open/floor/carpet/black,
/area/shuttle/hunter)
"Ik" = (
/obj/effect/decal/cleanable/dirt,
/turf/open/floor/iron/grimy,
/area/shuttle/hunter)
"IE" = (
/obj/effect/decal/cleanable/blood/old,
/obj/machinery/atmospherics/pipe/smart/manifold4w/supply/hidden,
/turf/open/floor/engine,
/area/shuttle/hunter)
"Ja" = (
/obj/effect/decal/cleanable/dirt,
/obj/item/reagent_containers/syringe/contraband,
/turf/open/floor/iron,
/area/shuttle/hunter)
"Jh" = (
/obj/effect/decal/cleanable/dirt,
/obj/effect/decal/cleanable/blood/old,
/obj/machinery/iv_drip,
/turf/open/floor/iron,
/area/shuttle/hunter)
"Jz" = (
/obj/machinery/door/airlock/grunge{
	name = "Freezer"
	},
/obj/effect/mapping_helpers/airlock/cutaiwire,
/obj/machinery/atmospherics/pipe/smart/manifold4w/supply/hidden,
/turf/open/floor/iron/freezer,
/area/shuttle/hunter)
"Kp" = (
/obj/structure/billboard/fortune_telling{
	pixel_y = 16
	},
/turf/open/floor/catwalk_floor,
/area/shuttle/hunter)
"Lc" = (
/obj/machinery/power/shuttle_engine/propulsion{
	dir = 4
	},
/turf/open/floor/plating/airless,
/area/shuttle/hunter)
"LI" = (
/obj/structure/rack,
/obj/item/megaphone,
/obj/item/storage/box/bodybags,
/obj/item/stack/package_wrap,
/obj/effect/turf_decal/box/white,
/obj/machinery/light/directional/east,
/turf/open/floor/iron/dark/textured,
/area/shuttle/hunter)
"Mc" = (
/obj/item/storage/pill_bottle,
/obj/structure/closet/crate/bin,
/obj/effect/decal/cleanable/plastic,
/turf/open/floor/iron/grimy,
/area/shuttle/hunter)
"Me" = (
/obj/structure/flora/bush/flowers_br/style_random,
/turf/open/floor/grass,
/area/shuttle/hunter)
"Mk" = (
/obj/effect/mapping_helpers/broken_floor,
/turf/open/floor/iron/freezer,
/area/shuttle/hunter)
"Nb" = (
/obj/machinery/light/directional/south,
/turf/open/floor/iron/dark/textured,
/area/shuttle/hunter)
"Ne" = (
/obj/machinery/atmospherics/components/unary/vent_pump/on{
	dir = 4
	},
/turf/open/floor/iron/freezer,
/area/shuttle/hunter)
"Nn" = (
/turf/closed/wall/space,
/area/shuttle/hunter)
"Nw" = (
/obj/structure/lattice,
/obj/effect/forcefield/psychic{
	initial_duration = 0
	},
/turf/template_noop,
/area/shuttle/hunter)
"NL" = (
/obj/machinery/suit_storage_unit/pirate,
/obj/effect/turf_decal/box/white,
/obj/effect/decal/cleanable/dirt,
/obj/structure/sign/departments/engineering/directional/south,
/turf/open/floor/iron/dark/textured,
/area/shuttle/hunter)
"NO" = (
/obj/effect/mob_spawn/ghost_role/human/fugitive/psykers,
/obj/machinery/light/floor,
/obj/structure/curtain/bounty,
/turf/open/floor/engine,
/area/shuttle/hunter)
"Oc" = (
/obj/effect/decal/cleanable/dirt,
/obj/machinery/light/small/directional/north,
/obj/item/reagent_containers/syringe/contraband,
/turf/open/floor/plating,
/area/shuttle/hunter)
"ON" = (
/obj/machinery/atmospherics/pipe/smart/manifold4w/supply/hidden,
/turf/open/floor/iron/stairs{
	dir = 4
	},
/area/shuttle/hunter)
"OS" = (
/obj/machinery/door/airlock/grunge{
	name = "Fortune Telling"
	},
/obj/effect/mapping_helpers/airlock/cutaiwire,
/obj/machinery/button/curtain{
	id = "fortune_tell";
	name = "Fortune Telling Curtains";
	pixel_x = -24
	},
/turf/open/floor/carpet/black,
/area/shuttle/hunter)
"Ph" = (
/obj/machinery/atmospherics/pipe/smart/manifold4w/supply/hidden,
/obj/machinery/door/airlock/maintenance_hatch{
	name = "Maintenance"
	},
/obj/effect/mapping_helpers/airlock/cutaiwire,
/turf/open/floor/plating,
/area/shuttle/hunter)
"Pv" = (
/obj/machinery/suit_storage_unit/pirate,
/obj/effect/turf_decal/box/white,
/obj/structure/sign/warning/vacuum/external/directional/east,
/turf/open/floor/iron/dark/textured,
/area/shuttle/hunter)
"Pz" = (
/obj/effect/forcefield/psychic{
	initial_duration = 0
	},
/obj/structure/lattice,
/turf/template_noop,
/area/shuttle/hunter)
"PA" = (
/obj/machinery/power/shuttle_engine/propulsion/right{
	dir = 4
	},
/turf/open/floor/plating/airless,
/area/shuttle/hunter)
"PD" = (
/obj/structure/rack,
/obj/item/clothing/shoes/laceup{
	pixel_x = -2
	},
/obj/item/clothing/suit/jacket/oversized{
	pixel_x = 4;
	pixel_y = 4
	},
/obj/item/clothing/under/suit/carpskin{
	pixel_y = 1
	},
/obj/item/cane,
/turf/open/floor/carpet/black,
/area/shuttle/hunter)
"PS" = (
/obj/effect/decal/cleanable/dirt,
/obj/effect/decal/cleanable/blood/old,
/turf/open/floor/plating,
/area/shuttle/hunter)
"PT" = (
/obj/effect/decal/cleanable/dirt,
/obj/effect/decal/cleanable/vomit/old,
/obj/structure/sign/departments/restroom/directional/west,
/turf/open/floor/plating,
/area/shuttle/hunter)
"QI" = (
/obj/effect/decal/cleanable/dirt,
/obj/machinery/light/small/directional/south,
/turf/open/floor/iron/freezer,
/area/shuttle/hunter)
"Rs" = (
/obj/machinery/atmospherics/pipe/smart/manifold4w/supply/hidden,
/obj/machinery/airalarm/directional/west,
/obj/effect/mapping_helpers/airalarm/all_access,
/obj/effect/decal/cleanable/dirt,
/obj/effect/decal/cleanable/robot_debris/up,
/turf/open/floor/plating,
/area/shuttle/hunter)
"RA" = (
/obj/effect/turf_decal/tile/dark_blue/diagonal_centre,
/obj/machinery/light/cold/directional/south,
/obj/item/statuebust,
/turf/open/floor/iron/white/diagonal,
/area/shuttle/hunter)
"RZ" = (
/obj/effect/decal/cleanable/dirt,
/turf/open/floor/carpet/black,
/area/shuttle/hunter)
"Ss" = (
/obj/effect/decal/cleanable/glass,
/turf/open/floor/engine,
/area/shuttle/hunter)
"SG" = (
/obj/effect/decal/cleanable/vomit/old,
/obj/item/stack/spacecash/c1{
	pixel_x = 5;
	pixel_y = -4
	},
/turf/open/floor/plating,
/area/shuttle/hunter)
"SI" = (
/obj/structure/rack,
/obj/item/storage/toolbox/electrical,
/obj/item/multitool,
/turf/open/floor/plating,
/area/shuttle/hunter)
"Te" = (
/obj/machinery/suit_storage_unit/pirate,
/obj/effect/turf_decal/box/white,
/obj/effect/decal/cleanable/dirt,
/turf/open/floor/iron/dark/textured,
/area/shuttle/hunter)
"Tj" = (
/obj/effect/decal/cleanable/vomit/old,
/obj/machinery/atmospherics/pipe/smart/manifold4w/supply/hidden,
/turf/open/floor/iron/grimy,
/area/shuttle/hunter)
"Tl" = (
/obj/effect/decal/cleanable/dirt,
/obj/effect/decal/cleanable/cobweb,
/obj/effect/decal/cleanable/garbage,
/turf/open/floor/plating,
/area/shuttle/hunter)
"Tw" = (
/obj/effect/turf_decal/arrows{
	dir = 4;
	pixel_y = -4
	},
/obj/effect/turf_decal/arrows{
	dir = 4;
	pixel_y = 4
	},
/turf/open/floor/iron/dark/textured,
/area/shuttle/hunter)
"TL" = (
/obj/machinery/button/door/directional/east{
	id = "psykerexternal";
	name = "External Bolt Control";
	normaldoorcontrol = 1;
	specialfunctions = 4
	},
/obj/effect/decal/cleanable/generic,
/turf/open/floor/iron/grimy,
/area/shuttle/hunter)
"Ui" = (
/obj/effect/turf_decal/tile/dark_blue/diagonal_edge,
/obj/structure/table/reinforced/plasmarglass,
/obj/item/gun/ballistic/revolver/c38{
	pixel_y = 3
	},
/obj/item/gun/ballistic/revolver/c38,
/turf/open/floor/iron/white/diagonal,
/area/shuttle/hunter)
"Vi" = (
/obj/effect/decal/cleanable/food/egg_smudge,
/turf/open/floor/plating,
/area/shuttle/hunter)
"Vw" = (
/obj/effect/decal/cleanable/dirt,
/obj/effect/decal/cleanable/generic,
/obj/machinery/atmospherics/pipe/smart/manifold4w/supply/hidden,
/turf/open/floor/iron,
/area/shuttle/hunter)
"VF" = (
/obj/structure/fans/tiny,
/obj/structure/curtain/cloth/fancy/mechanical/start_closed{
	icon_state = "bounty-closed";
	icon_type = "bounty";
	id = "fortune_tell"
	},
/turf/open/floor/carpet/black,
/area/shuttle/hunter)
"Ww" = (
/obj/machinery/light/floor,
/turf/open/floor/catwalk_floor,
/area/shuttle/hunter)
"Wy" = (
/obj/effect/mob_spawn/ghost_role/human/fugitive/psykers/captain,
/obj/machinery/light/floor,
/obj/structure/curtain/bounty,
/turf/open/floor/engine,
/area/shuttle/hunter)
"WL" = (
/obj/machinery/atmospherics/components/tank/air{
	dir = 1
	},
/obj/effect/decal/cleanable/dirt,
/turf/open/floor/plating,
/area/shuttle/hunter)
"WU" = (
/obj/effect/decal/cleanable/dirt,
/obj/item/reagent_containers/syringe/contraband,
/obj/machinery/atmospherics/components/unary/vent_pump/on{
	dir = 4
	},
/turf/open/floor/iron,
/area/shuttle/hunter)
"Xa" = (
/obj/machinery/button/door/directional/west{
	id = "psyker_bridge";
	name = "Blast Door Control"
	},
/turf/open/floor/iron/kitchen/small,
/area/shuttle/hunter)
"Xk" = (
/obj/structure/closet/crate/cardboard,
/turf/open/floor/iron/kitchen/small,
/area/shuttle/hunter)
"Xp" = (
/obj/structure/bouncy_castle{
	name = "Mark"
	},
/obj/effect/gibspawner/human,
/obj/effect/decal/cleanable/dirt,
/turf/open/floor/iron/freezer,
/area/shuttle/hunter)
"XX" = (
/obj/machinery/atmospherics/pipe/smart/manifold4w/supply/hidden,
/turf/open/floor/iron/kitchen/small,
/area/shuttle/hunter)
"Yq" = (
/obj/effect/decal/cleanable/dirt,
/obj/effect/decal/cleanable/glass,
/turf/open/floor/plating,
/area/shuttle/hunter)
"Ys" = (
/obj/machinery/atmospherics/pipe/smart/manifold4w/supply/hidden,
/obj/effect/decal/cleanable/dirt,
/obj/machinery/door/airlock/grunge{
	name = "Office"
	},
/turf/open/floor/iron/grimy,
/area/shuttle/hunter)
"Zb" = (
/obj/machinery/door/airlock/external/glass/ruin{
	id_tag = "psykerexternal"
	},
/obj/effect/mapping_helpers/airlock/cutaiwire,
/obj/effect/mapping_helpers/airlock/locked,
/obj/effect/mapping_helpers/airlock/cyclelink_helper{
	dir = 8
	},
/turf/open/floor/plating,
/area/shuttle/hunter)
"ZC" = (
/obj/effect/turf_decal/tile/dark_blue/diagonal_centre,
/obj/item/statuebust,
/turf/open/floor/iron/white/diagonal,
/area/shuttle/hunter)
"ZW" = (
/obj/effect/turf_decal/tile/dark_blue/diagonal_edge,
/obj/structure/table/reinforced/plasmarglass,
/obj/item/binoculars{
	pixel_x = -1
	},
/obj/item/knife/hunting{
	pixel_y = 3
	},
/obj/item/megaphone,
/obj/item/clothing/glasses/thermal/monocle{
	pixel_y = 2
	},
/turf/open/floor/iron/white/diagonal,
/area/shuttle/hunter)

(1,1,1) = {"
yd
yd
yd
yd
yd
Nw
Nw
Nw
Nw
Nw
Nw
Nw
Nw
yd
yd
yd
yd
yd
yd
yd
yd
yd
yd
yd
yd
"}
(2,1,1) = {"
yd
yd
yd
yd
yd
Nw
CW
vw
vw
vw
vw
CW
Nw
yd
yd
yd
yd
yd
yd
yd
yd
yd
yd
yd
yd
"}
(3,1,1) = {"
yd
Nw
Nw
Nw
Nw
Nw
CW
GS
tT
Xk
yO
CW
Nw
yd
yd
yd
yd
yd
yd
yd
yd
yd
yd
yd
yd
"}
(4,1,1) = {"
yd
Nw
yd
CW
vw
vw
CW
pb
lu
rF
Nb
CW
Nw
Nw
Nw
Nw
Nw
Nw
Nw
Nw
yd
yd
yd
yd
yd
"}
(5,1,1) = {"
yd
Nw
yd
CW
Tw
lu
Xa
bK
XX
rF
bV
CW
yd
oL
yd
yd
oL
yd
yd
Nw
yd
yd
yd
yd
yd
"}
(6,1,1) = {"
yd
Nw
oL
CW
zY
lu
lu
LI
XX
CW
CW
CW
CW
CW
CW
CW
CW
CW
yd
Nw
yd
yd
yd
yd
yd
"}
(7,1,1) = {"
yd
Nw
yd
CW
CW
CW
CW
CW
vu
CW
am
Xp
eZ
CW
ZW
ZC
ws
CW
oL
Pz
yd
yd
yd
yd
yd
"}
(8,1,1) = {"
yd
Nw
yd
CW
Tl
AF
kN
mP
Vw
na
Ne
Mk
QI
CW
lI
yg
RA
CW
yd
Pz
yd
yd
yd
yd
yd
"}
(9,1,1) = {"
yd
Nw
oL
CW
bX
rS
SG
WU
ke
na
Jz
na
CW
CW
GT
Dw
Ui
CW
yd
Pz
yd
yd
yd
yd
yd
"}
(10,1,1) = {"
yd
Nw
yd
CW
Jh
Yq
mz
IE
ah
PT
tH
bx
Ea
Id
hE
yg
RA
CW
oL
Pz
Pz
yd
yd
yd
yd
"}
(11,1,1) = {"
Nw
Nw
yd
CW
HO
PS
En
Vi
cp
aV
Ja
Ss
EM
mR
yg
lI
gE
CW
yd
yd
Pz
yd
yd
yd
yd
"}
(12,1,1) = {"
Nw
CW
CW
CW
na
na
na
na
nB
na
dq
BZ
CW
CW
CW
CW
CW
CW
CW
yd
Pz
Pz
Pz
yd
yd
"}
(13,1,1) = {"
Nw
CW
Nn
Nn
Nn
Nn
Nn
na
ON
na
na
na
na
Nn
Nn
Nn
Nn
Nn
CW
CW
CW
CW
Nw
Nw
oL
"}
(14,1,1) = {"
Nw
CW
Nn
NO
qa
nq
Nn
na
ON
na
Ih
Hp
na
Nn
BY
gj
tO
Nn
na
Ck
eO
VF
pO
pO
pO
"}
(15,1,1) = {"
Nw
CW
Nn
Wy
ht
Me
Nn
na
Hd
na
sB
RZ
OS
qz
Hq
xs
oN
qz
sn
Ck
Ck
De
pO
pO
gW
"}
(16,1,1) = {"
Nw
CW
Nn
NO
no
ys
Nn
na
jB
na
jl
PD
na
Nn
zm
zq
tO
Nn
na
Ck
uH
De
pO
pO
pO
"}
(17,1,1) = {"
Nw
CW
Nn
Nn
Nn
gY
Nn
na
jB
na
Ys
na
na
Nn
Nn
Nn
Nn
Nn
CW
CW
CW
CW
Nw
Nw
oL
"}
(18,1,1) = {"
Nw
CW
CW
CW
CW
rn
na
na
cM
gl
sW
eq
na
na
na
na
na
na
CW
yd
Nw
Nw
Nw
yd
yd
"}
(19,1,1) = {"
Nw
Nw
Nw
yd
CW
do
zi
na
Tj
cM
uy
Ik
Te
NL
na
Gv
Rs
WL
CW
Kp
Nw
yd
yd
yd
yd
"}
(20,1,1) = {"
yd
yd
Nw
yd
CW
Oc
nk
xt
Ik
AZ
lD
sW
sW
uy
Ph
js
nc
gA
CW
Ww
Nw
yd
yd
yd
yd
"}
(21,1,1) = {"
yd
yd
Nw
oL
CW
AH
SI
na
Mc
td
Ik
TL
Ik
Pv
na
zX
pf
xa
CW
pO
Nw
yd
yd
yd
yd
"}
(22,1,1) = {"
yd
yd
Nw
yd
CW
xp
xp
CW
CW
CW
Di
CW
Di
CW
CW
xp
xp
xp
CW
yd
Nw
yd
yd
yd
yd
"}
(23,1,1) = {"
yd
yd
Nw
Nw
Nw
PA
Lc
Nw
Nw
CW
HI
CW
HI
CW
Nw
PA
Lc
yq
Nw
Nw
Nw
yd
yd
yd
yd
"}
(24,1,1) = {"
yd
yd
yd
yd
yd
yd
yd
yd
Nw
CW
Zb
CW
Zb
CW
Nw
yd
yd
yd
yd
yd
yd
yd
yd
yd
yd
"}
(25,1,1) = {"
yd
yd
yd
yd
yd
yd
yd
yd
Nw
Nw
pO
pO
pO
Nw
Nw
yd
yd
yd
yd
yd
yd
yd
yd
yd
yd
"}
