//MAP CONVERTED BY dmm2tgm.py THIS HEADER COMMENT PREVENTS RECONVERSION, DO NOT REMOVE
"a" = (
/turf/closed/wall/mineral/titanium,
/area/shuttle/labor)
"b" = (
/obj/basic/effect/spawner/structure/window/shuttle,
/turf/open/floor/plating,
/area/shuttle/labor)
"c" = (
/obj/basic/machinery/computer/shuttle/labor{
	dir = 4
	},
/obj/basic/structure/reagent_dispensers/peppertank/directional/west,
/obj/basic/effect/turf_decal/bot,
/turf/open/floor/mineral/plastitanium,
/area/shuttle/labor)
"d" = (
/obj/basic/structure/chair/comfy/shuttle{
	dir = 1
	},
/turf/open/floor/mineral/plastitanium,
/area/shuttle/labor)
"e" = (
/obj/basic/structure/table,
/obj/basic/item/folder/red,
/obj/basic/item/restraints/handcuffs,
/turf/open/floor/mineral/plastitanium,
/area/shuttle/labor)
"f" = (
/obj/basic/effect/turf_decal/tile/neutral,
/obj/basic/effect/turf_decal/tile/neutral{
	dir = 1
	},
/obj/basic/effect/turf_decal/stripes/line{
	dir = 9
	},
/obj/basic/effect/turf_decal/stripes/corner,
/turf/open/floor/mineral/plastitanium/red,
/area/shuttle/labor)
"g" = (
/obj/basic/machinery/button/flasher{
	id = "gulagshuttleflasher";
	name = "Flash Control";
	pixel_y = -26;
	req_access_txt = "1"
	},
/obj/basic/machinery/light/directional/south,
/obj/basic/effect/turf_decal/tile/neutral,
/obj/basic/effect/turf_decal/tile/neutral{
	dir = 1
	},
/obj/basic/effect/turf_decal/stripes/line{
	dir = 1
	},
/obj/basic/effect/turf_decal/stripes/line,
/turf/open/floor/mineral/plastitanium/red,
/area/shuttle/labor)
"h" = (
/obj/basic/machinery/mineral/stacking_unit_console{
	machinedir = 2;
	pixel_x = 30;
	pixel_y = 30
	},
/obj/basic/effect/turf_decal/tile/neutral,
/obj/basic/effect/turf_decal/tile/neutral{
	dir = 1
	},
/obj/basic/effect/turf_decal/stripes/line{
	dir = 1
	},
/obj/basic/effect/turf_decal/stripes/line,
/turf/open/floor/mineral/plastitanium/red,
/area/shuttle/labor)
"i" = (
/obj/basic/machinery/door/airlock/titanium{
	name = "Labor Shuttle Airlock";
	req_access_txt = "2"
	},
/obj/basic/effect/turf_decal/stripes/line{
	dir = 4
	},
/obj/basic/effect/turf_decal/stripes/line{
	dir = 8
	},
/turf/open/floor/mineral/plastitanium,
/area/shuttle/labor)
"j" = (
/obj/basic/machinery/door/airlock/titanium{
	name = "Labor Shuttle Airlock";
	req_access_txt = "2"
	},
/obj/basic/effect/turf_decal/stripes/line,
/obj/basic/effect/turf_decal/stripes/line{
	dir = 1
	},
/turf/open/floor/mineral/plastitanium,
/area/shuttle/labor)
"k" = (
/obj/basic/machinery/mineral/stacking_machine/laborstacker{
	input_dir = 2;
	output_dir = 1
	},
/obj/basic/effect/turf_decal/stripes/line{
	dir = 8
	},
/obj/basic/effect/turf_decal/stripes/line{
	dir = 4
	},
/turf/open/floor/mineral/plastitanium,
/area/shuttle/labor)
"l" = (
/obj/basic/effect/turf_decal/tile/neutral,
/obj/basic/effect/turf_decal/tile/neutral{
	dir = 1
	},
/obj/basic/effect/turf_decal/stripes/line{
	dir = 8
	},
/obj/basic/effect/turf_decal/stripes/corner{
	dir = 4
	},
/turf/open/floor/mineral/plastitanium/red,
/area/shuttle/labor)
"m" = (
/obj/basic/machinery/light/directional/north,
/obj/basic/effect/turf_decal/tile/neutral,
/obj/basic/effect/turf_decal/tile/neutral{
	dir = 1
	},
/obj/basic/effect/turf_decal/stripes/line{
	dir = 1
	},
/turf/open/floor/mineral/plastitanium/red,
/area/shuttle/labor)
"n" = (
/obj/basic/machinery/mineral/labor_claim_console{
	machinedir = 1;
	pixel_x = 30
	},
/obj/basic/effect/turf_decal/tile/neutral,
/obj/basic/effect/turf_decal/tile/neutral{
	dir = 1
	},
/obj/basic/effect/turf_decal/stripes/line{
	dir = 5
	},
/turf/open/floor/mineral/plastitanium/red,
/area/shuttle/labor)
"o" = (
/obj/basic/effect/turf_decal/tile/neutral,
/obj/basic/effect/turf_decal/tile/neutral{
	dir = 1
	},
/obj/basic/structure/chair/comfy/shuttle{
	dir = 4
	},
/obj/basic/effect/turf_decal/stripes/line{
	dir = 10
	},
/turf/open/floor/mineral/plastitanium/red,
/area/shuttle/labor)
"p" = (
/obj/basic/effect/turf_decal/tile/neutral,
/obj/basic/effect/turf_decal/tile/neutral{
	dir = 1
	},
/obj/basic/effect/turf_decal/stripes/line,
/turf/open/floor/mineral/plastitanium/red,
/area/shuttle/labor)
"q" = (
/obj/basic/machinery/flasher/directional/east{
	id = "gulagshuttleflasher"
	},
/obj/basic/effect/turf_decal/tile/neutral,
/obj/basic/effect/turf_decal/tile/neutral{
	dir = 1
	},
/obj/basic/structure/chair/comfy/shuttle{
	dir = 8
	},
/obj/basic/effect/turf_decal/stripes/line{
	dir = 6
	},
/turf/open/floor/mineral/plastitanium/red,
/area/shuttle/labor)
"r" = (
/obj/basic/effect/turf_decal/tile/brown,
/obj/basic/effect/turf_decal/tile/brown{
	dir = 1
	},
/obj/basic/structure/closet/crate,
/obj/basic/effect/turf_decal/delivery,
/obj/basic/effect/turf_decal/stripes/line,
/turf/open/floor/mineral/titanium/yellow,
/area/shuttle/labor)
"s" = (
/obj/basic/effect/turf_decal/tile/brown,
/obj/basic/effect/turf_decal/tile/brown{
	dir = 1
	},
/obj/basic/effect/turf_decal/loading_area{
	dir = 4
	},
/obj/basic/effect/turf_decal/stripes/line,
/turf/open/floor/mineral/titanium/yellow,
/area/shuttle/labor)
"t" = (
/obj/basic/effect/turf_decal/tile/brown,
/obj/basic/effect/turf_decal/tile/brown{
	dir = 1
	},
/obj/basic/effect/turf_decal/stripes/line,
/turf/open/floor/mineral/titanium/yellow,
/area/shuttle/labor)
"u" = (
/obj/basic/machinery/door/airlock/titanium{
	id_tag = "prisonshuttle";
	name = "Labor Shuttle Airlock"
	},
/obj/basic/docking_port/mobile{
	dir = 8;
	dwidth = 2;
	height = 5;
	id = "laborcamp";
	name = "labor camp shuttle";
	port_direction = 4;
	width = 9
	},
/obj/basic/effect/turf_decal/stripes/line{
	dir = 4
	},
/obj/basic/effect/turf_decal/stripes/line{
	dir = 8
	},
/turf/open/floor/mineral/plastitanium,
/area/shuttle/labor)
"v" = (
/turf/closed/wall/mineral/titanium/nodiagonal,
/area/shuttle/labor)
"w" = (
/obj/basic/effect/spawner/structure/window/shuttle,
/obj/basic/structure/shuttle/engine/heater,
/turf/open/floor/plating,
/area/shuttle/labor)
"x" = (
/turf/closed/wall/mineral/plastitanium,
/area/shuttle/labor)
"y" = (
/obj/basic/structure/shuttle/engine/propulsion,
/turf/open/floor/plating/airless,
/area/shuttle/labor)

(1,1,1) = {"
a
a
b
a
b
a
b
v
x
"}
(2,1,1) = {"
b
c
f
j
l
o
r
w
y
"}
(3,1,1) = {"
b
d
g
a
m
p
s
w
y
"}
(4,1,1) = {"
b
e
h
k
n
q
t
w
y
"}
(5,1,1) = {"
a
a
i
a
a
a
u
v
x
"}
