//MAP CONVERTED BY dmm2tgm.py THIS HEADER COMMENT PREVENTS RECONVERSION, DO NOT REMOVE
"a" = (
/turf/template_noop,
/area/template_noop)
"b" = (
/obj/basic/effect/spawner/structure/window/shuttle,
/turf/open/floor/plating,
/area/shuttle/mining/large)
"c" = (
/obj/basic/structure/table/reinforced,
/obj/basic/item/storage/toolbox/emergency,
/obj/basic/effect/turf_decal/tile/brown,
/obj/basic/effect/turf_decal/tile/brown{
	dir = 1
	},
/obj/basic/effect/turf_decal/tile/brown{
	dir = 8
	},
/obj/basic/effect/decal/cleanable/dirt,
/turf/open/floor/iron/dark,
/area/shuttle/mining/large)
"d" = (
/obj/basic/machinery/computer/shuttle/mining,
/obj/basic/effect/turf_decal/tile/brown,
/obj/basic/effect/turf_decal/tile/brown{
	dir = 8
	},
/obj/basic/effect/turf_decal/bot_white,
/turf/open/floor/iron/dark,
/area/shuttle/mining/large)
"e" = (
/obj/basic/structure/table/reinforced,
/obj/basic/item/clothing/mask/gas,
/obj/basic/effect/turf_decal/tile/brown,
/obj/basic/effect/turf_decal/tile/brown{
	dir = 4
	},
/obj/basic/effect/turf_decal/tile/brown{
	dir = 8
	},
/obj/basic/item/tank/internals/emergency_oxygen,
/turf/open/floor/iron/dark,
/area/shuttle/mining/large)
"f" = (
/obj/basic/structure/table/reinforced,
/obj/basic/effect/turf_decal/tile/brown,
/obj/basic/effect/turf_decal/tile/brown{
	dir = 1
	},
/obj/basic/effect/turf_decal/tile/brown{
	dir = 4
	},
/obj/basic/item/storage/firstaid/regular,
/turf/open/floor/iron/dark,
/area/shuttle/mining/large)
"g" = (
/obj/basic/effect/turf_decal/tile/neutral,
/obj/basic/effect/turf_decal/tile/neutral{
	dir = 8
	},
/obj/basic/effect/turf_decal/tile/neutral{
	dir = 4
	},
/obj/basic/structure/chair/comfy/shuttle{
	dir = 1
	},
/obj/basic/effect/turf_decal/tile/brown{
	dir = 1
	},
/obj/basic/effect/turf_decal/bot_white,
/turf/open/floor/iron/dark,
/area/shuttle/mining/large)
"h" = (
/obj/basic/effect/turf_decal/tile/neutral,
/obj/basic/effect/turf_decal/tile/neutral{
	dir = 8
	},
/obj/basic/effect/turf_decal/tile/neutral{
	dir = 4
	},
/obj/basic/effect/turf_decal/tile/neutral{
	dir = 1
	},
/obj/basic/structure/chair/comfy/shuttle{
	dir = 1
	},
/obj/basic/effect/turf_decal/bot_white,
/turf/open/floor/iron/dark,
/area/shuttle/mining/large)
"i" = (
/obj/basic/effect/turf_decal/tile/neutral,
/obj/basic/effect/turf_decal/tile/neutral{
	dir = 8
	},
/obj/basic/effect/turf_decal/tile/neutral{
	dir = 1
	},
/obj/basic/structure/chair/comfy/shuttle{
	dir = 1
	},
/obj/basic/effect/turf_decal/tile/brown{
	dir = 4
	},
/obj/basic/effect/turf_decal/bot_white,
/turf/open/floor/iron/dark,
/area/shuttle/mining/large)
"j" = (
/obj/basic/structure/table/reinforced,
/obj/basic/effect/turf_decal/tile/brown{
	dir = 8
	},
/obj/basic/effect/turf_decal/tile/brown{
	dir = 1
	},
/obj/basic/effect/turf_decal/tile/brown{
	dir = 4
	},
/obj/basic/item/stack/ore/iron{
	pixel_x = 6;
	pixel_y = 4
	},
/obj/basic/item/stack/ore/iron{
	pixel_x = -2;
	pixel_y = -8
	},
/turf/open/floor/iron/dark,
/area/shuttle/mining/large)
"k" = (
/turf/closed/wall/mineral/titanium/nodiagonal,
/area/shuttle/mining/large)
"l" = (
/obj/basic/structure/table/reinforced,
/obj/basic/effect/turf_decal/tile/brown{
	dir = 8
	},
/obj/basic/effect/turf_decal/tile/brown,
/obj/basic/effect/turf_decal/tile/brown{
	dir = 4
	},
/obj/basic/item/folder/yellow,
/obj/basic/item/pen,
/obj/basic/effect/decal/cleanable/dirt,
/turf/open/floor/iron/dark,
/area/shuttle/mining/large)
"m" = (
/obj/basic/effect/turf_decal/tile/neutral,
/obj/basic/effect/turf_decal/tile/neutral{
	dir = 4
	},
/obj/basic/effect/turf_decal/tile/neutral{
	dir = 1
	},
/obj/basic/effect/turf_decal/stripes/white/corner,
/obj/basic/machinery/light/small/directional/south,
/obj/basic/effect/turf_decal/tile/brown{
	dir = 8
	},
/turf/open/floor/iron/dark,
/area/shuttle/mining/large)
"n" = (
/obj/basic/effect/turf_decal/tile/neutral,
/obj/basic/effect/turf_decal/tile/neutral{
	dir = 8
	},
/obj/basic/effect/turf_decal/tile/neutral{
	dir = 4
	},
/obj/basic/effect/turf_decal/tile/neutral{
	dir = 1
	},
/obj/basic/effect/turf_decal/stripes/white/line,
/turf/open/floor/iron/dark,
/area/shuttle/mining/large)
"o" = (
/obj/basic/effect/turf_decal/tile/neutral{
	dir = 8
	},
/obj/basic/effect/turf_decal/tile/neutral{
	dir = 4
	},
/obj/basic/effect/turf_decal/tile/neutral{
	dir = 1
	},
/obj/basic/effect/turf_decal/stripes/white/corner{
	dir = 8
	},
/obj/basic/machinery/light/small/directional/south,
/obj/basic/item/radio/intercom{
	pixel_y = -29
	},
/obj/basic/effect/turf_decal/tile/brown,
/obj/basic/effect/decal/cleanable/dirt,
/turf/open/floor/iron/dark,
/area/shuttle/mining/large)
"p" = (
/obj/basic/structure/table/reinforced,
/obj/basic/effect/turf_decal/tile/brown{
	dir = 8
	},
/obj/basic/effect/turf_decal/tile/brown,
/obj/basic/effect/turf_decal/tile/brown{
	dir = 1
	},
/obj/basic/effect/decal/cleanable/dirt,
/obj/basic/item/stock_parts/cell/high,
/obj/basic/item/screwdriver{
	pixel_y = 18
	},
/turf/open/floor/iron/dark,
/area/shuttle/mining/large)
"q" = (
/obj/basic/machinery/status_display/evac,
/turf/closed/wall/mineral/titanium/nodiagonal,
/area/shuttle/mining/large)
"r" = (
/obj/basic/effect/turf_decal/tile/neutral,
/obj/basic/effect/turf_decal/tile/neutral{
	dir = 8
	},
/obj/basic/effect/turf_decal/tile/neutral{
	dir = 4
	},
/obj/basic/effect/turf_decal/tile/neutral{
	dir = 1
	},
/obj/basic/machinery/door/airlock/mining{
	name = "Mining Shuttle Cockpit"
	},
/turf/open/floor/iron/dark,
/area/shuttle/mining/large)
"s" = (
/obj/basic/item/clothing/suit/hazardvest{
	desc = "A high-visibility lifejacket complete with whistle and slot for oxygen tanks.";
	name = "emergency lifejacket"
	},
/obj/basic/item/clothing/suit/hazardvest{
	desc = "A high-visibility lifejacket complete with whistle and slot for oxygen tanks.";
	name = "emergency lifejacket"
	},
/obj/basic/item/clothing/suit/hazardvest{
	desc = "A high-visibility lifejacket complete with whistle and slot for oxygen tanks.";
	name = "emergency lifejacket"
	},
/obj/basic/item/clothing/suit/hazardvest{
	desc = "A high-visibility lifejacket complete with whistle and slot for oxygen tanks.";
	name = "emergency lifejacket"
	},
/obj/basic/item/clothing/suit/hazardvest{
	desc = "A high-visibility lifejacket complete with whistle and slot for oxygen tanks.";
	name = "emergency lifejacket"
	},
/obj/basic/item/tank/internals/emergency_oxygen{
	pixel_x = 3
	},
/obj/basic/item/tank/internals/emergency_oxygen{
	pixel_x = 3
	},
/obj/basic/item/tank/internals/emergency_oxygen{
	pixel_x = 3
	},
/obj/basic/item/tank/internals/emergency_oxygen{
	pixel_x = 3
	},
/obj/basic/item/tank/internals/emergency_oxygen{
	pixel_x = 3
	},
/obj/basic/item/clothing/mask/breath{
	pixel_x = -3;
	pixel_y = -3
	},
/obj/basic/item/clothing/mask/breath{
	pixel_x = -3;
	pixel_y = -3
	},
/obj/basic/item/clothing/mask/breath{
	pixel_x = -3;
	pixel_y = -3
	},
/obj/basic/item/clothing/mask/breath{
	pixel_x = -3;
	pixel_y = -3
	},
/obj/basic/item/clothing/mask/breath{
	pixel_x = -3;
	pixel_y = -3
	},
/obj/basic/item/clothing/head/hardhat/orange{
	name = "protective hat";
	pixel_y = 9
	},
/obj/basic/item/clothing/head/hardhat/orange{
	name = "protective hat";
	pixel_y = 9
	},
/obj/basic/item/clothing/head/hardhat/orange{
	name = "protective hat";
	pixel_y = 9
	},
/obj/basic/item/clothing/head/hardhat/orange{
	name = "protective hat";
	pixel_y = 9
	},
/obj/basic/item/clothing/head/hardhat/orange{
	name = "protective hat";
	pixel_y = 9
	},
/obj/basic/structure/closet/crate/internals,
/obj/basic/item/pickaxe/emergency,
/obj/basic/item/pickaxe/emergency,
/obj/basic/effect/turf_decal/box/white/corners{
	dir = 1
	},
/turf/open/floor/iron/dark,
/area/shuttle/mining/large)
"t" = (
/obj/basic/effect/turf_decal/box/white/corners{
	dir = 4
	},
/turf/open/floor/iron/dark,
/area/shuttle/mining/large)
"u" = (
/obj/basic/effect/turf_decal/tile/neutral,
/obj/basic/effect/turf_decal/tile/neutral{
	dir = 8
	},
/obj/basic/effect/turf_decal/tile/neutral{
	dir = 4
	},
/obj/basic/effect/turf_decal/tile/neutral{
	dir = 1
	},
/obj/basic/effect/turf_decal/stripes/white/line{
	dir = 1
	},
/turf/open/floor/iron/dark,
/area/shuttle/mining/large)
"v" = (
/obj/basic/effect/turf_decal/box/white/corners{
	dir = 1
	},
/turf/open/floor/iron/dark,
/area/shuttle/mining/large)
"w" = (
/obj/basic/effect/turf_decal/box/white/corners{
	dir = 4
	},
/obj/basic/effect/decal/cleanable/dirt,
/obj/basic/structure/ore_box,
/turf/open/floor/iron/dark,
/area/shuttle/mining/large)
"x" = (
/obj/basic/effect/turf_decal/box/white/corners{
	dir = 8
	},
/obj/basic/effect/decal/cleanable/dirt,
/turf/open/floor/iron/dark,
/area/shuttle/mining/large)
"y" = (
/obj/basic/machinery/light/small/directional/south,
/obj/basic/effect/turf_decal/box/white/corners,
/turf/open/floor/iron/dark,
/area/shuttle/mining/large)
"z" = (
/obj/basic/effect/turf_decal/tile/neutral,
/obj/basic/effect/turf_decal/tile/neutral{
	dir = 8
	},
/obj/basic/effect/turf_decal/tile/neutral{
	dir = 4
	},
/obj/basic/effect/turf_decal/tile/neutral{
	dir = 1
	},
/obj/basic/effect/turf_decal/stripes/white/line,
/obj/basic/structure/cable,
/turf/open/floor/iron/dark,
/area/shuttle/mining/large)
"A" = (
/obj/basic/machinery/light/small/directional/south,
/obj/basic/effect/turf_decal/box/white/corners{
	dir = 8
	},
/obj/basic/structure/cable,
/turf/open/floor/iron/dark,
/area/shuttle/mining/large)
"B" = (
/obj/basic/effect/turf_decal/box/white/corners,
/obj/basic/structure/cable,
/turf/open/floor/iron/dark,
/area/shuttle/mining/large)
"C" = (
/obj/basic/effect/turf_decal/stripes/white/line{
	dir = 1
	},
/obj/basic/structure/rack,
/obj/basic/item/crowbar/red,
/obj/basic/item/wrench,
/obj/basic/item/flashlight,
/turf/open/floor/plating,
/area/shuttle/mining/large)
"D" = (
/obj/basic/machinery/door/airlock/external{
	name = "Mining Shuttle External Airlock"
	},
/obj/basic/effect/mapping_helpers/airlock/cyclelink_helper,
/obj/basic/structure/cable,
/turf/open/floor/plating,
/area/shuttle/mining/large)
"E" = (
/obj/basic/machinery/power/apc/auto_name/east,
/obj/basic/effect/turf_decal/stripes/white/line{
	dir = 1
	},
/obj/basic/effect/decal/cleanable/dirt,
/obj/basic/structure/cable,
/turf/open/floor/plating,
/area/shuttle/mining/large)
"F" = (
/turf/closed/wall/mineral/titanium,
/area/shuttle/mining/large)
"G" = (
/obj/basic/structure/shuttle/engine/heater,
/obj/basic/structure/window/reinforced{
	dir = 1;
	layer = 2.9
	},
/turf/open/floor/plating/airless,
/area/shuttle/mining/large)
"H" = (
/obj/basic/structure/sign/warning/vacuum/external{
	pixel_x = 32
	},
/obj/basic/structure/cable,
/turf/open/floor/plating,
/area/shuttle/mining/large)
"I" = (
/obj/basic/structure/shuttle/engine/propulsion,
/turf/open/floor/plating/airless,
/area/shuttle/mining/large)
"J" = (
/obj/basic/machinery/door/airlock/external{
	name = "Mining Shuttle External Airlock"
	},
/obj/basic/effect/mapping_helpers/airlock/cyclelink_helper{
	dir = 1
	},
/obj/basic/docking_port/mobile{
	dwidth = 3;
	height = 10;
	id = "mining";
	name = "mining shuttle";
	port_direction = 2;
	width = 7
	},
/obj/basic/structure/cable,
/turf/open/floor/plating,
/area/shuttle/mining/large)

(1,1,1) = {"
a
b
b
k
k
k
b
k
F
a
"}
(2,1,1) = {"
b
b
f
l
k
s
x
C
G
I
"}
(3,1,1) = {"
b
c
g
m
q
t
y
k
k
k
"}
(4,1,1) = {"
b
d
h
n
r
u
z
D
H
J
"}
(5,1,1) = {"
b
e
i
o
k
v
A
k
k
k
"}
(6,1,1) = {"
b
b
j
p
k
w
B
E
G
I
"}
(7,1,1) = {"
a
b
b
k
k
k
b
k
F
a
"}
