//MAP CONVERTED BY dmm2tgm.py THIS HEADER COMMENT PREVENTS RECONVERSION, DO NOT REMOVE
"az" = (
/obj/structure/table,
/obj/item/aicard,
/turf/open/floor/circuit/green/airless,
/area/shuttle/abandoned)
"aB" = (
/obj/structure/lattice/catwalk,
/obj/machinery/conveyor{
	dir = 8;
	id = "mothership_left"
	},
/turf/open/floor/plating/airless,
/area/shuttle/abandoned)
"aU" = (
/obj/machinery/conveyor_switch/oneway{
	id = "mothership_main"
	},
/turf/open/floor/iron/showroomfloor,
/area/shuttle/abandoned)
"bE" = (
/mob/living/simple_animal/bot/cleanbot,
/turf/open/floor/iron/showroomfloor,
/area/shuttle/abandoned)
"cU" = (
/obj/machinery/door/window/right/directional/north,
/obj/machinery/conveyor{
	id = "mothership_main"
	},
/turf/open/floor/plating/airless,
/area/shuttle/abandoned)
"dA" = (
/obj/item/mmi,
/turf/open/floor/circuit/green/airless,
/area/shuttle/abandoned)
"dC" = (
/obj/structure/lattice/catwalk,
/obj/machinery/conveyor{
	dir = 1;
	id = "mothership_bottom"
	},
/turf/open/floor/plating/airless,
/area/shuttle/abandoned)
"dI" = (
/obj/machinery/power/shuttle_engine/heater,
/obj/structure/window/reinforced{
	dir = 1;
	layer = 2.9
	},
/turf/open/floor/plating/airless,
/area/shuttle/abandoned)
"ey" = (
/obj/machinery/power/apc/auto_name/directional/north,
/turf/open/floor/circuit/airless,
/area/shuttle/abandoned)
"eO" = (
/obj/machinery/door/airlock/external/ruin,
/obj/effect/mapping_helpers/airlock/cyclelink_helper,
/obj/docking_port/mobile{
	callTime = 250;
	dir = 2;
	dwidth = 11;
	height = 26;
	shuttle_id = "whiteship";
	launch_status = 0;
	movement_force = list("KNOCKDOWN"=0,"THROW"=0);
	name = "Cyborg Mothership";
	port_direction = 8;
	preferred_direction = 4;
	width = 25
	},
/turf/open/floor/plating,
/area/shuttle/abandoned)
"fB" = (
/obj/effect/decal/cleanable/dirt/dust,
/obj/structure/table,
/obj/machinery/cell_charger,
/obj/item/stock_parts/cell/high,
/obj/structure/window/reinforced{
	dir = 1;
	layer = 2.9
	},
/obj/structure/window/reinforced{
	dir = 4
	},
/turf/open/floor/plating/airless,
/area/shuttle/abandoned)
"fV" = (
/obj/structure/lattice/catwalk,
/obj/machinery/shieldgen{
	active = 1;
	anchored = 1;
	locked = 1;
	req_access = list("syndicate")
	},
/turf/template_noop,
/area/shuttle/abandoned)
"gc" = (
/obj/machinery/door/window/right/directional/east,
/obj/machinery/conveyor{
	dir = 8;
	id = "mothership_left"
	},
/turf/open/floor/plating/airless,
/area/shuttle/abandoned)
"gG" = (
/obj/machinery/ore_silo,
/turf/open/floor/circuit/airless,
/area/shuttle/abandoned)
"hs" = (
/obj/effect/turf_decal/tile/neutral,
/obj/effect/turf_decal/tile/neutral{
	dir = 8
	},
/obj/machinery/computer/operating{
	dir = 8
	},
/obj/effect/turf_decal/bot,
/turf/open/floor/iron/dark,
/area/shuttle/abandoned)
"hx" = (
/turf/open/floor/iron/showroomfloor,
/area/shuttle/abandoned)
"hB" = (
/obj/item/stack/rods,
/obj/machinery/light/broken/directional/east,
/obj/machinery/button/door/directional/east{
	id = "mothership_right"
	},
/turf/open/floor/circuit/airless,
/area/shuttle/abandoned)
"hR" = (
/turf/template_noop,
/area/template_noop)
"il" = (
/obj/structure/sign/warning/vacuum/external/directional/west,
/obj/structure/closet/emcloset/anchored,
/obj/machinery/light/small/directional/west,
/turf/open/floor/plating/airless,
/area/shuttle/abandoned)
"iv" = (
/obj/structure/lattice,
/obj/structure/spacevine,
/turf/template_noop,
/area/shuttle/abandoned)
"iO" = (
/obj/machinery/rnd/production/protolathe/offstation,
/obj/machinery/conveyor{
	dir = 4;
	id = "mothership_right"
	},
/turf/open/floor/circuit/airless,
/area/shuttle/abandoned)
"jx" = (
/obj/structure/window/reinforced,
/obj/structure/window/reinforced{
	dir = 4
	},
/obj/effect/spawner/random/structure/crate_abandoned,
/turf/open/floor/plating/airless,
/area/shuttle/abandoned)
"jH" = (
/obj/machinery/recycler,
/obj/structure/lattice/catwalk,
/obj/machinery/conveyor{
	id = "Recycler"
	},
/turf/open/floor/plating/airless,
/area/shuttle/abandoned)
"jJ" = (
/obj/effect/mapping_helpers/airlock/cyclelink_helper{
	dir = 1
	},
/obj/effect/mapping_helpers/airlock/locked,
/obj/machinery/door/airlock/external/ruin{
	id_tag = "caravanpirate_bolt_port"
	},
/turf/open/floor/plating/airless,
/area/shuttle/abandoned)
"ks" = (
/obj/machinery/door/window/right/directional/south,
/obj/machinery/conveyor{
	dir = 1;
	id = "mothership_main"
	},
/turf/open/floor/plating/airless,
/area/shuttle/abandoned)
"ku" = (
/obj/machinery/conveyor{
	id = "Recycler"
	},
/turf/open/floor/plating/airless,
/area/shuttle/abandoned)
"kz" = (
/turf/closed/wall/mineral/titanium,
/area/shuttle/abandoned)
"lb" = (
/obj/item/stack/sheet/mineral/titanium,
/turf/open/floor/plating/airless,
/area/shuttle/abandoned)
"li" = (
/obj/structure/window/reinforced,
/obj/structure/window/reinforced{
	dir = 4
	},
/turf/open/floor/plating/airless,
/area/shuttle/abandoned)
"mc" = (
/obj/structure/lattice/catwalk,
/obj/machinery/camera/directional/west,
/obj/machinery/conveyor{
	dir = 4;
	id = "mothership_main"
	},
/turf/open/floor/plating/airless,
/area/shuttle/abandoned)
"mp" = (
/obj/machinery/camera/directional/east,
/turf/open/floor/plating/airless,
/area/shuttle/abandoned)
"mC" = (
/obj/machinery/door/airlock/hatch,
/turf/open/floor/plating/airless,
/area/shuttle/abandoned)
"mN" = (
/obj/machinery/conveyor{
	dir = 4;
	id = "mothership_main"
	},
/turf/open/floor/iron/showroomfloor,
/area/shuttle/abandoned)
"no" = (
/obj/item/organ/internal/brain,
/turf/open/floor/circuit/airless,
/area/shuttle/abandoned)
"oe" = (
/obj/structure/lattice/catwalk,
/obj/machinery/conveyor{
	dir = 4;
	id = "mothership_main"
	},
/turf/open/floor/plating/airless,
/area/shuttle/abandoned)
"of" = (
/obj/machinery/light/cold/no_nightlight/directional/west,
/turf/open/floor/circuit/airless,
/area/shuttle/abandoned)
"oy" = (
/obj/structure/windoor_assembly,
/obj/machinery/conveyor{
	dir = 1;
	id = "mothership_main"
	},
/turf/open/floor/plating/airless,
/area/shuttle/abandoned)
"oK" = (
/obj/structure/lattice,
/turf/template_noop,
/area/shuttle/abandoned)
"oR" = (
/obj/machinery/conveyor{
	dir = 1;
	id = "mothership_main"
	},
/turf/open/floor/plating/airless,
/area/shuttle/abandoned)
"po" = (
/obj/structure/lattice/catwalk,
/obj/machinery/conveyor{
	id = "mothership_main"
	},
/turf/open/floor/plating/airless,
/area/shuttle/abandoned)
"pz" = (
/turf/open/floor/circuit/airless,
/area/shuttle/abandoned)
"pG" = (
/obj/machinery/door/window/right/directional/west,
/obj/structure/spacevine,
/obj/machinery/conveyor{
	dir = 4;
	id = "mothership_right"
	},
/turf/open/floor/plating/airless,
/area/shuttle/abandoned)
"pL" = (
/obj/structure/spacevine,
/obj/structure/lattice,
/turf/open/space/basic,
/area/shuttle/abandoned)
"pY" = (
/obj/item/disk/holodisk/snowdin/overrun,
/turf/open/floor/circuit/airless,
/area/shuttle/abandoned)
"qc" = (
/obj/structure/lattice/catwalk,
/obj/machinery/conveyor{
	dir = 8;
	id = "mothership_main"
	},
/turf/open/floor/plating/airless,
/area/shuttle/abandoned)
"qn" = (
/obj/structure/spacevine,
/obj/machinery/power/solar{
	id = "mothership_solar"
	},
/turf/open/floor/iron/solarpanel/airless,
/area/shuttle/abandoned)
"qV" = (
/obj/structure/window/reinforced{
	dir = 8
	},
/obj/structure/lattice,
/turf/template_noop,
/area/shuttle/abandoned)
"ry" = (
/obj/machinery/mecha_part_fabricator/maint{
	name = "forgotten exosuit fabricator"
	},
/obj/machinery/conveyor{
	dir = 8;
	id = "mothership_left"
	},
/turf/open/floor/circuit/airless,
/area/shuttle/abandoned)
"rE" = (
/mob/living/simple_animal/hostile/hivebot,
/obj/structure/spacevine,
/obj/machinery/conveyor{
	id = "mothership_main"
	},
/turf/open/floor/plating/airless,
/area/shuttle/abandoned)
"rJ" = (
/obj/machinery/conveyor{
	dir = 4;
	id = "mothership_main"
	},
/obj/machinery/button/door/directional/north{
	id = "mothership_main"
	},
/turf/open/floor/iron/showroomfloor,
/area/shuttle/abandoned)
"ss" = (
/obj/machinery/conveyor{
	dir = 4;
	id = "mothership_right"
	},
/obj/structure/plasticflaps/opaque,
/obj/structure/lattice/catwalk,
/obj/machinery/door/poddoor/shutters/window{
	id = "mothership_right"
	},
/turf/open/floor/plating/airless,
/area/shuttle/abandoned)
"td" = (
/obj/structure/lattice/catwalk,
/obj/machinery/shieldgen{
	active = 1;
	anchored = 1;
	locked = 1;
	req_access = list("syndicate")
	},
/obj/structure/spacevine,
/turf/template_noop,
/area/shuttle/abandoned)
"tr" = (
/obj/structure/window/reinforced{
	dir = 8
	},
/obj/structure/window/reinforced{
	dir = 1;
	layer = 2.9
	},
/turf/open/floor/plating/airless,
/area/shuttle/abandoned)
"tW" = (
/obj/machinery/power/smes/engineering{
	charge = 1e+006
	},
/turf/open/floor/circuit/airless,
/area/shuttle/abandoned)
"vy" = (
/obj/machinery/computer/camera_advanced/shuttle_docker/whiteship{
	dir = 1
	},
/turf/open/floor/circuit/green/airless,
/area/shuttle/abandoned)
"vL" = (
/obj/machinery/light/small/directional/south,
/obj/machinery/conveyor{
	dir = 8;
	id = "mothership_main"
	},
/turf/open/floor/plating/airless,
/area/shuttle/abandoned)
"wk" = (
/obj/effect/turf_decal/tile/neutral,
/obj/effect/turf_decal/tile/neutral{
	dir = 8
	},
/obj/structure/table/optable,
/obj/effect/turf_decal/bot,
/obj/effect/mob_spawn/corpse/human/assistant,
/obj/machinery/light/cold/no_nightlight/directional/east,
/turf/open/floor/iron/dark,
/area/shuttle/abandoned)
"wo" = (
/obj/machinery/door/window/right/directional/south,
/obj/structure/spacevine,
/obj/machinery/conveyor{
	id = "mothership_main"
	},
/turf/open/floor/plating/airless,
/area/shuttle/abandoned)
"wA" = (
/obj/machinery/camera/directional/west,
/turf/template_noop,
/area/template_noop)
"xz" = (
/obj/machinery/camera/directional/west,
/turf/open/floor/plating/airless,
/area/shuttle/abandoned)
"yd" = (
/obj/structure/spacevine,
/turf/open/floor/plating/airless,
/area/shuttle/abandoned)
"yg" = (
/obj/machinery/conveyor_switch/oneway{
	id = "mothership_left"
	},
/turf/open/floor/circuit/airless,
/area/shuttle/abandoned)
"yn" = (
/obj/machinery/conveyor{
	dir = 4;
	id = "mothership_main"
	},
/obj/machinery/door/poddoor/shutters/window{
	id = "mothership_main"
	},
/obj/structure/plasticflaps/opaque,
/turf/open/floor/iron/showroomfloor,
/area/shuttle/abandoned)
"yA" = (
/obj/structure/lattice/catwalk,
/obj/structure/spacevine,
/obj/machinery/conveyor{
	dir = 4;
	id = "mothership_right"
	},
/turf/open/floor/plating/airless,
/area/shuttle/abandoned)
"yF" = (
/obj/machinery/status_display/ai,
/turf/closed/wall/mineral/titanium/nodiagonal,
/area/shuttle/abandoned)
"yG" = (
/obj/machinery/camera/directional/south,
/obj/machinery/power/solar_control{
	dir = 1;
	id = "mothership_solar";
	name = "Primary Solar Control"
	},
/turf/open/floor/circuit/airless,
/area/shuttle/abandoned)
"yQ" = (
/mob/living/simple_animal/hostile/hivebot,
/turf/open/floor/circuit/green/airless,
/area/shuttle/abandoned)
"zh" = (
/obj/structure/lattice/catwalk,
/obj/machinery/conveyor{
	dir = 1;
	id = "mothership_main"
	},
/turf/open/floor/plating/airless,
/area/shuttle/abandoned)
"zn" = (
/obj/machinery/power/shuttle_engine/propulsion,
/obj/structure/spacevine,
/turf/open/space/basic,
/area/shuttle/abandoned)
"zD" = (
/obj/structure/window/reinforced{
	dir = 8
	},
/obj/structure/window/reinforced,
/turf/open/floor/plating/airless,
/area/shuttle/abandoned)
"zF" = (
/obj/structure/lattice/catwalk,
/obj/structure/spacevine,
/obj/machinery/conveyor{
	dir = 1;
	id = "mothership_main"
	},
/turf/open/floor/plating/airless,
/area/shuttle/abandoned)
"zQ" = (
/obj/structure/lattice/catwalk,
/obj/machinery/conveyor{
	dir = 4;
	id = "mothership_right"
	},
/turf/open/floor/plating/airless,
/area/shuttle/abandoned)
"zZ" = (
/turf/closed/wall/mineral/titanium/nodiagonal,
/area/shuttle/abandoned)
"Ai" = (
/obj/machinery/door/airlock/hatch,
/turf/open/floor/circuit/airless,
/area/shuttle/abandoned)
"BD" = (
/obj/machinery/power/solar{
	id = "mothership_solar"
	},
/turf/open/floor/iron/solarpanel/airless,
/area/shuttle/abandoned)
"BE" = (
/obj/structure/window/reinforced{
	dir = 4
	},
/obj/structure/window/reinforced{
	dir = 1;
	layer = 2.9
	},
/obj/machinery/conveyor_switch{
	id = "Recycler";
	name = "Recycler"
	},
/turf/open/floor/plating/airless,
/area/shuttle/abandoned)
"Cq" = (
/obj/structure/lattice/catwalk,
/obj/machinery/camera/directional/north,
/obj/machinery/power/tracker,
/turf/open/floor/plating/airless,
/area/shuttle/abandoned)
"Dv" = (
/obj/machinery/light/cold/no_nightlight/directional/west,
/obj/machinery/button/door/directional/west{
	id = "mothership_left"
	},
/turf/open/floor/circuit/airless,
/area/shuttle/abandoned)
"Em" = (
/obj/structure/girder,
/turf/open/floor/plating/airless,
/area/shuttle/abandoned)
"Eq" = (
/obj/structure/plasticflaps/opaque,
/obj/structure/lattice/catwalk,
/obj/machinery/conveyor{
	dir = 8;
	id = "mothership_left"
	},
/obj/machinery/door/poddoor/shutters/window{
	id = "mothership_left"
	},
/turf/open/floor/plating/airless,
/area/shuttle/abandoned)
"Ex" = (
/obj/structure/window/reinforced{
	dir = 4
	},
/obj/structure/lattice,
/turf/template_noop,
/area/shuttle/abandoned)
"Ey" = (
/obj/effect/turf_decal/tile/neutral,
/obj/effect/turf_decal/tile/neutral{
	dir = 8
	},
/obj/structure/table,
/obj/item/storage/backpack/duffelbag/med/surgery,
/obj/effect/turf_decal/bot,
/obj/structure/sink/directional/east,
/turf/open/floor/iron/dark,
/area/shuttle/abandoned)
"Fe" = (
/mob/living/simple_animal/bot/hygienebot,
/obj/machinery/camera/directional/south,
/turf/open/floor/iron/showroomfloor,
/area/shuttle/abandoned)
"FQ" = (
/obj/structure/lattice,
/mob/living/simple_animal/hostile/hivebot/range,
/turf/template_noop,
/area/shuttle/abandoned)
"Ge" = (
/obj/machinery/conveyor{
	dir = 1;
	id = "mothership_main"
	},
/obj/structure/lattice/catwalk,
/turf/open/floor/plating/airless,
/area/shuttle/abandoned)
"Gf" = (
/obj/machinery/conveyor_switch/oneway{
	id = "mothership_right"
	},
/turf/open/floor/circuit/airless,
/area/shuttle/abandoned)
"Hg" = (
/obj/machinery/conveyor{
	dir = 8;
	id = "mothership_main"
	},
/obj/structure/lattice/catwalk,
/turf/open/floor/plating/airless,
/area/shuttle/abandoned)
"HK" = (
/obj/machinery/door/window/right/directional/north,
/obj/machinery/conveyor{
	id = "Recycler"
	},
/turf/open/floor/plating/airless,
/area/shuttle/abandoned)
"IS" = (
/obj/machinery/conveyor{
	id = "mothership_main"
	},
/obj/structure/lattice/catwalk,
/turf/open/floor/plating/airless,
/area/shuttle/abandoned)
"Jj" = (
/obj/structure/lattice/catwalk,
/obj/structure/spacevine,
/obj/machinery/conveyor{
	dir = 4;
	id = "mothership_main"
	},
/turf/open/floor/plating/airless,
/area/shuttle/abandoned)
"JJ" = (
/obj/structure/lattice,
/mob/living/simple_animal/hostile/hivebot/mechanic,
/turf/template_noop,
/area/shuttle/abandoned)
"KN" = (
/obj/machinery/conveyor{
	dir = 8;
	id = "mothership_main"
	},
/turf/open/floor/plating/airless,
/area/shuttle/abandoned)
"Ln" = (
/obj/structure/lattice,
/turf/open/space/basic,
/area/shuttle/abandoned)
"MB" = (
/obj/machinery/computer/shuttle/white_ship/bridge{
	dir = 1
	},
/turf/open/floor/circuit/green/airless,
/area/shuttle/abandoned)
"MZ" = (
/obj/machinery/light/cold/no_nightlight/directional/east,
/turf/open/floor/circuit/airless,
/area/shuttle/abandoned)
"Ng" = (
/obj/structure/lattice/catwalk,
/obj/structure/spacevine,
/obj/machinery/conveyor{
	dir = 8;
	id = "mothership_main"
	},
/turf/open/floor/plating/airless,
/area/shuttle/abandoned)
"Nv" = (
/obj/machinery/holopad/secure,
/turf/open/floor/circuit/green/airless,
/area/shuttle/abandoned)
"Oq" = (
/obj/machinery/conveyor{
	dir = 4;
	id = "mothership_main"
	},
/obj/structure/plasticflaps/opaque,
/obj/machinery/door/poddoor/shutters/window{
	id = "mothership_main"
	},
/turf/open/floor/iron/showroomfloor,
/area/shuttle/abandoned)
"Ou" = (
/obj/structure/lattice/catwalk,
/obj/machinery/camera/directional/east,
/obj/machinery/conveyor{
	dir = 1;
	id = "mothership_main"
	},
/turf/open/floor/plating/airless,
/area/shuttle/abandoned)
"OY" = (
/obj/machinery/power/shuttle_engine/heater,
/obj/structure/window/reinforced{
	dir = 1;
	layer = 2.9
	},
/obj/structure/window/reinforced{
	dir = 8
	},
/turf/open/floor/plating/airless,
/area/shuttle/abandoned)
"Pf" = (
/obj/structure/table_frame,
/turf/open/floor/circuit/green/airless,
/area/shuttle/abandoned)
"PP" = (
/obj/effect/turf_decal/tile/neutral,
/obj/effect/turf_decal/tile/neutral{
	dir = 8
	},
/obj/structure/table,
/obj/effect/turf_decal/bot,
/obj/item/clothing/gloves/color/latex,
/obj/item/clothing/mask/surgical,
/obj/item/razor,
/obj/structure/mirror/directional/west,
/obj/machinery/light/cold/no_nightlight/directional/west,
/turf/open/floor/iron/dark,
/area/shuttle/abandoned)
"RD" = (
/obj/machinery/recharge_station,
/obj/structure/sign/warning/vacuum/external/directional/east,
/obj/machinery/camera/directional/east,
/turf/open/floor/plating/airless,
/area/shuttle/abandoned)
"RV" = (
/obj/machinery/camera/directional/east,
/turf/template_noop,
/area/template_noop)
"Sc" = (
/obj/structure/rack,
/obj/item/storage/toolbox/electrical{
	pixel_x = -3;
	pixel_y = 3
	},
/obj/item/storage/toolbox/mechanical,
/obj/item/multitool,
/obj/machinery/light/small/directional/east,
/turf/open/floor/plating/airless,
/area/shuttle/abandoned)
"Sy" = (
/obj/structure/window/reinforced{
	dir = 1;
	layer = 2.9
	},
/obj/structure/window/reinforced{
	dir = 8
	},
/obj/effect/spawner/random/engineering/material{
	spawn_loot_count = 3;
	spawn_loot_split = 1
	},
/obj/structure/closet/crate{
	icon_state = "crateopen"
	},
/turf/open/floor/plating/airless,
/area/shuttle/abandoned)
"SV" = (
/obj/machinery/power/shuttle_engine/heater,
/obj/structure/window/reinforced{
	dir = 1;
	layer = 2.9
	},
/obj/structure/window/reinforced{
	dir = 4
	},
/turf/open/floor/plating/airless,
/area/shuttle/abandoned)
"Ty" = (
/obj/structure/lattice,
/obj/item/stack/sheet/mineral/titanium,
/turf/template_noop,
/area/shuttle/abandoned)
"UL" = (
/obj/structure/window/reinforced{
	dir = 4
	},
/obj/structure/window/reinforced{
	dir = 8
	},
/turf/open/floor/catwalk_floor/titanium,
/area/shuttle/abandoned)
"UU" = (
/obj/structure/window/reinforced{
	dir = 4
	},
/obj/structure/window/reinforced{
	dir = 1;
	layer = 2.9
	},
/obj/item/electronics/airlock,
/obj/item/stack/cable_coil,
/turf/open/floor/plating/airless,
/area/shuttle/abandoned)
"UV" = (
/obj/machinery/power/terminal,
/mob/living/simple_animal/hostile/hivebot/range,
/turf/open/floor/circuit/airless,
/area/shuttle/abandoned)
"Vb" = (
/obj/machinery/power/shuttle_engine/propulsion,
/turf/open/space/basic,
/area/shuttle/abandoned)
"VQ" = (
/turf/open/floor/plating/airless,
/area/shuttle/abandoned)
"VU" = (
/obj/structure/lattice/catwalk,
/obj/machinery/conveyor{
	id = "Recycler"
	},
/obj/machinery/mineral/stacking_machine{
	input_dir = 2
	},
/turf/open/floor/plating/airless,
/area/shuttle/abandoned)
"Yl" = (
/obj/structure/lattice/catwalk,
/obj/structure/spacevine,
/obj/machinery/conveyor{
	id = "mothership_main"
	},
/turf/open/floor/plating/airless,
/area/shuttle/abandoned)
"Zk" = (
/obj/structure/closet/crate{
	icon_state = "crateopen"
	},
/obj/effect/spawner/random/maintenance/three,
/obj/machinery/light/small/directional/west,
/turf/open/floor/plating/airless,
/area/shuttle/abandoned)
"ZB" = (
/obj/structure/ai_core,
/obj/item/radio/intercom/directional/south,
/turf/open/floor/circuit/green/airless,
/area/shuttle/abandoned)
"ZD" = (
/obj/machinery/conveyor_switch/oneway{
	id = "mothership_bottom"
	},
/turf/open/floor/plating/airless,
/area/shuttle/abandoned)
"ZI" = (
/obj/structure/window/reinforced,
/obj/structure/window/reinforced{
	dir = 8
	},
/obj/structure/closet/crate{
	icon_state = "crateopen"
	},
/obj/item/stack/sheet/iron/fifty,
/obj/item/stack/sheet/glass/fifty,
/turf/open/floor/plating/airless,
/area/shuttle/abandoned)

(1,1,1) = {"
hR
hR
hR
hR
hR
hR
hR
hR
hR
hR
hR
kz
zZ
dI
zn
hR
hR
hR
hR
hR
hR
hR
hR
hR
hR
hR
"}
(2,1,1) = {"
hR
hR
hR
hR
hR
hR
hR
hR
hR
hR
kz
zZ
Zk
zZ
SV
zn
hR
hR
hR
hR
hR
hR
hR
hR
hR
hR
"}
(3,1,1) = {"
hR
hR
hR
hR
hR
hR
hR
hR
hR
hR
fB
xz
VQ
VQ
jx
pL
hR
hR
hR
hR
hR
hR
hR
hR
hR
hR
"}
(4,1,1) = {"
hR
hR
hR
hR
hR
hR
hR
hR
oe
zh
zh
oy
oR
ks
zh
zh
zF
hR
hR
hR
hR
hR
hR
hR
hR
hR
"}
(5,1,1) = {"
hR
hR
hR
hR
td
qn
qn
qn
oe
hR
hR
UU
gc
li
hR
hR
Ng
qn
BD
qn
fV
hR
hR
hR
hR
hR
"}
(6,1,1) = {"
hR
hR
hR
hR
qn
Jj
zh
zh
zh
hR
hR
oK
aB
oK
hR
hR
qc
zh
zh
zh
qn
hR
hR
hR
hR
hR
"}
(7,1,1) = {"
hR
hR
hR
hR
qn
oe
oK
oK
hR
hR
hR
oK
aB
oK
hR
hR
hR
oK
oK
qc
qn
hR
hR
hR
hR
hR
"}
(8,1,1) = {"
hR
hR
hR
hR
qn
Jj
iv
oK
oK
hR
hR
oK
aB
oK
hR
hR
oK
oK
oK
qc
qn
hR
hR
hR
hR
hR
"}
(9,1,1) = {"
hR
hR
hR
oe
Ge
Ou
hR
oK
JJ
oK
hR
kz
Eq
kz
RV
oK
oK
oK
hR
qc
zF
Ge
hR
hR
hR
hR
"}
(10,1,1) = {"
hR
hR
kz
yn
zZ
zZ
kz
hR
oK
oK
kz
zZ
ry
zZ
zZ
kz
oK
hR
hR
hR
hR
qc
hR
hR
hR
hR
"}
(11,1,1) = {"
kz
zZ
zZ
rJ
PP
Ey
zZ
hR
hR
kz
zZ
Dv
yg
pz
of
zZ
kz
hR
hR
hR
hR
qc
dC
dC
dI
Vb
"}
(12,1,1) = {"
yF
il
zZ
mN
hx
Fe
yF
Ex
Ex
yF
pz
yQ
vy
Pf
pz
gG
yF
oK
oK
oK
tr
KN
ZD
KN
dI
Vb
"}
(13,1,1) = {"
eO
VQ
jJ
mN
aU
hx
mC
UL
UL
Ai
no
Nv
ZB
zZ
ey
yG
zZ
Cq
VU
jH
HK
ku
ku
vL
dI
Vb
"}
(14,1,1) = {"
yF
RD
zZ
mN
hx
bE
yF
qV
qV
yF
pY
dA
MB
az
UV
tW
yF
oK
oK
oK
BE
KN
VQ
KN
dI
Vb
"}
(15,1,1) = {"
kz
zZ
zZ
rJ
wk
hs
zZ
hR
hR
Em
lb
hB
Gf
pz
MZ
zZ
kz
hR
hR
hR
hR
qc
dC
dC
dI
Vb
"}
(16,1,1) = {"
hR
hR
kz
Oq
zZ
zZ
kz
hR
oK
Ty
lb
zZ
iO
zZ
zZ
kz
oK
hR
hR
hR
hR
Ng
hR
hR
hR
hR
"}
(17,1,1) = {"
hR
hR
hR
IS
po
mc
hR
oK
oK
Ty
hR
kz
ss
kz
wA
oK
oK
oK
hR
po
Yl
Ng
hR
hR
hR
hR
"}
(18,1,1) = {"
hR
hR
hR
hR
qn
Jj
FQ
oK
oK
hR
hR
oK
zQ
iv
hR
hR
oK
oK
oK
qc
qn
hR
hR
hR
hR
hR
"}
(19,1,1) = {"
hR
hR
hR
hR
BD
Jj
iv
iv
hR
hR
hR
iv
yA
iv
hR
hR
hR
oK
oK
qc
qn
hR
hR
hR
hR
hR
"}
(20,1,1) = {"
hR
hR
hR
hR
qn
Yl
Yl
Yl
oe
hR
hR
iv
zQ
oK
hR
hR
po
po
po
qc
qn
hR
hR
hR
hR
hR
"}
(21,1,1) = {"
hR
hR
hR
hR
fV
qn
qn
qn
oe
hR
hR
yd
pG
zD
hR
hR
qc
BD
qn
qn
td
hR
hR
hR
hR
hR
"}
(22,1,1) = {"
hR
hR
hR
hR
hR
hR
hR
hR
po
po
po
cU
rE
wo
po
po
Hg
hR
hR
hR
hR
hR
hR
hR
hR
hR
"}
(23,1,1) = {"
hR
hR
hR
hR
hR
hR
hR
hR
hR
hR
Sy
mp
VQ
yd
ZI
Ln
hR
hR
hR
hR
hR
hR
hR
hR
hR
hR
"}
(24,1,1) = {"
hR
hR
hR
hR
hR
hR
hR
hR
hR
hR
kz
zZ
Sc
zZ
OY
Vb
hR
hR
hR
hR
hR
hR
hR
hR
hR
hR
"}
(25,1,1) = {"
hR
hR
hR
hR
hR
hR
hR
hR
hR
hR
hR
kz
zZ
OY
Vb
hR
hR
hR
hR
hR
hR
hR
hR
hR
hR
hR
"}
