//MAP CONVERTED BY dmm2tgm.py THIS HEADER COMMENT PREVENTS RECONVERSION, DO NOT REMOVE
"af" = (
/turf/closed/wall/mineral/plastitanium/nodiagonal,
/area/shuttle/caravan/pirate)
"aE" = (
/obj/basic/structure/closet{
	name = "pirate outfits"
	},
/obj/basic/item/clothing/head/collectable/pirate,
/obj/basic/item/clothing/suit/pirate,
/obj/basic/item/clothing/under/costume/pirate,
/obj/basic/item/clothing/shoes/jackboots,
/obj/basic/item/clothing/head/bandana,
/turf/open/floor/iron/dark/side{
	dir = 5
	},
/area/shuttle/caravan/pirate)
"bd" = (
/obj/basic/structure/table/reinforced,
/obj/basic/machinery/button/door{
	id = "caravanpirate_bridge";
	name = "Bridge Blast Door Control";
	pixel_x = -16
	},
/obj/basic/effect/turf_decal/tile/red,
/obj/basic/effect/turf_decal/tile/red{
	dir = 8
	},
/turf/open/floor/iron/dark,
/area/shuttle/caravan/pirate)
"bH" = (
/obj/basic/machinery/atmospherics/pipe/smart/manifold4w/supply/hidden{
	dir = 5
	},
/obj/basic/effect/decal/cleanable/dirt,
/turf/open/floor/iron,
/area/shuttle/caravan/pirate)
"de" = (
/obj/basic/machinery/atmospherics/pipe/smart/manifold4w/supply/hidden{
	dir = 8
	},
/obj/basic/effect/turf_decal/tile/neutral{
	dir = 1
	},
/obj/basic/effect/turf_decal/tile/neutral,
/obj/basic/effect/turf_decal/tile/neutral{
	dir = 4
	},
/obj/basic/effect/turf_decal/tile/neutral{
	dir = 8
	},
/turf/open/floor/iron/dark,
/area/shuttle/caravan/pirate)
"dE" = (
/obj/basic/effect/turf_decal/tile/neutral{
	dir = 1
	},
/obj/basic/effect/turf_decal/tile/neutral,
/obj/basic/effect/turf_decal/tile/neutral{
	dir = 4
	},
/obj/basic/effect/turf_decal/tile/neutral{
	dir = 8
	},
/turf/open/floor/iron/dark,
/area/shuttle/caravan/pirate)
"eL" = (
/obj/basic/machinery/porta_turret/syndicate/pod{
	dir = 10;
	faction = list("pirate")
	},
/turf/closed/wall/mineral/plastitanium,
/area/shuttle/caravan/pirate)
"fh" = (
/obj/basic/machinery/atmospherics/pipe/smart/manifold4w/supply/hidden{
	dir = 4
	},
/turf/open/floor/plating,
/area/shuttle/caravan/pirate)
"fL" = (
/obj/basic/machinery/computer/shuttle/caravan/pirate{
	dir = 8
	},
/obj/basic/effect/turf_decal/tile/red{
	dir = 1
	},
/obj/basic/effect/turf_decal/tile/red{
	dir = 8
	},
/turf/open/floor/iron/dark,
/area/shuttle/caravan/pirate)
"fS" = (
/obj/basic/structure/bed,
/obj/basic/item/bedsheet/brown,
/obj/basic/machinery/airalarm/all_access{
	dir = 4;
	pixel_x = -24
	},
/obj/basic/effect/turf_decal/tile/red{
	dir = 8
	},
/turf/open/floor/iron/dark,
/area/shuttle/caravan/pirate)
"fU" = (
/obj/basic/machinery/atmospherics/pipe/smart/manifold4w/supply/hidden,
/obj/basic/effect/turf_decal/tile/red,
/obj/basic/effect/turf_decal/tile/red{
	dir = 8
	},
/turf/open/floor/iron,
/area/shuttle/caravan/pirate)
"hh" = (
/mob/living/simple_animal/hostile/pirate{
	environment_smash = 0
	},
/turf/open/floor/iron,
/area/shuttle/caravan/pirate)
"hI" = (
/obj/basic/machinery/atmospherics/pipe/smart/manifold4w/supply/hidden,
/obj/basic/structure/cable,
/turf/open/floor/plating,
/area/shuttle/caravan/pirate)
"hT" = (
/obj/basic/machinery/light/small/directional/north,
/obj/basic/structure/bed,
/obj/basic/item/bedsheet/brown,
/turf/open/floor/iron/dark,
/area/shuttle/caravan/pirate)
"hZ" = (
/obj/basic/machinery/atmospherics/pipe/smart/manifold4w/supply/hidden,
/obj/basic/effect/turf_decal/tile/neutral{
	dir = 1
	},
/obj/basic/effect/turf_decal/tile/neutral,
/obj/basic/effect/turf_decal/tile/neutral{
	dir = 4
	},
/obj/basic/effect/turf_decal/tile/neutral{
	dir = 8
	},
/turf/open/floor/iron/dark,
/area/shuttle/caravan/pirate)
"iF" = (
/obj/basic/machinery/atmospherics/pipe/smart/manifold4w/supply/hidden{
	dir = 9
	},
/obj/basic/effect/turf_decal/tile/neutral{
	dir = 1
	},
/obj/basic/effect/turf_decal/tile/neutral,
/obj/basic/effect/turf_decal/tile/neutral{
	dir = 4
	},
/obj/basic/effect/turf_decal/tile/neutral{
	dir = 8
	},
/turf/open/floor/iron/dark,
/area/shuttle/caravan/pirate)
"iX" = (
/obj/basic/structure/table,
/obj/basic/machinery/door/window/southleft{
	base_state = "right";
	icon_state = "right";
	name = "Weapon Storage"
	},
/obj/basic/item/gun/energy/laser,
/obj/basic/effect/turf_decal/tile/neutral{
	dir = 1
	},
/obj/basic/effect/turf_decal/tile/neutral,
/obj/basic/effect/turf_decal/tile/neutral{
	dir = 4
	},
/obj/basic/effect/turf_decal/tile/neutral{
	dir = 8
	},
/turf/open/floor/iron/dark,
/area/shuttle/caravan/pirate)
"jh" = (
/obj/basic/machinery/power/port_gen/pacman{
	anchored = 1
	},
/obj/basic/item/wrench,
/obj/basic/effect/turf_decal/stripes/line{
	dir = 6
	},
/obj/basic/structure/cable,
/turf/open/floor/plating,
/area/shuttle/caravan/pirate)
"jo" = (
/obj/basic/structure/table,
/obj/basic/machinery/airalarm/all_access{
	pixel_y = 24
	},
/obj/basic/item/ammo_box/a40mm,
/obj/basic/effect/turf_decal/tile/neutral{
	dir = 1
	},
/obj/basic/effect/turf_decal/tile/neutral,
/obj/basic/effect/turf_decal/tile/neutral{
	dir = 4
	},
/obj/basic/effect/turf_decal/tile/neutral{
	dir = 8
	},
/turf/open/floor/iron/dark,
/area/shuttle/caravan/pirate)
"js" = (
/obj/basic/machinery/light/small/directional/east,
/obj/basic/machinery/atmospherics/pipe/smart/manifold4w/supply/hidden,
/turf/open/floor/plating,
/area/shuttle/caravan/pirate)
"jU" = (
/obj/basic/structure/shuttle/engine/propulsion/burst{
	dir = 8
	},
/turf/open/floor/plating/airless,
/area/shuttle/caravan/pirate)
"kl" = (
/obj/basic/machinery/atmospherics/pipe/smart/manifold4w/supply/hidden{
	dir = 1
	},
/turf/open/floor/iron/white/side{
	dir = 1
	},
/area/shuttle/caravan/pirate)
"ku" = (
/obj/basic/structure/rack,
/obj/basic/item/storage/bag/money/vault,
/obj/basic/effect/turf_decal/tile/blue{
	dir = 4
	},
/mob/living/simple_animal/parrot{
	faction = list("pirate");
	name = "Pegwing"
	},
/turf/open/floor/iron/dark,
/area/shuttle/caravan/pirate)
"kY" = (
/obj/basic/machinery/atmospherics/pipe/smart/manifold4w/supply/hidden{
	dir = 8
	},
/obj/basic/machinery/meter,
/turf/open/floor/plating,
/area/shuttle/caravan/pirate)
"le" = (
/obj/basic/machinery/porta_turret/syndicate/pod{
	dir = 5;
	faction = list("pirate")
	},
/turf/closed/wall/mineral/plastitanium,
/area/shuttle/caravan/pirate)
"lG" = (
/obj/basic/machinery/atmospherics/components/unary/vent_pump/on,
/obj/basic/effect/turf_decal/tile/neutral{
	dir = 1
	},
/obj/basic/effect/turf_decal/tile/neutral,
/obj/basic/effect/turf_decal/tile/neutral{
	dir = 4
	},
/obj/basic/effect/turf_decal/tile/neutral{
	dir = 8
	},
/turf/open/floor/iron/dark,
/area/shuttle/caravan/pirate)
"mr" = (
/obj/basic/machinery/atmospherics/pipe/smart/manifold4w/supply/hidden{
	dir = 4
	},
/obj/basic/machinery/door/firedoor,
/obj/basic/machinery/door/airlock/command{
	name = "Bridge"
	},
/obj/basic/effect/turf_decal/tile/neutral{
	dir = 1
	},
/obj/basic/effect/turf_decal/tile/neutral,
/obj/basic/effect/turf_decal/tile/neutral{
	dir = 4
	},
/obj/basic/effect/turf_decal/tile/neutral{
	dir = 8
	},
/turf/open/floor/iron/dark,
/area/shuttle/caravan/pirate)
"mI" = (
/obj/basic/structure/table,
/obj/basic/item/storage/firstaid/brute{
	pixel_x = 3;
	pixel_y = 3
	},
/obj/basic/item/storage/firstaid/fire,
/obj/basic/machinery/firealarm/directional/south,
/turf/open/floor/iron/white,
/area/shuttle/caravan/pirate)
"na" = (
/obj/basic/machinery/atmospherics/pipe/smart/manifold4w/supply/hidden{
	dir = 4
	},
/turf/open/floor/iron/white/side{
	dir = 1
	},
/area/shuttle/caravan/pirate)
"nD" = (
/obj/basic/machinery/light/small/directional/east,
/obj/basic/machinery/atmospherics/pipe/smart/manifold4w/supply/hidden{
	dir = 10
	},
/turf/open/floor/iron/white/side{
	dir = 1
	},
/area/shuttle/caravan/pirate)
"oe" = (
/obj/basic/structure/table,
/obj/basic/item/circular_saw,
/obj/basic/item/scalpel{
	pixel_y = 12
	},
/obj/basic/item/cautery{
	pixel_x = 4
	},
/obj/basic/machinery/light/small/directional/west,
/turf/open/floor/iron/white/side{
	dir = 8
	},
/area/shuttle/caravan/pirate)
"oF" = (
/obj/basic/structure/closet{
	name = "pirate outfits"
	},
/obj/basic/item/clothing/head/collectable/pirate,
/obj/basic/item/clothing/suit/pirate,
/obj/basic/item/clothing/under/costume/pirate,
/obj/basic/item/clothing/shoes/jackboots,
/obj/basic/item/clothing/head/bandana,
/obj/basic/effect/turf_decal/tile/red{
	dir = 1
	},
/turf/open/floor/iron/dark,
/area/shuttle/caravan/pirate)
"oL" = (
/turf/closed/wall/mineral/plastitanium,
/area/shuttle/caravan/pirate)
"oO" = (
/obj/basic/machinery/computer/camera_advanced/shuttle_docker/caravan/pirate,
/obj/basic/effect/turf_decal/tile/red{
	dir = 1
	},
/obj/basic/effect/turf_decal/tile/red{
	dir = 4
	},
/turf/open/floor/iron/dark,
/area/shuttle/caravan/pirate)
"oT" = (
/obj/basic/structure/table,
/obj/basic/structure/window/reinforced{
	dir = 8
	},
/obj/basic/machinery/door/window/southleft{
	name = "Weapon Storage"
	},
/obj/basic/item/grenade/smokebomb{
	pixel_x = -4
	},
/obj/basic/item/grenade/smokebomb{
	pixel_x = 2
	},
/obj/basic/effect/turf_decal/tile/neutral{
	dir = 1
	},
/obj/basic/effect/turf_decal/tile/neutral,
/obj/basic/effect/turf_decal/tile/neutral{
	dir = 4
	},
/obj/basic/effect/turf_decal/tile/neutral{
	dir = 8
	},
/turf/open/floor/iron/dark,
/area/shuttle/caravan/pirate)
"pK" = (
/obj/basic/item/stack/sheet/mineral/gold{
	amount = 25
	},
/obj/basic/item/stack/sheet/mineral/bananium{
	amount = 5
	},
/obj/basic/item/stack/sheet/mineral/silver{
	amount = 25
	},
/obj/basic/item/stack/sheet/mineral/uranium{
	amount = 10
	},
/obj/basic/item/stack/sheet/mineral/diamond{
	amount = 5
	},
/obj/basic/structure/closet/crate,
/obj/basic/item/coin/silver,
/obj/basic/item/coin/silver,
/obj/basic/item/coin/silver,
/obj/basic/item/coin/gold,
/obj/basic/item/coin/gold,
/obj/basic/effect/turf_decal/tile/blue,
/turf/open/floor/iron/dark,
/area/shuttle/caravan/pirate)
"pS" = (
/obj/basic/machinery/atmospherics/components/unary/vent_pump/on,
/obj/basic/effect/decal/cleanable/dirt,
/turf/open/floor/iron,
/area/shuttle/caravan/pirate)
"pZ" = (
/obj/basic/structure/tank_dispenser/oxygen,
/obj/basic/machinery/firealarm/directional/north,
/obj/basic/effect/turf_decal/tile/neutral{
	dir = 1
	},
/obj/basic/effect/turf_decal/tile/neutral,
/obj/basic/effect/turf_decal/tile/neutral{
	dir = 4
	},
/obj/basic/effect/turf_decal/tile/neutral{
	dir = 8
	},
/turf/open/floor/iron/dark,
/area/shuttle/caravan/pirate)
"qo" = (
/obj/basic/machinery/porta_turret/syndicate/pod{
	dir = 6;
	faction = list("pirate")
	},
/turf/closed/wall/mineral/plastitanium,
/area/shuttle/caravan/pirate)
"qC" = (
/obj/basic/structure/table,
/obj/basic/item/storage/fancy/donut_box{
	pixel_y = 18
	},
/obj/basic/item/storage/box/donkpockets{
	pixel_x = -3;
	pixel_y = 7
	},
/obj/basic/item/storage/box/donkpockets{
	pixel_x = -6
	},
/obj/basic/item/reagent_containers/food/drinks/bottle/rum{
	pixel_x = 8;
	pixel_y = 3
	},
/obj/basic/structure/sign/poster/contraband/red_rum{
	pixel_x = 32
	},
/turf/open/floor/iron/dark,
/area/shuttle/caravan/pirate)
"qX" = (
/obj/basic/structure/reagent_dispensers/watertank,
/obj/basic/item/reagent_containers/glass/bucket,
/obj/basic/item/mop,
/obj/basic/effect/turf_decal/stripes/line{
	dir = 5
	},
/turf/open/floor/plating,
/area/shuttle/caravan/pirate)
"sr" = (
/obj/basic/machinery/atmospherics/pipe/smart/manifold4w/supply/hidden{
	dir = 4
	},
/obj/basic/effect/turf_decal/tile/red,
/obj/basic/effect/turf_decal/tile/red{
	dir = 8
	},
/turf/open/floor/iron,
/area/shuttle/caravan/pirate)
"su" = (
/obj/basic/effect/decal/cleanable/dirt,
/turf/open/floor/iron,
/area/shuttle/caravan/pirate)
"th" = (
/obj/basic/machinery/atmospherics/pipe/smart/manifold4w/supply/hidden{
	dir = 4
	},
/obj/basic/machinery/door/firedoor,
/obj/basic/machinery/door/airlock/engineering{
	name = "Engineering"
	},
/turf/open/floor/plating,
/area/shuttle/caravan/pirate)
"to" = (
/obj/basic/structure/table,
/obj/basic/item/reagent_containers/food/drinks/bottle/rum{
	pixel_x = 3;
	pixel_y = 6
	},
/obj/basic/item/reagent_containers/food/drinks/bottle/rum,
/turf/open/floor/iron/dark,
/area/shuttle/caravan/pirate)
"tM" = (
/obj/basic/effect/decal/cleanable/dirt,
/mob/living/simple_animal/hostile/pirate/ranged{
	environment_smash = 0
	},
/turf/open/floor/iron,
/area/shuttle/caravan/pirate)
"ul" = (
/obj/basic/structure/table,
/obj/basic/item/retractor,
/obj/basic/item/hemostat,
/turf/open/floor/iron/white,
/area/shuttle/caravan/pirate)
"un" = (
/obj/basic/machinery/atmospherics/pipe/smart/manifold4w/supply/hidden{
	dir = 4
	},
/obj/basic/effect/turf_decal/tile/red{
	dir = 1
	},
/obj/basic/effect/turf_decal/tile/red,
/obj/basic/effect/turf_decal/tile/red{
	dir = 8
	},
/turf/open/floor/iron,
/area/shuttle/caravan/pirate)
"vd" = (
/obj/basic/machinery/atmospherics/pipe/smart/manifold4w/supply/hidden{
	dir = 6
	},
/obj/basic/effect/decal/cleanable/dirt,
/turf/open/floor/iron,
/area/shuttle/caravan/pirate)
"vq" = (
/obj/basic/structure/bed,
/obj/basic/item/bedsheet/brown,
/obj/basic/machinery/firealarm/directional/west,
/turf/open/floor/iron/dark/side{
	dir = 6
	},
/area/shuttle/caravan/pirate)
"vW" = (
/obj/basic/machinery/light/small/directional/east,
/obj/basic/machinery/atmospherics/pipe/smart/manifold4w/supply/hidden,
/obj/basic/structure/cable,
/turf/open/floor/plating,
/area/shuttle/caravan/pirate)
"wL" = (
/obj/basic/machinery/atmospherics/pipe/smart/manifold4w/supply/hidden{
	dir = 4
	},
/obj/basic/machinery/button/door/directional/north{
	id = "caravanpirate_bolt_port";
	name = "External Bolt Control";
	normaldoorcontrol = 1;
	specialfunctions = 4
	},
/turf/open/floor/iron/white/side{
	dir = 1
	},
/area/shuttle/caravan/pirate)
"wX" = (
/obj/basic/machinery/light/small/directional/west,
/obj/basic/effect/turf_decal/tile/red{
	dir = 1
	},
/obj/basic/effect/turf_decal/tile/red{
	dir = 8
	},
/turf/open/floor/iron,
/area/shuttle/caravan/pirate)
"wZ" = (
/obj/basic/machinery/atmospherics/pipe/smart/manifold4w/supply/hidden{
	dir = 4
	},
/obj/basic/effect/turf_decal/tile/neutral{
	dir = 1
	},
/obj/basic/effect/turf_decal/tile/neutral,
/obj/basic/effect/turf_decal/tile/neutral{
	dir = 4
	},
/obj/basic/effect/turf_decal/tile/neutral{
	dir = 8
	},
/turf/open/floor/iron/dark,
/area/shuttle/caravan/pirate)
"xg" = (
/obj/basic/structure/table,
/obj/basic/machinery/microwave{
	pixel_y = 5
	},
/turf/open/floor/iron/dark,
/area/shuttle/caravan/pirate)
"yt" = (
/obj/basic/structure/reagent_dispensers/fueltank,
/obj/basic/effect/turf_decal/stripes/line{
	dir = 4
	},
/turf/open/floor/plating,
/area/shuttle/caravan/pirate)
"yu" = (
/obj/basic/machinery/atmospherics/pipe/smart/manifold4w/supply/hidden{
	dir = 10
	},
/obj/basic/effect/turf_decal/tile/neutral{
	dir = 1
	},
/obj/basic/effect/turf_decal/tile/neutral,
/obj/basic/effect/turf_decal/tile/neutral{
	dir = 4
	},
/obj/basic/effect/turf_decal/tile/neutral{
	dir = 8
	},
/turf/open/floor/iron/dark,
/area/shuttle/caravan/pirate)
"yW" = (
/obj/basic/machinery/atmospherics/components/unary/vent_pump/on{
	dir = 4
	},
/obj/basic/machinery/space_heater,
/obj/basic/effect/turf_decal/stripes/line{
	dir = 6
	},
/turf/open/floor/plating,
/area/shuttle/caravan/pirate)
"zB" = (
/obj/basic/machinery/atmospherics/pipe/smart/manifold4w/supply/hidden{
	dir = 4
	},
/obj/basic/effect/turf_decal/tile/red,
/obj/basic/effect/turf_decal/tile/red{
	dir = 8
	},
/obj/basic/machinery/button/door/directional/south{
	id = "caravanpirate_bolt_starboard";
	name = "External Bolt Control";
	normaldoorcontrol = 1;
	specialfunctions = 4
	},
/turf/open/floor/iron,
/area/shuttle/caravan/pirate)
"Ag" = (
/obj/basic/structure/table/optable,
/obj/basic/effect/turf_decal/bot,
/turf/open/floor/iron/white,
/area/shuttle/caravan/pirate)
"Ah" = (
/obj/basic/effect/mapping_helpers/airlock/cyclelink_helper{
	dir = 1
	},
/obj/basic/effect/mapping_helpers/airlock/locked,
/obj/basic/machinery/door/airlock/external{
	id_tag = "caravanpirate_bolt_starboard"
	},
/turf/open/floor/plating,
/area/shuttle/caravan/pirate)
"Av" = (
/obj/basic/machinery/atmospherics/pipe/smart/manifold4w/supply/hidden{
	dir = 4
	},
/obj/basic/machinery/door/firedoor,
/obj/basic/machinery/door/airlock/medical/glass{
	name = "Medbay"
	},
/obj/basic/effect/decal/cleanable/dirt,
/turf/open/floor/iron,
/area/shuttle/caravan/pirate)
"AP" = (
/obj/basic/structure/sign/departments/medbay/alt,
/turf/closed/wall/mineral/plastitanium/nodiagonal,
/area/shuttle/caravan/pirate)
"Bi" = (
/obj/basic/machinery/door/poddoor{
	id = "caravanpirate_bridge"
	},
/obj/basic/effect/spawner/structure/window/plasma/reinforced/plastitanium,
/turf/open/floor/plating,
/area/shuttle/caravan/pirate)
"BC" = (
/obj/basic/effect/spawner/structure/window/plasma/reinforced/plastitanium,
/obj/basic/machinery/door/poddoor{
	id = "caravanpirate_bridge"
	},
/turf/open/floor/plating,
/area/shuttle/caravan/pirate)
"BI" = (
/obj/basic/structure/table,
/obj/basic/machinery/light/small/directional/west,
/obj/basic/item/stack/spacecash/c200,
/turf/open/floor/iron/dark,
/area/shuttle/caravan/pirate)
"BL" = (
/obj/basic/structure/table,
/obj/basic/machinery/cell_charger,
/obj/basic/item/stack/cable_coil,
/obj/basic/item/stock_parts/cell/high,
/obj/basic/effect/turf_decal/bot,
/turf/open/floor/plating,
/area/shuttle/caravan/pirate)
"Cb" = (
/obj/basic/machinery/power/apc{
	dir = 8;
	name = "Pirate Cutter APC";
	pixel_x = -25
	},
/obj/basic/machinery/atmospherics/pipe/smart/manifold4w/supply/hidden,
/obj/basic/machinery/airalarm/all_access{
	dir = 8;
	pixel_x = 24
	},
/obj/basic/structure/cable,
/turf/open/floor/plating,
/area/shuttle/caravan/pirate)
"DY" = (
/obj/basic/structure/closet/crate/secure/loot,
/obj/basic/machinery/airalarm/all_access{
	pixel_y = 24
	},
/turf/open/floor/iron/dark,
/area/shuttle/caravan/pirate)
"EB" = (
/obj/basic/structure/chair/office{
	dir = 4
	},
/obj/basic/machinery/turretid{
	icon_state = "control_kill";
	lethal = 1;
	locked = 0;
	pixel_y = -30;
	req_access = null
	},
/obj/basic/effect/turf_decal/tile/neutral{
	dir = 1
	},
/obj/basic/effect/turf_decal/tile/neutral,
/obj/basic/effect/turf_decal/tile/neutral{
	dir = 4
	},
/obj/basic/effect/turf_decal/tile/neutral{
	dir = 8
	},
/mob/living/simple_animal/hostile/pirate/ranged{
	environment_smash = 0
	},
/turf/open/floor/iron/dark,
/area/shuttle/caravan/pirate)
"EK" = (
/obj/basic/machinery/atmospherics/components/unary/vent_pump/on{
	dir = 1
	},
/turf/open/floor/iron,
/area/shuttle/caravan/pirate)
"FM" = (
/obj/basic/machinery/power/terminal{
	dir = 1
	},
/obj/basic/structure/closet/crate,
/obj/basic/item/stack/sheet/iron/twenty,
/obj/basic/item/stack/sheet/glass{
	amount = 10
	},
/obj/basic/item/storage/toolbox/mechanical,
/obj/basic/item/flashlight{
	pixel_x = 3;
	pixel_y = 3
	},
/obj/basic/item/stack/sheet/mineral/plasma{
	amount = 20
	},
/obj/basic/effect/turf_decal/stripes/line{
	dir = 4
	},
/obj/basic/structure/cable,
/turf/open/floor/plating,
/area/shuttle/caravan/pirate)
"Gh" = (
/obj/basic/machinery/atmospherics/components/tank/air,
/obj/basic/effect/turf_decal/bot,
/turf/open/floor/plating,
/area/shuttle/caravan/pirate)
"GQ" = (
/obj/basic/machinery/light/small/directional/east,
/obj/basic/machinery/atmospherics/pipe/smart/manifold4w/supply/hidden{
	dir = 9
	},
/obj/basic/effect/turf_decal/tile/red,
/obj/basic/effect/turf_decal/tile/red{
	dir = 8
	},
/turf/open/floor/iron,
/area/shuttle/caravan/pirate)
"GR" = (
/obj/basic/structure/table,
/obj/basic/item/coin/gold,
/obj/basic/item/coin/silver,
/obj/basic/item/coin/silver,
/turf/open/floor/iron/dark,
/area/shuttle/caravan/pirate)
"HD" = (
/obj/basic/structure/shuttle/engine/heater{
	dir = 8
	},
/obj/basic/structure/window/reinforced{
	dir = 4
	},
/turf/open/floor/plating/airless,
/area/shuttle/caravan/pirate)
"HO" = (
/obj/basic/machinery/atmospherics/pipe/smart/manifold4w/supply/hidden{
	dir = 4
	},
/obj/basic/machinery/door/firedoor,
/obj/basic/machinery/door/airlock/security{
	name = "Armory"
	},
/obj/basic/effect/decal/cleanable/dirt,
/turf/open/floor/iron,
/area/shuttle/caravan/pirate)
"II" = (
/obj/basic/structure/closet/crate/freezer/surplus_limbs,
/obj/basic/effect/turf_decal/bot,
/turf/open/floor/iron/white,
/area/shuttle/caravan/pirate)
"Jb" = (
/obj/basic/effect/mapping_helpers/airlock/cyclelink_helper,
/obj/basic/effect/mapping_helpers/airlock/locked,
/obj/basic/machinery/door/airlock/external{
	id_tag = "caravanpirate_bolt_port"
	},
/obj/basic/docking_port/mobile{
	callTime = 150;
	dir = 2;
	dwidth = 14;
	height = 13;
	id = "caravanpirate";
	movement_force = list("KNOCKDOWN" = 0, "THROW" = 0);
	name = "Pirate Cutter";
	port_direction = 8;
	preferred_direction = 4;
	width = 22
	},
/turf/open/floor/plating,
/area/shuttle/caravan/pirate)
"Jv" = (
/turf/template_noop,
/area/template_noop)
"Kd" = (
/obj/basic/machinery/sleeper{
	dir = 1
	},
/obj/basic/effect/turf_decal/delivery,
/obj/basic/machinery/airalarm/all_access{
	dir = 1;
	pixel_y = -24
	},
/turf/open/floor/iron/white,
/area/shuttle/caravan/pirate)
"Ku" = (
/obj/basic/effect/mapping_helpers/airlock/cyclelink_helper,
/obj/basic/effect/mapping_helpers/airlock/locked,
/obj/basic/machinery/door/airlock/external{
	id_tag = "caravanpirate_bolt_starboard"
	},
/turf/open/floor/plating,
/area/shuttle/caravan/pirate)
"Ld" = (
/obj/basic/machinery/suit_storage_unit/open,
/obj/basic/effect/turf_decal/tile/neutral{
	dir = 1
	},
/obj/basic/effect/turf_decal/tile/neutral,
/obj/basic/effect/turf_decal/tile/neutral{
	dir = 4
	},
/obj/basic/effect/turf_decal/tile/neutral{
	dir = 8
	},
/turf/open/floor/iron/dark,
/area/shuttle/caravan/pirate)
"Nx" = (
/obj/basic/structure/shuttle/engine/propulsion/burst/right{
	dir = 8
	},
/turf/open/floor/plating/airless,
/area/shuttle/caravan/pirate)
"NM" = (
/obj/basic/machinery/light/small/directional/west,
/obj/basic/structure/closet/crate/secure/loot,
/obj/basic/machinery/atmospherics/components/unary/vent_pump/on{
	dir = 4
	},
/obj/basic/structure/extinguisher_cabinet{
	pixel_x = -27
	},
/turf/open/floor/iron/dark,
/area/shuttle/caravan/pirate)
"Pc" = (
/obj/basic/structure/sign/departments/engineering,
/turf/closed/wall/mineral/plastitanium/nodiagonal,
/area/shuttle/caravan/pirate)
"Pn" = (
/obj/basic/structure/shuttle/engine/propulsion/burst/left{
	dir = 8
	},
/turf/open/floor/plating/airless,
/area/shuttle/caravan/pirate)
"Rq" = (
/obj/basic/machinery/atmospherics/pipe/smart/manifold4w/supply/hidden{
	dir = 4
	},
/turf/open/floor/iron/white/side{
	dir = 9
	},
/area/shuttle/caravan/pirate)
"Rz" = (
/obj/basic/effect/mapping_helpers/airlock/cyclelink_helper{
	dir = 1
	},
/obj/basic/effect/mapping_helpers/airlock/locked,
/obj/basic/machinery/door/airlock/external{
	id_tag = "caravanpirate_bolt_port"
	},
/turf/open/floor/plating,
/area/shuttle/caravan/pirate)
"RC" = (
/obj/basic/machinery/atmospherics/pipe/smart/manifold4w/supply/hidden{
	dir = 4
	},
/obj/basic/effect/turf_decal/tile/red{
	dir = 1
	},
/obj/basic/effect/turf_decal/tile/red{
	dir = 8
	},
/turf/open/floor/iron/dark,
/area/shuttle/caravan/pirate)
"RK" = (
/obj/basic/machinery/power/smes{
	charge = 5e+006
	},
/obj/basic/effect/turf_decal/stripes/line{
	dir = 5
	},
/obj/basic/structure/cable,
/turf/open/floor/plating,
/area/shuttle/caravan/pirate)
"Sd" = (
/obj/basic/machinery/light/small/directional/west,
/obj/basic/structure/sign/warning/vacuum{
	pixel_x = -32
	},
/turf/open/floor/plating,
/area/shuttle/caravan/pirate)
"Sk" = (
/obj/basic/machinery/atmospherics/pipe/smart/manifold4w/supply/hidden{
	dir = 4
	},
/obj/basic/effect/turf_decal/tile/blue,
/obj/basic/effect/turf_decal/tile/blue{
	dir = 4
	},
/turf/open/floor/iron/dark,
/area/shuttle/caravan/pirate)
"SF" = (
/obj/basic/machinery/atmospherics/pipe/smart/manifold4w/supply/hidden{
	dir = 4
	},
/turf/open/floor/iron/dark/side{
	dir = 4
	},
/area/shuttle/caravan/pirate)
"SR" = (
/obj/basic/machinery/atmospherics/pipe/smart/manifold4w/supply/hidden{
	dir = 9
	},
/obj/basic/machinery/firealarm/directional/south,
/turf/open/floor/iron/dark,
/area/shuttle/caravan/pirate)
"UP" = (
/obj/basic/structure/rack,
/obj/basic/item/storage/toolbox/emergency,
/obj/basic/item/weldingtool,
/obj/basic/effect/turf_decal/tile/red{
	dir = 4
	},
/turf/open/floor/iron/dark,
/area/shuttle/caravan/pirate)
"Wb" = (
/obj/basic/machinery/light/small/directional/south,
/obj/basic/structure/bed,
/obj/basic/item/bedsheet/brown,
/turf/open/floor/iron/dark,
/area/shuttle/caravan/pirate)
"Xq" = (
/obj/basic/structure/table/reinforced,
/obj/basic/machinery/recharger,
/obj/basic/item/melee/baton,
/obj/basic/effect/turf_decal/tile/red,
/turf/open/floor/iron/dark,
/area/shuttle/caravan/pirate)
"Yj" = (
/obj/basic/machinery/porta_turret/syndicate/pod{
	dir = 9;
	faction = list("pirate")
	},
/turf/closed/wall/mineral/plastitanium,
/area/shuttle/caravan/pirate)
"Yo" = (
/obj/basic/structure/table,
/obj/basic/item/storage/box/lethalshot,
/obj/basic/effect/turf_decal/tile/neutral{
	dir = 1
	},
/obj/basic/effect/turf_decal/tile/neutral,
/obj/basic/effect/turf_decal/tile/neutral{
	dir = 4
	},
/obj/basic/effect/turf_decal/tile/neutral{
	dir = 8
	},
/turf/open/floor/iron/dark,
/area/shuttle/caravan/pirate)
"Yw" = (
/obj/basic/machinery/atmospherics/pipe/smart/manifold4w/supply/hidden{
	dir = 4
	},
/turf/open/floor/iron/dark,
/area/shuttle/caravan/pirate)
"Zo" = (
/obj/basic/machinery/atmospherics/pipe/smart/manifold4w/supply/hidden{
	dir = 5
	},
/turf/open/floor/plating,
/area/shuttle/caravan/pirate)
"ZY" = (
/obj/basic/structure/chair/office{
	dir = 8
	},
/obj/basic/effect/turf_decal/tile/neutral{
	dir = 1
	},
/obj/basic/effect/turf_decal/tile/neutral,
/obj/basic/effect/turf_decal/tile/neutral{
	dir = 4
	},
/obj/basic/effect/turf_decal/tile/neutral{
	dir = 8
	},
/turf/open/floor/iron/dark,
/area/shuttle/caravan/pirate)

(1,1,1) = {"
Jv
Jv
Jv
Pn
jU
Nx
Jv
Pn
jU
Nx
Jv
Jv
Jv
"}
(2,1,1) = {"
Jv
Jv
oL
HD
HD
HD
af
HD
HD
HD
oL
Jv
Jv
"}
(3,1,1) = {"
Jv
Yj
af
qX
yt
yW
af
RK
FM
jh
af
eL
Jv
"}
(4,1,1) = {"
Jv
af
Gh
kY
js
fh
Cb
hI
vW
Zo
BL
af
Jv
"}
(5,1,1) = {"
Jv
af
af
th
Pc
af
af
af
Pc
th
af
af
Jv
"}
(6,1,1) = {"
Jv
af
Ld
Rq
oe
ul
af
Yo
wX
un
Ld
af
Jv
"}
(7,1,1) = {"
oL
af
af
na
su
Ag
af
jo
tM
sr
af
af
oL
"}
(8,1,1) = {"
Jb
Sd
Rz
kl
EK
mI
af
pZ
pS
fU
Ku
Sd
Ah
"}
(9,1,1) = {"
oL
af
af
wL
su
Kd
af
oT
hh
zB
af
af
oL
"}
(10,1,1) = {"
Jv
BC
Ld
nD
bH
II
af
iX
vd
GQ
Ld
Bi
Jv
"}
(11,1,1) = {"
Jv
oL
af
AP
Av
af
af
af
HO
af
af
oL
Jv
"}
(12,1,1) = {"
Jv
Jv
af
aE
SF
vq
NM
fS
RC
oF
af
Jv
Jv
"}
(13,1,1) = {"
Jv
Jv
af
hT
yu
hZ
wZ
de
iF
Wb
af
Jv
Jv
"}
(14,1,1) = {"
Jv
Jv
le
af
xg
qC
pK
Sk
ku
af
qo
Jv
Jv
"}
(15,1,1) = {"
Jv
Jv
Jv
oL
af
af
af
mr
af
oL
Jv
Jv
Jv
"}
(16,1,1) = {"
Jv
Jv
Jv
Jv
af
to
BI
Yw
af
Jv
Jv
Jv
Jv
"}
(17,1,1) = {"
Jv
Jv
Jv
Jv
af
GR
ZY
Yw
af
Jv
Jv
Jv
Jv
"}
(18,1,1) = {"
Jv
Jv
Jv
Jv
af
DY
lG
SR
af
Jv
Jv
Jv
Jv
"}
(19,1,1) = {"
Jv
Jv
Jv
Jv
af
UP
dE
Xq
af
Jv
Jv
Jv
Jv
"}
(20,1,1) = {"
Jv
Jv
Jv
Jv
Bi
oO
EB
bd
BC
Jv
Jv
Jv
Jv
"}
(21,1,1) = {"
Jv
Jv
Jv
Jv
BC
BC
fL
BC
BC
Jv
Jv
Jv
Jv
"}
(22,1,1) = {"
Jv
Jv
Jv
Jv
Jv
BC
BC
BC
Jv
Jv
Jv
Jv
Jv
"}
