"a" = (/turf/open/space,/area/space)
"b" = (/turf/closed/wall/mineral/titanium,/area/shuttle/abandoned)
"c" = (/obj/machinery/door/airlock/titanium,/obj/docking_port/mobile{dheight = 0; dir = 2; dwidth = 11; height = 22; id = "whiteship"; launch_status = 0; name = "NT Medical Ship"; roundstart_move = "whiteship_away"; port_angle = 180; width = 35; timid = 1},/turf/open/floor/mineral/titanium,/area/shuttle/abandoned)
"d" = (/obj/machinery/door/airlock/titanium,/turf/open/floor/mineral/titanium,/area/shuttle/abandoned)
"e" = (/obj/structure/shuttle/engine/propulsion{icon_state = "propulsion_l"; dir = 4},/turf/open/floor/plating/airless,/area/shuttle/abandoned)
"f" = (/turf/open/floor/mineral/titanium,/area/shuttle/abandoned)
"g" = (/obj/structure/table,/obj/item/device/radio/off,/turf/open/floor/mineral/titanium,/area/shuttle/abandoned)
"h" = (/obj/structure/table,/obj/item/weapon/screwdriver,/turf/open/floor/mineral/titanium,/area/shuttle/abandoned)
"i" = (/obj/structure/shuttle/engine/propulsion{icon_state = "propulsion"; dir = 4},/turf/open/floor/plating/airless,/area/shuttle/abandoned)
"j" = (/obj/structure/shuttle/engine/heater{icon_state = "heater"; dir = 8},/obj/structure/window/reinforced{dir = 4},/turf/open/floor/plating/airless,/area/shuttle/abandoned)
"k" = (/turf/open/floor/plating,/turf/closed/wall/mineral/titanium/interior,/area/shuttle/abandoned)
"l" = (/obj/machinery/computer/pod{id = "oldship_gun"},/turf/open/floor/mineral/titanium,/area/shuttle/abandoned)
"m" = (/turf/open/floor/plating,/area/shuttle/abandoned)
"n" = (/turf/open/floor/mineral/titanium,/turf/closed/wall/mineral/titanium/interior,/area/shuttle/abandoned)
"o" = (/obj/structure/rack,/obj/item/clothing/suit/space/hardsuit/medical,/obj/item/clothing/mask/breath,/turf/open/floor/mineral/titanium,/area/shuttle/abandoned)
"p" = (/obj/machinery/door/airlock/glass,/turf/open/floor/plating,/area/shuttle/abandoned)
"q" = (/obj/machinery/mass_driver{dir = 4; icon_state = "mass_driver"; id = "oldship_gun"},/turf/open/floor/plating,/area/shuttle/abandoned)
"r" = (/obj/machinery/door/poddoor{id = "oldship_gun"; name = "pod bay door"},/turf/open/floor/plating,/area/shuttle/abandoned)
"s" = (/obj/structure/shuttle/engine/propulsion{icon_state = "propulsion_r"; dir = 4},/turf/open/floor/plating/airless,/area/shuttle/abandoned)
"t" = (/obj/machinery/door/airlock/titanium,/turf/open/floor/plating,/area/shuttle/abandoned)
"u" = (/obj/item/weapon/stock_parts/cell{charge = 100; maxcharge = 15000},/turf/open/floor/mineral/titanium,/area/shuttle/abandoned)
"v" = (/obj/structure/rack,/obj/item/weapon/tank/internals/emergency_oxygen,/obj/item/weapon/tank/internals/emergency_oxygen,/obj/item/weapon/tank/internals/emergency_oxygen,/obj/item/weapon/tank/internals/emergency_oxygen,/obj/item/weapon/storage/toolbox/mechanical,/turf/open/floor/mineral/titanium,/area/shuttle/abandoned)
"w" = (/obj/structure/frame/computer{anchored = 1},/turf/open/floor/mineral/titanium,/area/shuttle/abandoned)
"x" = (/obj/structure/chair{dir = 1},/turf/open/floor/mineral/titanium,/area/shuttle/abandoned)
"y" = (/obj/item/weapon/shard{icon_state = "medium"},/turf/open/floor/mineral/titanium,/area/shuttle/abandoned)
"z" = (/obj/structure/grille,/obj/structure/window/shuttle,/turf/open/floor/plating,/area/shuttle/abandoned)
"A" = (/obj/machinery/door/airlock/titanium,/turf/open/floor/plasteel/shuttle/white,/area/shuttle/abandoned)
"B" = (/obj/machinery/door/window,/turf/open/floor/mineral/titanium/purple,/area/shuttle/abandoned)
"C" = (/obj/structure/bed,/obj/item/weapon/bedsheet,/obj/structure/window/reinforced,/obj/structure/window/reinforced{dir = 4},/turf/open/floor/mineral/titanium/purple,/area/shuttle/abandoned)
"D" = (/obj/structure/table,/turf/open/floor/mineral/titanium,/area/shuttle/abandoned)
"E" = (/obj/structure/table,/obj/item/weapon/gun/energy/laser/retro,/turf/open/floor/mineral/titanium,/area/shuttle/abandoned)
"F" = (/obj/machinery/door/airlock/glass,/turf/open/floor/mineral/titanium,/area/shuttle/abandoned)
"G" = (/obj/machinery/door/airlock/glass,/turf/open/floor/plasteel/shuttle/white,/area/shuttle/abandoned)
"H" = (/obj/structure/chair{dir = 4},/obj/effect/decal/remains/human,/turf/open/floor/mineral/titanium,/area/shuttle/abandoned)
"I" = (/obj/machinery/computer/shuttle/white_ship,/turf/open/floor/mineral/titanium,/area/shuttle/abandoned)
"J" = (/obj/machinery/portable_atmospherics/canister/oxygen,/turf/open/floor/mineral/titanium,/area/shuttle/abandoned)
"K" = (/obj/structure/table,/obj/item/weapon/tank/internals/oxygen,/turf/open/floor/mineral/titanium,/area/shuttle/abandoned)
"L" = (/obj/structure/bed,/obj/item/weapon/bedsheet,/obj/structure/window/reinforced{dir = 1},/obj/structure/window/reinforced{dir = 8},/turf/open/floor/mineral/titanium/purple,/area/shuttle/abandoned)
"M" = (/obj/machinery/door/window/northright,/obj/effect/decal/remains/human,/turf/open/floor/mineral/titanium/purple,/area/shuttle/abandoned)
"N" = (/obj/machinery/portable_atmospherics/scrubber,/turf/open/floor/mineral/titanium,/area/shuttle/abandoned)
"O" = (/obj/item/device/multitool,/turf/open/floor/mineral/titanium,/area/shuttle/abandoned)
"P" = (/obj/structure/chair,/turf/open/floor/mineral/titanium,/area/shuttle/abandoned)
"Q" = (/obj/structure/frame/computer{anchored = 1},/turf/open/floor/plasteel/shuttle/white,/area/shuttle/abandoned)
"R" = (/obj/item/weapon/scalpel,/turf/open/floor/mineral/titanium,/area/shuttle/abandoned)
"S" = (/obj/structure/table,/obj/item/weapon/storage/firstaid/regular{pixel_x = 6; pixel_y = -5},/turf/open/floor/mineral/titanium,/area/shuttle/abandoned)
"T" = (/obj/machinery/sleeper{icon_state = "sleeper-open"; dir = 8},/obj/effect/decal/remains/human,/turf/open/floor/mineral/titanium,/area/shuttle/abandoned)

(1,1,1) = {"
aaaaaaaaaaaaaabbaaaaaabcbbbbbbdbaaa
aaaaaaaaaaaaaaebbaaaabbffghffffbaaa
aaaaaaaaaaaaaaijkbaabbbffffffflbbba
aaaaaaaaaaaaaaijmkbbbnbofffffffpqra
aaaaaaaaaaaaaaijmmbbnfbofffffnbbbbb
aaaaaaaaaaaaaasbkmtfufbnvfffnbnwwnb
aaaaaaaaaaaaaaabbbbfffnbbbdbbnfxxyb
aaaaaaaaaaaaabbbnfbffffffffnbfffffz
bbbbbbbbbbbabbnfffbffbbbAbffbfffffz
bnfffffffnbbbnffffzffbBCfbffzfffDEz
dfffffffffdfdfffffFffbfffbffGfffHIz
bnffffffJnbbbnffffzffbfKfbffzfffDDz
bbbbbbbbbbbabbnfffbffbfLMbffbfffffz
aaaaaaaaaaaaabbbnNbffbAbbbffbDffffz
aaaaaaaaaaaaaaabbbbfffffffffbDffffb
aaaaaaaaaaaaaaebkmtffffffufObDfPfnb
aaaaaaaaaaaaaaijmmbbbbdbbzzzbbnQnbb
aaaaaaaaaaaaaaijmkbbbbfffRffffnbbba
aaaaaaaaaaaaaaijkbaabbnSffffffwbbaa
aaaaaaaaaaaaaasbbaaaabbbnfTffnbbaaa
aaaaaaaaaaaaaabbaaaaaaabbbbbbbaaaaa
aaaaaaaaaaaaaaaaaaaaaaaaaaaaaaaaaaa
"}
