//MAP CONVERTED BY dmm2tgm.py THIS HEADER COMMENT PREVENTS RECONVERSION, DO NOT REMOVE
"aa" = (
/turf/template_noop,
/area/template_noop)
"ab" = (
/turf/closed/wall/mineral/titanium,
/area/shuttle/abandoned)
"ac" = (
/turf/closed/wall/mineral/titanium/nodiagonal,
/area/shuttle/abandoned)
"al" = (
/obj/structure/lattice,
/turf/template_noop,
/area/shuttle/abandoned)
"am" = (
/obj/machinery/power/shuttle_engine/propulsion/right{
	dir = 1
	},
/turf/open/floor/plating/airless,
/area/shuttle/abandoned)
"an" = (
/obj/machinery/power/shuttle_engine/propulsion/left{
	dir = 1
	},
/turf/open/floor/plating/airless,
/area/shuttle/abandoned)
"aq" = (
/turf/template_noop,
/area/shuttle/abandoned)
"ar" = (
/obj/machinery/power/shuttle_engine/heater{
	dir = 1
	},
/obj/structure/window/reinforced/spawner/directional/south,
/turf/open/floor/plating/airless,
/area/shuttle/abandoned)
"aX" = (
/obj/machinery/power/shuttle_engine/heater,
/obj/structure/window/reinforced/spawner/directional/north{
	layer = 2.9
	},
/turf/open/floor/plating/airless,
/area/shuttle/abandoned)
"be" = (
/obj/machinery/power/shuttle_engine/propulsion/left,
/turf/open/floor/plating/airless,
/area/shuttle/abandoned)
"bf" = (
/obj/machinery/power/shuttle_engine/propulsion/right,
/turf/open/floor/plating/airless,
/area/shuttle/abandoned)
"bq" = (
/obj/effect/spawner/structure/window/reinforced/shuttle,
/turf/open/floor/plating,
/area/shuttle/abandoned)
"cm" = (
/obj/effect/decal/cleanable/dirt,
/obj/item/stock_parts/power_store/cell/high,
/turf/open/floor/iron/airless,
/area/shuttle/abandoned)
"da" = (
/obj/machinery/light/small/directional/west,
/obj/structure/table,
/obj/effect/decal/cleanable/dirt,
/obj/item/folder/blue,
/obj/effect/turf_decal/tile/blue/half/contrasted{
	dir = 8
	},
/turf/open/floor/iron/airless,
/area/shuttle/abandoned)
"dh" = (
/obj/effect/decal/cleanable/dirt,
/obj/item/stack/sheet/mineral/titanium,
/turf/open/floor/plating/airless,
/area/shuttle/abandoned)
"eu" = (
/obj/machinery/mech_bay_recharge_port,
/obj/effect/decal/cleanable/dirt,
/turf/open/floor/iron/airless,
/area/shuttle/abandoned)
"eQ" = (
/obj/structure/chair/comfy/shuttle{
	dir = 4
	},
/obj/effect/decal/cleanable/dirt,
/obj/structure/extinguisher_cabinet/directional/north,
/obj/item/storage/toolbox/emergency,
/turf/open/floor/iron/airless,
/area/shuttle/abandoned)
"gf" = (
/obj/effect/decal/cleanable/dirt,
/obj/structure/fluff/paper/stack{
	dir = 4
	},
/obj/item/folder/yellow,
/turf/open/floor/iron/airless,
/area/shuttle/abandoned)
"hp" = (
/obj/effect/decal/cleanable/dirt,
/obj/machinery/light/broken/directional/east,
/obj/structure/closet/emcloset,
/turf/open/floor/iron/airless,
/area/shuttle/abandoned)
"hP" = (
/obj/effect/decal/cleanable/dirt,
/obj/effect/decal/cleanable/oil,
/obj/item/stack/cable_coil,
/turf/open/floor/iron/airless,
/area/shuttle/abandoned)
"iK" = (
/obj/effect/decal/cleanable/dirt,
/obj/structure/rack,
/obj/item/storage/toolbox/mechanical,
/obj/structure/extinguisher_cabinet{
	pixel_x = 24
	},
/turf/open/floor/iron/airless,
/area/shuttle/abandoned)
"iP" = (
/obj/machinery/light/small/directional/east,
/obj/structure/table,
/obj/effect/decal/cleanable/dirt,
/obj/machinery/cell_charger,
/obj/effect/turf_decal/tile/blue/half/contrasted{
	dir = 4
	},
/turf/open/floor/iron/airless,
/area/shuttle/abandoned)
"jd" = (
/obj/effect/decal/cleanable/dirt,
/obj/structure/frame/machine,
/obj/item/stack/cable_coil,
/obj/machinery/light/broken/directional/east,
/turf/open/floor/iron/airless,
/area/shuttle/abandoned)
"jo" = (
/obj/effect/decal/cleanable/dirt,
/obj/item/stack/sheet/iron,
/obj/machinery/power/port_gen/pacman,
/obj/effect/turf_decal/tile/yellow/half/contrasted{
	dir = 8
	},
/turf/open/floor/iron/airless,
/area/shuttle/abandoned)
"jt" = (
/obj/effect/decal/cleanable/dirt,
/obj/machinery/power/smes,
/turf/open/floor/iron/airless,
/area/shuttle/abandoned)
"jP" = (
/obj/effect/decal/cleanable/dirt,
/obj/item/stack/sheet/mineral/plasma{
	amount = 15
	},
/turf/open/floor/plating/airless,
/area/shuttle/abandoned)
"kI" = (
/obj/effect/decal/cleanable/dirt,
/obj/machinery/light/directional/south,
/obj/effect/spawner/random/exotic/ripley,
/turf/open/floor/iron/recharge_floor,
/area/shuttle/abandoned)
"mY" = (
/obj/effect/decal/cleanable/dirt,
/obj/item/stack/sheet/iron{
	amount = 50
	},
/turf/open/floor/iron/airless,
/area/shuttle/abandoned)
"nu" = (
/obj/effect/decal/cleanable/dirt,
/turf/open/floor/iron/showroomfloor/airless,
/area/shuttle/abandoned)
"pM" = (
/obj/effect/decal/cleanable/dirt,
/obj/machinery/door/airlock/titanium{
	name = "Restroom"
	},
/turf/open/floor/iron/showroomfloor/airless,
/area/shuttle/abandoned)
"qy" = (
/obj/effect/decal/cleanable/dirt,
/obj/effect/decal/cleanable/oil/slippery,
/turf/open/floor/plating/airless,
/area/shuttle/abandoned)
"rq" = (
/obj/machinery/light/floor,
/obj/effect/decal/cleanable/dirt,
/obj/item/crowbar/red,
/turf/open/floor/plating/airless,
/area/shuttle/abandoned)
"rt" = (
/obj/effect/decal/cleanable/dirt,
/obj/structure/door_assembly/door_assembly_ext,
/turf/open/floor/plating/airless,
/area/shuttle/abandoned)
"sg" = (
/obj/effect/decal/cleanable/dirt,
/obj/effect/decal/cleanable/generic,
/obj/effect/decal/cleanable/oil,
/turf/open/floor/iron/airless,
/area/shuttle/abandoned)
"sw" = (
/obj/effect/decal/cleanable/dirt,
/obj/effect/decal/cleanable/shreds,
/turf/open/floor/plating/airless,
/area/shuttle/abandoned)
"ui" = (
/obj/effect/decal/cleanable/dirt,
/turf/open/floor/plating/airless,
/area/shuttle/abandoned)
"vu" = (
/obj/structure/table,
/obj/effect/decal/cleanable/dirt,
/obj/effect/turf_decal/tile/blue/anticorner/contrasted,
/turf/open/floor/iron/airless,
/area/shuttle/abandoned)
"vW" = (
/obj/effect/decal/cleanable/dirt,
/obj/item/clothing/suit/space/eva,
/obj/item/clothing/head/helmet/space/eva,
/obj/item/clothing/mask/breath,
/turf/open/floor/plating/airless,
/area/shuttle/abandoned)
"wD" = (
/obj/effect/decal/cleanable/dirt,
/obj/structure/fluff/paper/stack{
	dir = 8
	},
/obj/effect/turf_decal/tile/blue{
	dir = 8
	},
/turf/open/floor/iron/airless,
/area/shuttle/abandoned)
"Bw" = (
/obj/effect/decal/cleanable/dirt,
/obj/structure/sink/directional/east,
/obj/item/soap,
/turf/open/floor/iron/showroomfloor/airless,
/area/shuttle/abandoned)
"Bz" = (
/obj/effect/decal/cleanable/dirt,
/obj/structure/girder,
/turf/open/floor/plating/airless,
/area/shuttle/abandoned)
"BM" = (
/obj/effect/decal/cleanable/dirt,
/obj/effect/decal/cleanable/generic,
/turf/open/floor/iron/airless,
/area/shuttle/abandoned)
"BW" = (
/obj/effect/decal/cleanable/dirt,
/obj/machinery/power/terminal{
	dir = 1
	},
/turf/open/floor/plating/airless,
/area/shuttle/abandoned)
"Cg" = (
/obj/machinery/computer/crew{
	dir = 1
	},
/obj/effect/decal/cleanable/dirt,
/obj/effect/turf_decal/tile/blue/half/contrasted,
/turf/open/floor/iron/airless,
/area/shuttle/abandoned)
"CC" = (
/obj/effect/decal/cleanable/dirt,
/obj/machinery/door/airlock/titanium{
	name = "Cockpit"
	},
/obj/effect/mapping_helpers/airlock/access/all/admin/captain,
/obj/effect/mapping_helpers/airlock/locked,
/turf/open/floor/plating/airless,
/area/shuttle/abandoned)
"Dz" = (
/obj/effect/decal/cleanable/dirt,
/obj/structure/toilet{
	dir = 4
	},
/obj/machinery/door/window/left/directional/east,
/obj/structure/window/reinforced/tinted/spawner/directional/south,
/turf/open/floor/iron/showroomfloor/airless,
/area/shuttle/abandoned)
"DG" = (
/obj/effect/decal/cleanable/dirt,
/obj/structure/mecha_wreckage/ripley,
/turf/open/floor/iron/recharge_floor,
/area/shuttle/abandoned)
"Ef" = (
/obj/effect/decal/cleanable/dirt,
/obj/effect/decal/cleanable/shreds,
/obj/item/storage/medkit/ancient,
/turf/open/floor/plating/airless,
/area/shuttle/abandoned)
"EC" = (
/obj/effect/decal/cleanable/dirt,
/turf/open/floor/iron/airless,
/area/shuttle/abandoned)
"Fs" = (
/obj/structure/chair/comfy/shuttle{
	dir = 8
	},
/obj/effect/decal/cleanable/dirt,
/obj/item/paper,
/turf/open/floor/iron/airless,
/area/shuttle/abandoned)
"Hi" = (
/obj/effect/decal/cleanable/dirt,
/obj/structure/fluff/paper/stack{
	dir = 1
	},
/turf/open/floor/plating/airless,
/area/shuttle/abandoned)
"Hs" = (
/obj/effect/decal/cleanable/dirt,
/obj/machinery/light/directional/west,
/obj/item/stack/sheet/iron,
/obj/structure/tank_dispenser,
/turf/open/floor/iron/airless,
/area/shuttle/abandoned)
"Ic" = (
/obj/effect/decal/cleanable/dirt,
/obj/item/wallframe/apc,
/obj/item/electronics/apc{
	name = "improper power control module"
	},
/turf/open/floor/plating/airless,
/area/shuttle/abandoned)
"Jf" = (
/obj/effect/decal/cleanable/dirt,
/obj/item/stack/sheet/iron,
/turf/open/floor/iron/airless,
/area/shuttle/abandoned)
"KK" = (
/obj/machinery/computer/mech_bay_power_console{
	dir = 1
	},
/obj/effect/decal/cleanable/dirt,
/turf/open/floor/iron/airless,
/area/shuttle/abandoned)
"KL" = (
/obj/effect/decal/cleanable/dirt,
/obj/structure/urinal/directional/east,
/obj/structure/window/reinforced/tinted/spawner/directional/south,
/turf/open/floor/iron/showroomfloor/airless,
/area/shuttle/abandoned)
"KR" = (
/obj/effect/decal/cleanable/dirt,
/obj/item/stack/rods,
/turf/open/floor/plating/airless,
/area/shuttle/abandoned)
"KZ" = (
/obj/effect/decal/cleanable/dirt,
/obj/effect/decal/cleanable/blood/splatter,
/turf/open/floor/plating/airless,
/area/shuttle/abandoned)
"Lb" = (
/obj/effect/decal/cleanable/dirt,
/obj/machinery/door/airlock/external/glass/ruin,
/obj/docking_port/mobile{
	dir = 2;
	shuttle_id = "whiteship";
	launch_status = 0;
	name = "White Ship";
	port_direction = 2
	},
/turf/open/floor/plating/airless,
/area/shuttle/abandoned)
"Ms" = (
/obj/effect/decal/cleanable/dirt,
/obj/effect/decal/cleanable/generic,
/turf/open/floor/plating/airless,
/area/shuttle/abandoned)
"MT" = (
/obj/effect/decal/cleanable/dirt,
/obj/item/storage/toolbox/electrical,
/turf/open/floor/iron/airless,
/area/shuttle/abandoned)
"Ng" = (
/obj/effect/decal/cleanable/dirt,
/obj/effect/turf_decal/tile/yellow/half/contrasted,
/turf/open/floor/iron/airless,
/area/shuttle/abandoned)
"Nm" = (
/obj/effect/decal/cleanable/dirt,
/obj/effect/decal/cleanable/blood/gibs/old,
/obj/item/stack/rods,
/turf/open/floor/iron/airless,
/area/shuttle/abandoned)
"NG" = (
/obj/effect/decal/cleanable/dirt,
/obj/item/stock_parts/power_store/cell/high/empty,
/turf/open/floor/plating/airless,
/area/shuttle/abandoned)
"Ot" = (
/obj/effect/decal/cleanable/dirt,
/obj/machinery/portable_atmospherics/canister/air,
/turf/open/floor/plating/airless,
/area/shuttle/abandoned)
"OK" = (
/obj/structure/table,
/obj/effect/decal/cleanable/dirt,
/obj/effect/turf_decal/tile/blue/anticorner/contrasted{
	dir = 8
	},
/turf/open/floor/iron/airless,
/area/shuttle/abandoned)
"OL" = (
/obj/structure/chair/comfy/shuttle,
/obj/effect/decal/cleanable/dirt,
/obj/item/stack/sheet/mineral/titanium{
	amount = 50
	},
/turf/open/floor/iron/airless,
/area/shuttle/abandoned)
"OT" = (
/obj/machinery/computer/shuttle/white_ship/bridge{
	dir = 1
	},
/obj/effect/decal/cleanable/dirt,
/obj/effect/turf_decal/tile/blue/half/contrasted,
/turf/open/floor/iron/airless,
/area/shuttle/abandoned)
"PT" = (
/obj/structure/girder,
/obj/effect/decal/cleanable/dirt,
/turf/open/floor/plating/airless,
/area/shuttle/abandoned)
"Qx" = (
/obj/effect/decal/cleanable/dirt,
/obj/item/reagent_containers/cup/glass/mug,
/obj/effect/turf_decal/tile/blue,
/turf/open/floor/iron/airless,
/area/shuttle/abandoned)
"SB" = (
/obj/effect/decal/cleanable/dirt,
/obj/effect/decal/cleanable/glass,
/turf/open/floor/plating/airless,
/area/shuttle/abandoned)
"Te" = (
/obj/effect/decal/cleanable/dirt,
/obj/structure/urinal/directional/east,
/obj/structure/window/reinforced/tinted/spawner/directional/north,
/turf/open/floor/iron/showroomfloor/airless,
/area/shuttle/abandoned)
"Wf" = (
/obj/machinery/computer/mech_bay_power_console{
	dir = 8
	},
/obj/effect/decal/cleanable/dirt,
/turf/open/floor/iron/airless,
/area/shuttle/abandoned)
"Xd" = (
/obj/effect/decal/cleanable/dirt,
/obj/item/pen,
/turf/open/floor/plating/airless,
/area/shuttle/abandoned)
"Xk" = (
/obj/structure/table,
/obj/effect/decal/cleanable/dirt,
/obj/item/paper_bin{
	total_paper = 20
	},
/obj/effect/turf_decal/tile/blue/anticorner/contrasted{
	dir = 8
	},
/turf/open/floor/iron/airless,
/area/shuttle/abandoned)
"XY" = (
/obj/machinery/computer/camera_advanced/shuttle_docker/whiteship{
	dir = 1
	},
/obj/effect/decal/cleanable/dirt,
/obj/item/disk/holodisk/donutstation/whiteship,
/obj/effect/turf_decal/tile/blue/half/contrasted,
/turf/open/floor/iron/airless,
/area/shuttle/abandoned)
"YO" = (
/obj/effect/decal/cleanable/dirt,
/obj/machinery/light/directional/south,
/turf/open/floor/iron/showroomfloor/airless,
/area/shuttle/abandoned)
"ZA" = (
/obj/effect/decal/cleanable/dirt,
/obj/machinery/door/airlock/titanium{
	name = "Mech Bay"
	},
/turf/open/floor/plating/airless,
/area/shuttle/abandoned)

(1,1,1) = {"
aa
aa
aa
aa
aa
aa
aa
ab
ab
ab
ab
ab
ab
ab
aa
aa
aa
aa
"}
(2,1,1) = {"
aa
aa
aa
aa
ac
ab
ab
ac
jo
Ic
ac
Dz
Bw
ab
ab
ac
aa
aa
"}
(3,1,1) = {"
aa
aa
aa
aa
am
ar
ab
jt
BW
Ng
pM
nu
YO
ab
aX
be
aa
aa
"}
(4,1,1) = {"
aa
aa
aa
aa
an
ar
ac
PT
NG
ui
ac
KL
Te
ab
aX
bf
aa
aa
"}
(5,1,1) = {"
aa
aa
aa
aa
ac
ac
jP
al
al
al
ac
ab
ab
ab
ab
ab
ab
aa
"}
(6,1,1) = {"
ab
ab
ab
ab
ac
dh
SB
aq
aq
al
Ms
Ef
Nm
ab
da
Xk
ab
ab
"}
(7,1,1) = {"
ab
Hs
vW
ac
Nm
sw
al
aq
aq
aq
aq
KZ
sw
ac
Fs
wD
OK
bq
"}
(8,1,1) = {"
ac
EC
Ms
PT
sw
KZ
al
aq
aq
aq
aq
ui
ui
PT
gf
Xd
XY
bq
"}
(9,1,1) = {"
Lb
ui
rt
al
al
aq
aq
aq
aq
aq
aq
aq
al
CC
rq
OL
OT
bq
"}
(10,1,1) = {"
ac
Jf
ui
al
aq
aq
aq
aq
aq
aq
aq
aq
al
ac
cm
Hi
Cg
bq
"}
(11,1,1) = {"
ab
hp
Ot
PT
al
aq
aq
aq
aq
aq
aq
ui
ui
ab
eQ
Qx
vu
bq
"}
(12,1,1) = {"
ab
ab
ab
ac
PT
aq
aq
aq
al
aq
ui
ui
mY
ab
iP
vu
ab
ab
"}
(13,1,1) = {"
aa
aa
aa
aa
al
aq
aq
al
al
al
ZA
ac
ab
ab
ab
ab
ab
aa
"}
(14,1,1) = {"
aa
aa
aa
aa
al
aq
al
ui
SB
ui
MT
hP
eu
ab
aX
be
aa
aa
"}
(15,1,1) = {"
aa
aa
aa
aa
al
aq
aq
ui
KR
sg
qy
BM
kI
ab
aX
bf
aa
aa
"}
(16,1,1) = {"
aa
aa
aa
aa
al
al
al
Bz
jd
DG
Wf
iK
KK
ab
ab
ac
aa
aa
"}
(17,1,1) = {"
aa
aa
aa
aa
aa
aa
aa
ac
ab
ab
ab
ab
ab
ab
aa
aa
aa
aa
"}
