//MAP CONVERTED BY dmm2tgm.py THIS HEADER COMMENT PREVENTS RECONVERSION, DO NOT REMOVE
"ab" = (
/turf/open/floor/circuit/green/off,
/area/centcom/ctf)
"aL" = (
/obj/effect/turf_decal/tile/yellow/anticorner/contrasted,
/turf/open/floor/iron/dark,
/area/centcom/ctf)
"bF" = (
/obj/effect/turf_decal/tile/red/anticorner/contrasted{
	dir = 8
	},
/turf/open/floor/iron/dark,
/area/centcom/ctf)
"bI" = (
/obj/effect/spawner/structure/window/reinforced/indestructible,
/turf/open/floor/plating,
/area/centcom/ctf)
"cj" = (
/obj/structure/fluff/drake_statue,
/obj/effect/turf_decal/tile/green/fourcorners,
/turf/open/floor/iron/dark,
/area/centcom/ctf)
"cm" = (
/turf/open/floor/plating,
/area/centcom/ctf)
"cx" = (
/obj/structure/trap/ctf/blue,
/obj/effect/turf_decal/tile/blue/fourcorners,
/turf/open/floor/iron/dark,
/area/centcom/ctf)
"cC" = (
/obj/effect/turf_decal/tile/green/half/contrasted,
/turf/open/floor/iron/dark,
/area/centcom/ctf)
"cJ" = (
/turf/closed/indestructible/riveted,
/area/centcom/ctf)
"df" = (
/obj/effect/turf_decal/tile/yellow/fourcorners,
/turf/open/floor/iron/white,
/area/centcom/ctf)
"dn" = (
/obj/effect/turf_decal/tile/blue/half/contrasted{
	dir = 4
	},
/turf/open/floor/iron/dark,
/area/centcom/ctf)
"dr" = (
/obj/effect/turf_decal/tile/red/anticorner/contrasted{
	dir = 1
	},
/turf/open/floor/iron/dark,
/area/centcom/ctf)
"dy" = (
/obj/effect/turf_decal/tile/neutral{
	dir = 1
	},
/turf/open/floor/iron/dark,
/area/centcom/ctf)
"eF" = (
/obj/machinery/ctf/spawner/blue,
/turf/open/floor/circuit/green/off,
/area/centcom/ctf)
"eH" = (
/obj/effect/turf_decal/tile/yellow{
	dir = 8
	},
/turf/open/floor/iron/dark,
/area/centcom/ctf)
"eO" = (
/obj/effect/turf_decal/tile/green/fourcorners,
/turf/open/floor/iron,
/area/centcom/ctf)
"hw" = (
/obj/effect/turf_decal/tile/blue/half/contrasted,
/turf/open/floor/iron/dark,
/area/centcom/ctf)
"hU" = (
/obj/effect/turf_decal/tile/red/half/contrasted{
	dir = 4
	},
/turf/open/floor/iron/dark,
/area/centcom/ctf)
"ie" = (
/obj/effect/turf_decal/tile/yellow/half/contrasted,
/turf/open/floor/iron/dark,
/area/centcom/ctf)
"iF" = (
/turf/open/floor/circuit/green/anim,
/area/centcom/ctf)
"iH" = (
/obj/effect/turf_decal/tile/green/fourcorners,
/turf/open/floor/iron/dark,
/area/centcom/ctf)
"jA" = (
/obj/effect/turf_decal/tile/blue,
/turf/open/floor/iron/dark,
/area/centcom/ctf)
"kA" = (
/obj/effect/turf_decal/tile/yellow/anticorner/contrasted{
	dir = 1
	},
/turf/open/floor/iron/dark,
/area/centcom/ctf)
"kX" = (
/obj/structure/trap/ctf/red,
/obj/effect/turf_decal/tile/red/fourcorners,
/turf/open/floor/iron/dark,
/area/centcom/ctf)
"lZ" = (
/obj/effect/turf_decal/tile/neutral{
	dir = 4
	},
/turf/open/floor/iron/dark,
/area/centcom/ctf)
"mC" = (
/obj/effect/turf_decal/tile/red,
/turf/open/floor/iron/dark,
/area/centcom/ctf)
"mG" = (
/obj/effect/turf_decal/tile/red/anticorner/contrasted{
	dir = 4
	},
/turf/open/floor/iron/dark,
/area/centcom/ctf)
"oD" = (
/obj/effect/turf_decal/stripes/line{
	dir = 8
	},
/obj/effect/turf_decal/stripes/line{
	dir = 4
	},
/turf/open/floor/iron/dark,
/area/centcom/ctf)
"qb" = (
/obj/effect/turf_decal/stripes/line{
	dir = 4
	},
/obj/effect/turf_decal/stripes/line{
	dir = 8
	},
/turf/open/floor/iron/dark,
/area/centcom/ctf)
"qp" = (
/obj/effect/turf_decal/tile/green/fourcorners,
/turf/open/floor/iron/white,
/area/centcom/ctf)
"qy" = (
/obj/effect/turf_decal/tile/green/half/contrasted{
	dir = 8
	},
/turf/open/floor/iron/dark,
/area/centcom/ctf)
"rf" = (
/obj/effect/turf_decal/tile/red/fourcorners,
/turf/open/floor/iron,
/area/centcom/ctf)
"rk" = (
/obj/structure/barricade/security/ctf,
/turf/open/floor/iron/dark,
/area/centcom/ctf)
"rE" = (
/obj/effect/turf_decal/tile/blue/fourcorners,
/turf/open/floor/iron/dark,
/area/centcom/ctf)
"rO" = (
/obj/effect/turf_decal/tile/green{
	dir = 1
	},
/turf/open/floor/iron/dark,
/area/centcom/ctf)
"sq" = (
/obj/structure/barricade/security/ctf,
/turf/open/floor/circuit/green/off,
/area/centcom/ctf)
"sr" = (
/obj/effect/turf_decal/tile/yellow/anticorner/contrasted{
	dir = 8
	},
/turf/open/floor/iron/dark,
/area/centcom/ctf)
"sP" = (
/obj/effect/turf_decal/tile/blue/fourcorners,
/turf/open/floor/iron,
/area/centcom/ctf)
"th" = (
/obj/effect/turf_decal/tile/blue{
	dir = 4
	},
/turf/open/floor/iron/dark,
/area/centcom/ctf)
"tj" = (
/obj/effect/turf_decal/tile/red{
	dir = 1
	},
/turf/open/floor/iron/dark,
/area/centcom/ctf)
"uG" = (
/obj/item/ctf_flag{
	desc = "A banner used to play capture the flag.";
	name = "capture flag"
	},
/turf/open/floor/circuit/green/anim,
/area/centcom/ctf)
"wb" = (
/obj/effect/turf_decal/stripes/line{
	dir = 1
	},
/obj/effect/turf_decal/stripes/line,
/turf/open/floor/iron/dark,
/area/centcom/ctf)
"wf" = (
/obj/effect/turf_decal/tile/red/half/contrasted{
	dir = 8
	},
/turf/open/floor/iron/dark,
/area/centcom/ctf)
"wA" = (
/turf/open/floor/iron/dark,
/area/centcom/ctf)
"xc" = (
/obj/effect/turf_decal/tile/blue/anticorner/contrasted,
/turf/open/floor/iron/dark,
/area/centcom/ctf)
"xd" = (
/obj/effect/turf_decal/tile/red/half/contrasted,
/turf/open/floor/iron/dark,
/area/centcom/ctf)
"xx" = (
/obj/machinery/ctf/spawner/green,
/turf/open/floor/circuit/green/off,
/area/centcom/ctf)
"zp" = (
/obj/structure/fluff/drake_statue,
/obj/effect/turf_decal/tile/yellow/fourcorners,
/turf/open/floor/iron/dark,
/area/centcom/ctf)
"zw" = (
/obj/structure/barricade/security/ctf,
/obj/effect/turf_decal/tile/green/fourcorners,
/turf/open/floor/iron/dark,
/area/centcom/ctf)
"Ad" = (
/obj/effect/turf_decal/tile/yellow/fourcorners,
/turf/open/floor/iron,
/area/centcom/ctf)
"Bl" = (
/obj/structure/barricade/security/ctf,
/obj/effect/turf_decal/tile/yellow/fourcorners,
/turf/open/floor/iron/dark,
/area/centcom/ctf)
"Bt" = (
/obj/effect/turf_decal/tile/blue{
	dir = 1
	},
/turf/open/floor/iron/dark,
/area/centcom/ctf)
"Ci" = (
/obj/effect/turf_decal/tile/green/half/contrasted{
	dir = 1
	},
/turf/open/floor/iron/dark,
/area/centcom/ctf)
"CH" = (
/obj/effect/turf_decal/tile/neutral,
/turf/open/floor/iron/dark,
/area/centcom/ctf)
"CW" = (
/obj/effect/turf_decal/tile/yellow{
	dir = 1
	},
/turf/open/floor/iron/dark,
/area/centcom/ctf)
"DJ" = (
/turf/template_noop,
/area/template_noop)
"DT" = (
/obj/machinery/ctf/spawner/red,
/turf/open/floor/circuit/green/off,
/area/centcom/ctf)
"EZ" = (
/obj/structure/barricade/security/ctf,
/turf/open/floor/plating,
/area/centcom/ctf)
"FW" = (
/obj/machinery/ctf/spawner/yellow,
/turf/open/floor/circuit/green/off,
/area/centcom/ctf)
"Gm" = (
/obj/effect/turf_decal/tile/yellow/half/contrasted{
	dir = 4
	},
/turf/open/floor/iron/dark,
/area/centcom/ctf)
"Gn" = (
/obj/effect/turf_decal/tile/blue/anticorner/contrasted{
	dir = 4
	},
/turf/open/floor/iron/dark,
/area/centcom/ctf)
"Gq" = (
/obj/structure/fluff/drake_statue,
/obj/effect/turf_decal/tile/red/fourcorners,
/turf/open/floor/iron/dark,
/area/centcom/ctf)
"Gv" = (
/obj/structure/barricade/security/ctf,
/obj/effect/turf_decal/tile/blue/fourcorners,
/turf/open/floor/iron/dark,
/area/centcom/ctf)
"Ho" = (
/obj/effect/turf_decal/tile/blue/anticorner/contrasted{
	dir = 8
	},
/turf/open/floor/iron/dark,
/area/centcom/ctf)
"HY" = (
/obj/effect/turf_decal/tile/green/half/contrasted{
	dir = 4
	},
/turf/open/floor/iron/dark,
/area/centcom/ctf)
"Iu" = (
/obj/structure/trap/ctf/yellow,
/obj/effect/turf_decal/tile/yellow/fourcorners,
/turf/open/floor/iron/dark,
/area/centcom/ctf)
"Jq" = (
/obj/structure/trap/ctf/green,
/obj/effect/turf_decal/tile/green/fourcorners,
/turf/open/floor/iron/dark,
/area/centcom/ctf)
"JL" = (
/obj/effect/turf_decal/tile/green/anticorner/contrasted,
/turf/open/floor/iron/dark,
/area/centcom/ctf)
"Kj" = (
/obj/effect/turf_decal/stripes/line,
/obj/effect/turf_decal/stripes/line{
	dir = 1
	},
/turf/open/floor/iron/dark,
/area/centcom/ctf)
"Lz" = (
/turf/closed/wall/mineral/titanium/interior,
/area/centcom/ctf)
"LT" = (
/obj/effect/turf_decal/tile/green,
/turf/open/floor/iron/dark,
/area/centcom/ctf)
"Mg" = (
/obj/effect/turf_decal/tile/red{
	dir = 8
	},
/turf/open/floor/iron/dark,
/area/centcom/ctf)
"MC" = (
/obj/effect/turf_decal/tile/yellow/half/contrasted{
	dir = 8
	},
/turf/open/floor/iron/dark,
/area/centcom/ctf)
"Nc" = (
/obj/effect/turf_decal/tile/green/anticorner/contrasted{
	dir = 1
	},
/turf/open/floor/iron/dark,
/area/centcom/ctf)
"NI" = (
/obj/effect/turf_decal/tile/yellow/half/contrasted{
	dir = 1
	},
/turf/open/floor/iron/dark,
/area/centcom/ctf)
"OO" = (
/obj/effect/turf_decal/tile/blue{
	dir = 8
	},
/turf/open/floor/iron/dark,
/area/centcom/ctf)
"PD" = (
/obj/effect/turf_decal/tile/red{
	dir = 4
	},
/turf/open/floor/iron/dark,
/area/centcom/ctf)
"PY" = (
/obj/effect/turf_decal/tile/blue/half/contrasted{
	dir = 8
	},
/turf/open/floor/iron/dark,
/area/centcom/ctf)
"Qw" = (
/obj/effect/turf_decal/tile/green/anticorner/contrasted{
	dir = 4
	},
/turf/open/floor/iron/dark,
/area/centcom/ctf)
"QH" = (
/obj/structure/fluff/drake_statue,
/obj/effect/turf_decal/tile/blue/fourcorners,
/turf/open/floor/iron/dark,
/area/centcom/ctf)
"QS" = (
/obj/effect/turf_decal/tile/neutral{
	dir = 8
	},
/turf/open/floor/iron/dark,
/area/centcom/ctf)
"QX" = (
/obj/structure/barricade/security/ctf,
/obj/effect/turf_decal/tile/red/fourcorners,
/turf/open/floor/iron/dark,
/area/centcom/ctf)
"Sk" = (
/obj/effect/turf_decal/tile/yellow,
/turf/open/floor/iron/dark,
/area/centcom/ctf)
"UK" = (
/obj/effect/turf_decal/tile/red/fourcorners,
/turf/open/floor/iron/white,
/area/centcom/ctf)
"Xi" = (
/obj/effect/turf_decal/tile/blue/half/contrasted{
	dir = 1
	},
/turf/open/floor/iron/dark,
/area/centcom/ctf)
"XF" = (
/obj/effect/turf_decal/tile/yellow/fourcorners,
/turf/open/floor/iron/dark,
/area/centcom/ctf)
"XG" = (
/obj/effect/turf_decal/tile/green{
	dir = 8
	},
/turf/open/floor/iron/dark,
/area/centcom/ctf)
"XZ" = (
/obj/effect/turf_decal/tile/red/half/contrasted{
	dir = 1
	},
/turf/open/floor/iron/dark,
/area/centcom/ctf)
"Yq" = (
/obj/effect/turf_decal/tile/blue/fourcorners,
/turf/open/floor/iron/white,
/area/centcom/ctf)
"Yv" = (
/obj/effect/turf_decal/tile/yellow{
	dir = 4
	},
/turf/open/floor/iron/dark,
/area/centcom/ctf)
"YJ" = (
/obj/effect/turf_decal/tile/red/fourcorners,
/turf/open/floor/iron/dark,
/area/centcom/ctf)
"Zd" = (
/obj/effect/turf_decal/tile/green{
	dir = 4
	},
/turf/open/floor/iron/dark,
/area/centcom/ctf)

(1,1,1) = {"
DJ
DJ
DJ
DJ
DJ
DJ
DJ
DJ
DJ
DJ
DJ
DJ
DJ
DJ
DJ
DJ
DJ
DJ
DJ
DJ
DJ
DJ
DJ
DJ
DJ
DJ
DJ
DJ
DJ
DJ
DJ
DJ
DJ
cJ
cJ
cJ
cJ
cJ
cJ
cJ
cJ
cJ
cJ
cJ
DJ
DJ
DJ
DJ
DJ
DJ
DJ
DJ
DJ
DJ
DJ
DJ
DJ
DJ
DJ
DJ
DJ
DJ
DJ
DJ
DJ
DJ
DJ
DJ
DJ
DJ
DJ
DJ
DJ
DJ
DJ
DJ
DJ
"}
(2,1,1) = {"
DJ
DJ
DJ
DJ
DJ
DJ
DJ
DJ
DJ
DJ
DJ
DJ
DJ
DJ
DJ
DJ
DJ
DJ
DJ
DJ
DJ
DJ
DJ
DJ
DJ
DJ
cJ
cJ
cJ
cJ
cJ
cJ
cJ
cJ
UK
UK
UK
UK
UK
UK
UK
UK
UK
cJ
cJ
cJ
cJ
cJ
cJ
cJ
cJ
DJ
DJ
DJ
DJ
DJ
DJ
DJ
DJ
DJ
DJ
DJ
DJ
DJ
DJ
DJ
DJ
DJ
DJ
DJ
DJ
DJ
DJ
DJ
DJ
DJ
DJ
"}
(3,1,1) = {"
DJ
DJ
DJ
DJ
DJ
DJ
DJ
DJ
DJ
DJ
DJ
DJ
DJ
DJ
DJ
DJ
DJ
DJ
DJ
DJ
DJ
DJ
DJ
DJ
DJ
DJ
cJ
YJ
YJ
YJ
rf
rf
rf
UK
UK
UK
UK
UK
ab
UK
UK
UK
UK
UK
rf
rf
rf
YJ
YJ
YJ
cJ
DJ
DJ
DJ
DJ
DJ
DJ
DJ
DJ
DJ
DJ
DJ
DJ
DJ
DJ
DJ
DJ
DJ
DJ
DJ
DJ
DJ
DJ
DJ
DJ
DJ
DJ
"}
(4,1,1) = {"
DJ
DJ
DJ
DJ
DJ
DJ
DJ
DJ
DJ
DJ
DJ
DJ
DJ
DJ
DJ
DJ
DJ
DJ
DJ
DJ
DJ
DJ
DJ
DJ
DJ
DJ
cJ
YJ
Gq
YJ
rf
rf
rf
UK
UK
UK
UK
ab
DT
ab
UK
UK
UK
UK
rf
rf
rf
YJ
Gq
YJ
cJ
DJ
DJ
DJ
DJ
DJ
DJ
DJ
DJ
DJ
DJ
DJ
DJ
DJ
DJ
DJ
DJ
DJ
DJ
DJ
DJ
DJ
DJ
DJ
DJ
DJ
DJ
"}
(5,1,1) = {"
DJ
DJ
DJ
DJ
DJ
DJ
DJ
DJ
DJ
DJ
DJ
DJ
DJ
DJ
DJ
DJ
DJ
DJ
DJ
DJ
DJ
DJ
DJ
DJ
DJ
DJ
cJ
YJ
YJ
YJ
rf
rf
rf
UK
UK
UK
UK
UK
ab
UK
UK
UK
UK
UK
rf
rf
rf
YJ
YJ
YJ
cJ
DJ
DJ
DJ
DJ
DJ
DJ
DJ
DJ
DJ
DJ
DJ
DJ
DJ
DJ
DJ
DJ
DJ
DJ
DJ
DJ
DJ
DJ
DJ
DJ
DJ
DJ
"}
(6,1,1) = {"
DJ
DJ
DJ
DJ
DJ
DJ
DJ
DJ
DJ
DJ
DJ
DJ
DJ
DJ
DJ
DJ
DJ
DJ
DJ
DJ
DJ
DJ
DJ
DJ
cJ
cJ
cJ
kX
kX
kX
cJ
cJ
cJ
cJ
UK
UK
UK
UK
UK
UK
UK
UK
UK
cJ
cJ
cJ
cJ
kX
kX
kX
cJ
cJ
cJ
DJ
DJ
DJ
DJ
DJ
DJ
DJ
DJ
DJ
DJ
DJ
DJ
DJ
DJ
DJ
DJ
DJ
DJ
DJ
DJ
DJ
DJ
DJ
DJ
"}
(7,1,1) = {"
DJ
DJ
DJ
DJ
DJ
DJ
DJ
DJ
DJ
DJ
DJ
DJ
DJ
DJ
DJ
DJ
DJ
DJ
DJ
DJ
DJ
DJ
DJ
DJ
cJ
ab
ab
ab
YJ
ab
ab
ab
Lz
cJ
cJ
cJ
cJ
cJ
cJ
cJ
cJ
cJ
cJ
cJ
Lz
ab
ab
ab
YJ
ab
ab
ab
cJ
DJ
DJ
DJ
DJ
DJ
DJ
DJ
DJ
DJ
DJ
DJ
DJ
DJ
DJ
DJ
DJ
DJ
DJ
DJ
DJ
DJ
DJ
DJ
DJ
"}
(8,1,1) = {"
DJ
DJ
DJ
DJ
DJ
DJ
DJ
DJ
DJ
DJ
DJ
DJ
DJ
DJ
DJ
DJ
DJ
DJ
DJ
DJ
DJ
DJ
DJ
DJ
cJ
ab
ab
ab
QX
ab
ab
ab
Lz
cJ
DJ
DJ
DJ
DJ
DJ
DJ
DJ
DJ
DJ
cJ
Lz
ab
ab
ab
QX
ab
ab
ab
cJ
DJ
DJ
DJ
DJ
DJ
DJ
DJ
DJ
DJ
DJ
DJ
DJ
DJ
DJ
DJ
DJ
DJ
DJ
DJ
DJ
DJ
DJ
DJ
DJ
"}
(9,1,1) = {"
DJ
DJ
DJ
DJ
DJ
DJ
DJ
DJ
DJ
DJ
DJ
DJ
DJ
DJ
DJ
DJ
DJ
DJ
DJ
DJ
DJ
DJ
DJ
DJ
cJ
ab
ab
YJ
QX
YJ
ab
ab
Lz
cJ
DJ
DJ
DJ
DJ
DJ
DJ
DJ
DJ
DJ
cJ
Lz
ab
ab
YJ
QX
YJ
ab
ab
cJ
DJ
DJ
DJ
DJ
DJ
DJ
DJ
DJ
DJ
DJ
DJ
DJ
DJ
DJ
DJ
DJ
DJ
DJ
DJ
DJ
DJ
DJ
DJ
DJ
"}
(10,1,1) = {"
DJ
DJ
DJ
DJ
DJ
DJ
DJ
DJ
DJ
DJ
DJ
DJ
DJ
DJ
DJ
DJ
DJ
DJ
DJ
DJ
DJ
DJ
DJ
DJ
cJ
ab
sq
QX
QX
QX
sq
ab
Lz
cJ
DJ
DJ
DJ
DJ
DJ
DJ
DJ
DJ
DJ
cJ
Lz
ab
sq
QX
QX
QX
sq
ab
cJ
DJ
DJ
DJ
DJ
DJ
DJ
DJ
DJ
DJ
DJ
DJ
DJ
DJ
DJ
DJ
DJ
DJ
DJ
DJ
DJ
DJ
DJ
DJ
DJ
"}
(11,1,1) = {"
DJ
DJ
DJ
DJ
DJ
DJ
DJ
DJ
DJ
DJ
DJ
DJ
DJ
DJ
DJ
DJ
DJ
DJ
DJ
DJ
DJ
DJ
DJ
DJ
cJ
ab
ab
YJ
QX
YJ
ab
ab
Lz
cJ
DJ
DJ
DJ
DJ
DJ
DJ
DJ
DJ
DJ
cJ
Lz
ab
ab
YJ
QX
YJ
ab
ab
cJ
DJ
DJ
DJ
DJ
DJ
DJ
DJ
DJ
DJ
DJ
DJ
DJ
DJ
DJ
DJ
DJ
DJ
DJ
DJ
DJ
DJ
DJ
DJ
DJ
"}
(12,1,1) = {"
DJ
DJ
DJ
DJ
DJ
DJ
DJ
DJ
DJ
DJ
DJ
DJ
DJ
DJ
DJ
DJ
DJ
DJ
DJ
DJ
DJ
DJ
DJ
DJ
cJ
ab
ab
ab
QX
ab
ab
ab
Lz
cJ
cJ
cJ
cJ
cJ
cJ
cJ
cJ
cJ
cJ
cJ
Lz
ab
ab
ab
QX
ab
ab
ab
cJ
DJ
DJ
DJ
DJ
DJ
DJ
DJ
DJ
DJ
DJ
DJ
DJ
DJ
DJ
DJ
DJ
DJ
DJ
DJ
DJ
DJ
DJ
DJ
DJ
"}
(13,1,1) = {"
DJ
DJ
DJ
DJ
DJ
DJ
DJ
DJ
DJ
DJ
DJ
DJ
DJ
DJ
DJ
DJ
DJ
DJ
DJ
DJ
DJ
DJ
DJ
DJ
cJ
ab
ab
ab
YJ
ab
ab
ab
Lz
Lz
Lz
Lz
Lz
Lz
Lz
Lz
Lz
Lz
Lz
Lz
Lz
ab
ab
ab
YJ
ab
ab
ab
cJ
DJ
DJ
DJ
DJ
DJ
DJ
DJ
DJ
DJ
DJ
DJ
DJ
DJ
DJ
DJ
DJ
DJ
DJ
DJ
DJ
DJ
DJ
DJ
DJ
"}
(14,1,1) = {"
DJ
DJ
DJ
DJ
DJ
DJ
DJ
DJ
DJ
DJ
DJ
DJ
DJ
DJ
DJ
DJ
DJ
DJ
DJ
DJ
DJ
DJ
DJ
DJ
cJ
ab
ab
ab
YJ
ab
ab
ab
ab
bI
ab
ab
ab
ab
ab
ab
ab
ab
ab
bI
ab
ab
ab
ab
YJ
ab
ab
ab
cJ
DJ
DJ
DJ
DJ
DJ
DJ
DJ
DJ
DJ
DJ
DJ
DJ
DJ
DJ
DJ
DJ
DJ
DJ
DJ
DJ
DJ
DJ
DJ
DJ
"}
(15,1,1) = {"
DJ
DJ
DJ
DJ
DJ
DJ
DJ
DJ
DJ
DJ
DJ
DJ
DJ
DJ
DJ
DJ
DJ
DJ
DJ
DJ
DJ
DJ
DJ
DJ
cJ
ab
ab
ab
YJ
ab
ab
ab
ab
bI
ab
ab
ab
ab
ab
ab
ab
ab
ab
bI
ab
ab
ab
ab
YJ
ab
ab
ab
cJ
DJ
DJ
DJ
DJ
DJ
DJ
DJ
DJ
DJ
DJ
DJ
DJ
DJ
DJ
DJ
DJ
DJ
DJ
DJ
DJ
DJ
DJ
DJ
DJ
"}
(16,1,1) = {"
DJ
DJ
DJ
DJ
DJ
DJ
DJ
DJ
DJ
DJ
DJ
DJ
DJ
DJ
DJ
cJ
cJ
cJ
cJ
cJ
cJ
cJ
cJ
cJ
cJ
ab
ab
YJ
YJ
QX
ab
ab
ab
ab
ab
ab
ab
YJ
YJ
YJ
ab
ab
ab
ab
ab
ab
ab
QX
YJ
YJ
ab
ab
cJ
cJ
cJ
cJ
cJ
cJ
cJ
cJ
cJ
cJ
DJ
DJ
DJ
DJ
DJ
DJ
DJ
DJ
DJ
DJ
DJ
DJ
DJ
DJ
DJ
"}
(17,1,1) = {"
DJ
DJ
DJ
DJ
DJ
DJ
DJ
DJ
DJ
DJ
DJ
DJ
DJ
DJ
DJ
cJ
cm
cm
cm
cm
cm
cm
cm
cm
EZ
ab
ab
YJ
YJ
QX
YJ
YJ
YJ
YJ
YJ
YJ
YJ
YJ
YJ
YJ
YJ
YJ
YJ
YJ
YJ
YJ
YJ
QX
YJ
YJ
ab
ab
EZ
cm
cm
cm
cm
cm
cm
cm
cm
cJ
DJ
DJ
DJ
DJ
DJ
DJ
DJ
DJ
DJ
DJ
DJ
DJ
DJ
DJ
DJ
"}
(18,1,1) = {"
DJ
DJ
DJ
DJ
DJ
DJ
DJ
DJ
DJ
DJ
DJ
DJ
DJ
DJ
DJ
cJ
cm
cm
cm
cm
cm
cm
cm
cm
EZ
ab
ab
QX
QX
QX
ab
ab
ab
ab
ab
sq
ab
YJ
YJ
YJ
ab
sq
ab
ab
ab
ab
ab
QX
QX
QX
ab
ab
EZ
cm
cm
cm
cm
cm
cm
cm
cm
cJ
DJ
DJ
DJ
DJ
DJ
DJ
DJ
DJ
DJ
DJ
DJ
DJ
DJ
DJ
DJ
"}
(19,1,1) = {"
DJ
DJ
DJ
DJ
DJ
DJ
DJ
DJ
DJ
DJ
DJ
DJ
DJ
DJ
DJ
cJ
cm
cm
cJ
cJ
cJ
cJ
cJ
cJ
cJ
ab
ab
ab
ab
ab
ab
ab
ab
bI
ab
sq
sq
ab
YJ
ab
sq
sq
ab
bI
ab
ab
ab
ab
ab
ab
ab
ab
cJ
cJ
cJ
cJ
cJ
cJ
cJ
cm
cm
cJ
DJ
DJ
DJ
DJ
DJ
DJ
DJ
DJ
DJ
DJ
DJ
DJ
DJ
DJ
DJ
"}
(20,1,1) = {"
DJ
DJ
DJ
DJ
DJ
DJ
DJ
DJ
DJ
DJ
DJ
DJ
DJ
DJ
DJ
cJ
cm
cm
cJ
DJ
DJ
DJ
DJ
DJ
cJ
ab
ab
ab
ab
ab
ab
ab
ab
bI
ab
ab
ab
ab
YJ
ab
ab
ab
ab
bI
ab
ab
ab
ab
ab
ab
ab
ab
cJ
DJ
DJ
DJ
DJ
DJ
cJ
cm
cm
cJ
DJ
DJ
DJ
DJ
DJ
DJ
DJ
DJ
DJ
DJ
DJ
DJ
DJ
DJ
DJ
"}
(21,1,1) = {"
DJ
DJ
DJ
DJ
DJ
DJ
DJ
DJ
DJ
DJ
DJ
DJ
DJ
DJ
DJ
cJ
cm
cm
cJ
DJ
DJ
DJ
DJ
cJ
cJ
cJ
bI
bI
cJ
cJ
bI
bI
cJ
cJ
bI
bI
cJ
dr
wf
bF
cJ
bI
bI
cJ
cJ
bI
bI
cJ
cJ
bI
bI
cJ
cJ
cJ
DJ
DJ
DJ
DJ
cJ
cm
cm
cJ
DJ
DJ
DJ
DJ
DJ
DJ
DJ
DJ
DJ
DJ
DJ
DJ
DJ
DJ
DJ
"}
(22,1,1) = {"
DJ
DJ
DJ
DJ
DJ
DJ
DJ
DJ
DJ
DJ
DJ
DJ
DJ
DJ
DJ
cJ
cm
cm
cJ
DJ
DJ
DJ
cJ
cJ
tj
tj
tj
tj
tj
tj
tj
tj
tj
tj
tj
tj
tj
tj
wA
Mg
Mg
Mg
Mg
Mg
Mg
Mg
Mg
Mg
Mg
Mg
Mg
Mg
Mg
cJ
cJ
DJ
DJ
DJ
cJ
cm
cm
cJ
DJ
DJ
DJ
DJ
DJ
DJ
DJ
DJ
DJ
DJ
DJ
DJ
DJ
DJ
DJ
"}
(23,1,1) = {"
DJ
DJ
DJ
DJ
DJ
DJ
DJ
DJ
DJ
DJ
DJ
DJ
DJ
DJ
DJ
cJ
cm
cm
cJ
DJ
DJ
cJ
cJ
tj
tj
wA
wA
wA
wA
wA
wA
wA
wA
wA
wA
wA
wA
wA
wA
wA
wA
wA
wA
wA
wA
wA
wA
wA
wA
wA
wA
wA
Mg
Mg
cJ
cJ
DJ
DJ
cJ
cm
cm
cJ
DJ
DJ
DJ
DJ
DJ
DJ
DJ
DJ
DJ
DJ
DJ
DJ
DJ
DJ
DJ
"}
(24,1,1) = {"
DJ
DJ
DJ
DJ
DJ
DJ
DJ
DJ
DJ
DJ
DJ
DJ
DJ
DJ
DJ
cJ
cm
cm
cJ
DJ
cJ
cJ
rO
rk
wA
rk
wA
wA
wA
wA
wA
wA
wA
wA
wA
wA
wA
wA
wA
wA
wA
wA
wA
wA
wA
wA
wA
wA
wA
wA
wA
rk
wA
rk
eH
cJ
cJ
DJ
cJ
cm
cm
cJ
DJ
DJ
DJ
DJ
DJ
DJ
DJ
DJ
DJ
DJ
DJ
DJ
DJ
DJ
DJ
"}
(25,1,1) = {"
DJ
DJ
DJ
DJ
DJ
cJ
cJ
cJ
cJ
cJ
cJ
cJ
cJ
cJ
cJ
cJ
EZ
EZ
cJ
cJ
cJ
rO
rO
wA
cJ
cJ
cJ
qb
qb
qb
cJ
cJ
cJ
cJ
cJ
bI
bI
bI
bI
bI
bI
bI
cJ
cJ
cJ
cJ
cJ
qb
qb
qb
cJ
cJ
cJ
wA
eH
eH
cJ
cJ
cJ
EZ
EZ
cJ
cJ
cJ
cJ
cJ
cJ
cJ
cJ
cJ
cJ
cJ
DJ
DJ
DJ
DJ
DJ
"}
(26,1,1) = {"
DJ
DJ
DJ
DJ
DJ
cJ
ab
ab
ab
ab
ab
ab
ab
ab
ab
ab
ab
ab
ab
ab
cJ
rO
wA
rk
cJ
rO
rO
wA
wA
wA
rO
rO
rO
rO
rO
wA
wA
wA
wA
wA
wA
wA
Mg
Mg
Mg
Mg
Mg
wA
wA
wA
Mg
Mg
cJ
rk
wA
eH
cJ
ab
ab
ab
ab
ab
ab
ab
ab
ab
ab
ab
ab
ab
ab
cJ
DJ
DJ
DJ
DJ
DJ
"}
(27,1,1) = {"
DJ
cJ
cJ
cJ
cJ
cJ
ab
ab
ab
sq
ab
ab
ab
ab
ab
ab
ab
ab
ab
ab
bI
rO
wA
wA
cJ
rO
wA
wA
wA
wA
wA
wA
wA
wA
wA
wA
wA
wA
wA
wA
wA
wA
wA
wA
wA
wA
wA
wA
wA
wA
wA
Mg
cJ
wA
wA
eH
bI
ab
ab
ab
ab
ab
ab
ab
ab
ab
ab
sq
ab
ab
ab
cJ
cJ
cJ
cJ
cJ
DJ
"}
(28,1,1) = {"
DJ
cJ
iH
iH
iH
Jq
ab
ab
iH
zw
iH
ab
ab
ab
ab
iH
iH
zw
ab
ab
bI
rO
wA
wA
Kj
wA
wA
Lz
Lz
Lz
Lz
oD
oD
oD
oD
oD
oD
oD
oD
oD
oD
oD
oD
oD
oD
oD
Lz
Lz
Lz
Lz
wA
wA
wb
wA
wA
eH
bI
ab
ab
Bl
XF
XF
ab
ab
ab
ab
XF
Bl
XF
ab
ab
Iu
XF
XF
XF
cJ
DJ
"}
(29,1,1) = {"
DJ
cJ
iH
cj
iH
Jq
iH
zw
zw
zw
zw
zw
iH
iH
iH
iH
iH
zw
ab
ab
cJ
rO
wA
wA
Kj
wA
wA
Lz
rO
rO
rO
wA
mC
hU
hU
hU
hU
hU
hU
hU
hU
hU
hU
hU
PD
wA
Mg
Mg
Mg
Lz
wA
wA
wb
wA
wA
eH
cJ
ab
ab
Bl
XF
XF
XF
XF
XF
Bl
Bl
Bl
Bl
Bl
XF
Iu
XF
zp
XF
cJ
DJ
"}
(30,1,1) = {"
DJ
cJ
iH
iH
iH
Jq
ab
ab
iH
zw
iH
ab
ab
ab
ab
zw
zw
zw
ab
ab
cJ
rO
wA
wA
Kj
wA
wA
Lz
rO
wA
wA
wA
xd
QX
QX
cJ
QX
QX
cJ
QX
QX
cJ
QX
QX
XZ
wA
wA
wA
Mg
Lz
wA
wA
wb
wA
wA
eH
cJ
ab
ab
Bl
Bl
Bl
ab
ab
ab
ab
XF
Bl
XF
ab
ab
Iu
XF
XF
XF
cJ
DJ
"}
(31,1,1) = {"
DJ
cJ
eO
eO
eO
cJ
ab
ab
ab
sq
ab
ab
ab
ab
ab
ab
iH
ab
ab
ab
bI
rO
wA
wA
cJ
rO
wA
Lz
rO
wA
wA
wA
Mg
wf
wf
wf
wf
wf
wf
wf
wf
wf
wf
wf
tj
wA
wA
wA
Mg
Lz
wA
Mg
cJ
wA
wA
eH
bI
ab
ab
ab
XF
ab
ab
ab
ab
ab
ab
sq
ab
ab
ab
cJ
Ad
Ad
Ad
cJ
DJ
"}
(32,1,1) = {"
DJ
cJ
eO
eO
eO
cJ
ab
ab
ab
ab
ab
ab
ab
ab
ab
ab
iH
ab
ab
ab
bI
rO
wA
wA
cJ
rO
wA
wb
wA
wA
wA
wA
wA
wA
wA
wA
wA
wA
wA
wA
wA
wA
wA
wA
wA
wA
wA
wA
wA
Kj
wA
Mg
cJ
wA
wA
eH
bI
ab
ab
ab
XF
ab
ab
ab
ab
ab
ab
ab
ab
ab
ab
cJ
Ad
Ad
Ad
cJ
DJ
"}
(33,1,1) = {"
DJ
cJ
eO
eO
eO
cJ
Lz
Lz
Lz
Lz
Lz
Lz
Lz
ab
ab
ab
iH
ab
ab
ab
cJ
rO
wA
wA
cJ
rO
wA
wb
LT
HY
Zd
wA
cJ
cJ
cJ
cJ
cJ
dy
ab
QS
bI
bI
bI
bI
cJ
wA
Sk
Gm
Yv
Kj
wA
Mg
cJ
wA
wA
eH
cJ
ab
ab
ab
XF
ab
ab
ab
Lz
Lz
Lz
Lz
Lz
Lz
Lz
cJ
Ad
Ad
Ad
cJ
DJ
"}
(34,1,1) = {"
cJ
cJ
qp
qp
qp
cJ
cJ
cJ
cJ
cJ
cJ
cJ
Lz
bI
bI
ab
iH
ab
bI
bI
cJ
rO
wA
wA
cJ
rO
wA
wb
cC
zw
Ci
wA
bI
ab
ab
ab
ab
dy
ab
QS
ab
ab
ab
ab
cJ
wA
ie
Bl
NI
Kj
wA
Mg
cJ
wA
wA
eH
cJ
bI
bI
ab
XF
ab
bI
bI
Lz
cJ
cJ
cJ
cJ
cJ
cJ
cJ
df
df
df
cJ
cJ
"}
(35,1,1) = {"
cJ
qp
qp
qp
qp
qp
cJ
DJ
DJ
DJ
DJ
cJ
Lz
ab
ab
ab
iH
ab
ab
ab
bI
rO
wA
wA
cJ
rO
wA
wb
cC
zw
Ci
wA
bI
ab
iH
Zd
LT
dy
ab
QS
PD
mC
YJ
ab
cJ
wA
ie
Bl
NI
Kj
wA
Mg
cJ
wA
wA
eH
bI
ab
ab
ab
XF
ab
ab
ab
Lz
cJ
DJ
DJ
DJ
DJ
cJ
df
df
df
df
df
cJ
"}
(36,1,1) = {"
cJ
qp
qp
qp
qp
qp
cJ
DJ
DJ
DJ
DJ
cJ
Lz
ab
ab
ab
iH
sq
sq
ab
bI
rO
wA
wA
bI
wA
wA
wb
cC
cJ
Ci
wA
bI
ab
XG
iH
JL
dy
ab
QS
mG
YJ
tj
ab
cJ
wA
ie
cJ
NI
Kj
wA
wA
bI
wA
wA
eH
bI
ab
sq
sq
XF
ab
ab
ab
Lz
cJ
DJ
DJ
DJ
DJ
cJ
df
df
df
df
df
cJ
"}
(37,1,1) = {"
cJ
qp
qp
qp
qp
qp
cJ
DJ
DJ
DJ
DJ
cJ
Lz
ab
ab
ab
iH
ab
sq
ab
cJ
rO
wA
wA
bI
wA
wA
wb
cC
zw
Ci
wA
bI
ab
LT
JL
zw
dy
ab
QS
QX
mG
PD
ab
cJ
wA
ie
Bl
NI
Kj
wA
wA
bI
wA
wA
eH
cJ
ab
sq
ab
XF
ab
ab
ab
Lz
cJ
DJ
DJ
DJ
DJ
cJ
df
df
df
df
df
cJ
"}
(38,1,1) = {"
cJ
qp
qp
ab
qp
qp
cJ
DJ
DJ
DJ
DJ
cJ
Lz
ab
ab
iH
iH
iH
ab
ab
Nc
rO
wA
wA
bI
wA
wA
wb
cC
zw
Ci
wA
dy
dy
dy
dy
dy
dy
iF
QS
QS
QS
QS
QS
QS
wA
ie
Bl
NI
Kj
wA
wA
bI
wA
wA
eH
sr
ab
ab
XF
XF
XF
ab
ab
Lz
cJ
DJ
DJ
DJ
DJ
cJ
df
df
ab
df
df
cJ
"}
(39,1,1) = {"
cJ
qp
ab
xx
ab
qp
cJ
DJ
DJ
DJ
DJ
cJ
Lz
ab
ab
iH
iH
iH
iH
iH
Ci
wA
wA
wA
bI
wA
wA
wb
cC
cJ
Ci
wA
ab
ab
ab
ab
ab
iF
uG
iF
ab
ab
ab
ab
ab
wA
ie
cJ
NI
Kj
wA
wA
bI
wA
wA
wA
ie
XF
XF
XF
XF
XF
ab
ab
Lz
cJ
DJ
DJ
DJ
DJ
cJ
df
ab
FW
ab
df
cJ
"}
(40,1,1) = {"
cJ
qp
qp
ab
qp
qp
cJ
DJ
DJ
DJ
DJ
cJ
Lz
ab
ab
iH
iH
iH
ab
ab
Qw
Zd
wA
wA
bI
wA
wA
wb
cC
zw
Ci
wA
lZ
lZ
lZ
lZ
lZ
lZ
iF
CH
CH
CH
CH
CH
CH
wA
ie
Bl
NI
Kj
wA
wA
bI
wA
wA
Sk
aL
ab
ab
XF
XF
XF
ab
ab
Lz
cJ
DJ
DJ
DJ
DJ
cJ
df
df
ab
df
df
cJ
"}
(41,1,1) = {"
cJ
qp
qp
qp
qp
qp
cJ
DJ
DJ
DJ
DJ
cJ
Lz
ab
ab
ab
iH
ab
sq
ab
cJ
Zd
wA
wA
bI
wA
wA
wb
cC
zw
Ci
wA
cJ
ab
OO
Ho
Gv
lZ
ab
CH
Bl
kA
CW
ab
bI
wA
ie
Bl
NI
Kj
wA
wA
bI
wA
wA
Sk
cJ
ab
sq
ab
XF
ab
ab
ab
Lz
cJ
DJ
DJ
DJ
DJ
cJ
df
df
df
df
df
cJ
"}
(42,1,1) = {"
cJ
qp
qp
qp
qp
qp
cJ
DJ
DJ
DJ
DJ
cJ
Lz
ab
ab
ab
iH
sq
sq
ab
bI
Zd
wA
wA
bI
wA
wA
wb
cC
cJ
Ci
wA
cJ
ab
jA
rE
Ho
lZ
ab
CH
kA
XF
Yv
ab
bI
wA
ie
cJ
NI
Kj
wA
wA
bI
wA
wA
Sk
bI
ab
sq
sq
XF
ab
ab
ab
Lz
cJ
DJ
DJ
DJ
DJ
cJ
df
df
df
df
df
cJ
"}
(43,1,1) = {"
cJ
qp
qp
qp
qp
qp
cJ
DJ
DJ
DJ
DJ
cJ
Lz
ab
ab
ab
iH
ab
ab
ab
bI
Zd
wA
wA
cJ
th
wA
wb
cC
zw
Ci
wA
cJ
ab
rE
Bt
OO
lZ
ab
CH
CW
eH
XF
ab
bI
wA
ie
Bl
NI
Kj
wA
Sk
cJ
wA
wA
Sk
bI
ab
ab
ab
XF
ab
ab
ab
Lz
cJ
DJ
DJ
DJ
DJ
cJ
df
df
df
df
df
cJ
"}
(44,1,1) = {"
cJ
cJ
qp
qp
qp
cJ
cJ
cJ
cJ
cJ
cJ
cJ
Lz
bI
bI
ab
iH
ab
bI
bI
cJ
Zd
wA
wA
cJ
th
wA
wb
cC
zw
Ci
wA
cJ
ab
ab
ab
ab
lZ
ab
CH
ab
ab
ab
ab
bI
wA
ie
Bl
NI
Kj
wA
Sk
cJ
wA
wA
Sk
cJ
bI
bI
ab
XF
ab
bI
bI
Lz
cJ
cJ
cJ
cJ
cJ
cJ
cJ
df
df
df
cJ
cJ
"}
(45,1,1) = {"
DJ
cJ
eO
eO
eO
cJ
Lz
Lz
Lz
Lz
Lz
Lz
Lz
ab
ab
ab
iH
ab
ab
ab
cJ
Zd
wA
wA
cJ
th
wA
wb
XG
qy
rO
wA
cJ
bI
bI
bI
bI
lZ
ab
CH
cJ
cJ
cJ
cJ
cJ
wA
eH
MC
CW
Kj
wA
Sk
cJ
wA
wA
Sk
cJ
ab
ab
ab
XF
ab
ab
ab
Lz
Lz
Lz
Lz
Lz
Lz
Lz
cJ
Ad
Ad
Ad
cJ
DJ
"}
(46,1,1) = {"
DJ
cJ
eO
eO
eO
cJ
ab
ab
ab
ab
ab
ab
ab
ab
ab
ab
iH
ab
ab
ab
bI
Zd
wA
wA
cJ
th
wA
wb
wA
wA
wA
wA
wA
wA
wA
wA
wA
wA
wA
wA
wA
wA
wA
wA
wA
wA
wA
wA
wA
Kj
wA
Sk
cJ
wA
wA
Sk
bI
ab
ab
ab
XF
ab
ab
ab
ab
ab
ab
ab
ab
ab
ab
cJ
Ad
Ad
Ad
cJ
DJ
"}
(47,1,1) = {"
DJ
cJ
eO
eO
eO
cJ
ab
ab
ab
sq
ab
ab
ab
ab
ab
ab
iH
ab
ab
ab
bI
Zd
wA
wA
cJ
th
wA
Lz
th
wA
wA
wA
jA
dn
dn
dn
dn
dn
dn
dn
dn
dn
dn
dn
th
wA
wA
wA
Sk
Lz
wA
Sk
cJ
wA
wA
Sk
bI
ab
ab
ab
XF
ab
ab
ab
ab
ab
ab
sq
ab
ab
ab
cJ
Ad
Ad
Ad
cJ
DJ
"}
(48,1,1) = {"
DJ
cJ
iH
iH
iH
Jq
ab
ab
iH
zw
iH
ab
ab
ab
ab
zw
zw
zw
ab
ab
cJ
Zd
wA
wA
Kj
wA
wA
Lz
th
wA
wA
wA
hw
Gv
Gv
cJ
Gv
Gv
cJ
Gv
Gv
cJ
Gv
Gv
Xi
wA
wA
wA
Sk
Lz
wA
wA
wb
wA
wA
Sk
cJ
ab
ab
Bl
Bl
Bl
ab
ab
ab
ab
XF
Bl
XF
ab
ab
Iu
XF
XF
XF
cJ
DJ
"}
(49,1,1) = {"
DJ
cJ
iH
cj
iH
Jq
iH
zw
zw
zw
zw
zw
iH
iH
iH
iH
iH
zw
ab
ab
cJ
Zd
wA
wA
Kj
wA
wA
Lz
th
th
th
wA
OO
PY
PY
PY
PY
PY
PY
PY
PY
PY
PY
PY
Bt
wA
Sk
Sk
Sk
Lz
wA
wA
wb
wA
wA
Sk
cJ
ab
ab
Bl
XF
XF
XF
XF
XF
Bl
Bl
Bl
Bl
Bl
XF
Iu
XF
zp
XF
cJ
DJ
"}
(50,1,1) = {"
DJ
cJ
iH
iH
iH
Jq
ab
ab
iH
zw
iH
ab
ab
ab
ab
iH
iH
zw
ab
ab
bI
Zd
wA
wA
Kj
wA
wA
Lz
Lz
Lz
Lz
qb
qb
qb
qb
qb
qb
qb
qb
qb
qb
qb
qb
qb
qb
qb
Lz
Lz
Lz
Lz
wA
wA
wb
wA
wA
Sk
bI
ab
ab
Bl
XF
XF
ab
ab
ab
ab
XF
Bl
XF
ab
ab
Iu
XF
XF
XF
cJ
DJ
"}
(51,1,1) = {"
DJ
cJ
cJ
cJ
cJ
cJ
ab
ab
ab
sq
ab
ab
ab
ab
ab
ab
ab
ab
ab
ab
bI
Zd
wA
wA
cJ
th
wA
wA
wA
wA
wA
wA
wA
wA
wA
wA
wA
wA
wA
wA
wA
wA
wA
wA
wA
wA
wA
wA
wA
wA
wA
Sk
cJ
wA
wA
Sk
bI
ab
ab
ab
ab
ab
ab
ab
ab
ab
ab
sq
ab
ab
ab
cJ
cJ
cJ
cJ
cJ
DJ
"}
(52,1,1) = {"
DJ
DJ
DJ
DJ
DJ
cJ
ab
ab
ab
ab
ab
ab
ab
ab
ab
ab
ab
ab
ab
ab
cJ
Zd
wA
rk
cJ
th
th
wA
wA
wA
th
th
th
th
th
wA
wA
wA
wA
wA
wA
wA
Sk
Sk
Sk
Sk
Sk
wA
wA
wA
Sk
Sk
cJ
rk
wA
Sk
cJ
ab
ab
ab
ab
ab
ab
ab
ab
ab
ab
ab
ab
ab
ab
cJ
DJ
DJ
DJ
DJ
DJ
"}
(53,1,1) = {"
DJ
DJ
DJ
DJ
DJ
cJ
cJ
cJ
cJ
cJ
cJ
cJ
cJ
cJ
cJ
cJ
EZ
EZ
cJ
cJ
cJ
Zd
Zd
wA
cJ
cJ
cJ
oD
oD
oD
cJ
cJ
cJ
cJ
cJ
bI
bI
bI
bI
bI
bI
bI
cJ
cJ
cJ
cJ
cJ
oD
oD
oD
cJ
cJ
cJ
wA
Sk
Sk
cJ
cJ
cJ
EZ
EZ
cJ
cJ
cJ
cJ
cJ
cJ
cJ
cJ
cJ
cJ
cJ
DJ
DJ
DJ
DJ
DJ
"}
(54,1,1) = {"
DJ
DJ
DJ
DJ
DJ
DJ
DJ
DJ
DJ
DJ
DJ
DJ
DJ
DJ
DJ
cJ
cm
cm
cJ
DJ
cJ
cJ
Zd
rk
wA
rk
wA
wA
wA
wA
wA
wA
wA
wA
wA
wA
wA
wA
wA
wA
wA
wA
wA
wA
wA
wA
wA
wA
wA
wA
wA
rk
wA
rk
Sk
cJ
cJ
DJ
cJ
cm
cm
cJ
DJ
DJ
DJ
DJ
DJ
DJ
DJ
DJ
DJ
DJ
DJ
DJ
DJ
DJ
DJ
"}
(55,1,1) = {"
DJ
DJ
DJ
DJ
DJ
DJ
DJ
DJ
DJ
DJ
DJ
DJ
DJ
DJ
DJ
cJ
cm
cm
cJ
DJ
DJ
cJ
cJ
th
th
wA
wA
wA
wA
wA
wA
wA
wA
wA
wA
wA
wA
wA
wA
wA
wA
wA
wA
wA
wA
wA
wA
wA
wA
wA
wA
wA
jA
jA
cJ
cJ
DJ
DJ
cJ
cm
cm
cJ
DJ
DJ
DJ
DJ
DJ
DJ
DJ
DJ
DJ
DJ
DJ
DJ
DJ
DJ
DJ
"}
(56,1,1) = {"
DJ
DJ
DJ
DJ
DJ
DJ
DJ
DJ
DJ
DJ
DJ
DJ
DJ
DJ
DJ
cJ
cm
cm
cJ
DJ
DJ
DJ
cJ
cJ
th
th
th
th
th
th
th
th
th
th
th
th
th
th
wA
jA
jA
jA
jA
jA
jA
jA
jA
jA
jA
jA
jA
jA
jA
cJ
cJ
DJ
DJ
DJ
cJ
cm
cm
cJ
DJ
DJ
DJ
DJ
DJ
DJ
DJ
DJ
DJ
DJ
DJ
DJ
DJ
DJ
DJ
"}
(57,1,1) = {"
DJ
DJ
DJ
DJ
DJ
DJ
DJ
DJ
DJ
DJ
DJ
DJ
DJ
DJ
DJ
cJ
cm
cm
cJ
DJ
DJ
DJ
DJ
cJ
cJ
cJ
cJ
bI
bI
cJ
bI
bI
cJ
cJ
bI
bI
cJ
Gn
dn
xc
cJ
bI
bI
cJ
cJ
bI
bI
cJ
cJ
bI
bI
cJ
cJ
cJ
DJ
DJ
DJ
DJ
cJ
cm
cm
cJ
DJ
DJ
DJ
DJ
DJ
DJ
DJ
DJ
DJ
DJ
DJ
DJ
DJ
DJ
DJ
"}
(58,1,1) = {"
DJ
DJ
DJ
DJ
DJ
DJ
DJ
DJ
DJ
DJ
DJ
DJ
DJ
DJ
DJ
cJ
cm
cm
cJ
DJ
DJ
DJ
DJ
DJ
cJ
ab
ab
ab
ab
ab
ab
ab
ab
bI
ab
ab
ab
ab
rE
ab
ab
ab
ab
bI
ab
ab
ab
ab
ab
ab
ab
ab
cJ
DJ
DJ
DJ
DJ
DJ
cJ
cm
cm
cJ
DJ
DJ
DJ
DJ
DJ
DJ
DJ
DJ
DJ
DJ
DJ
DJ
DJ
DJ
DJ
"}
(59,1,1) = {"
DJ
DJ
DJ
DJ
DJ
DJ
DJ
DJ
DJ
DJ
DJ
DJ
DJ
DJ
DJ
cJ
cm
cm
cJ
cJ
cJ
cJ
cJ
cJ
cJ
ab
ab
ab
ab
ab
ab
ab
ab
bI
ab
sq
sq
ab
rE
ab
sq
sq
ab
bI
ab
ab
ab
ab
ab
ab
ab
ab
cJ
cJ
cJ
cJ
cJ
cJ
cJ
cm
cm
cJ
DJ
DJ
DJ
DJ
DJ
DJ
DJ
DJ
DJ
DJ
DJ
DJ
DJ
DJ
DJ
"}
(60,1,1) = {"
DJ
DJ
DJ
DJ
DJ
DJ
DJ
DJ
DJ
DJ
DJ
DJ
DJ
DJ
DJ
cJ
cm
cm
cm
cm
cm
cm
cm
cm
EZ
ab
ab
Gv
Gv
Gv
ab
ab
ab
ab
ab
sq
ab
rE
rE
rE
ab
sq
ab
ab
ab
ab
ab
Gv
Gv
Gv
ab
ab
EZ
cm
cm
cm
cm
cm
cm
cm
cm
cJ
DJ
DJ
DJ
DJ
DJ
DJ
DJ
DJ
DJ
DJ
DJ
DJ
DJ
DJ
DJ
"}
(61,1,1) = {"
DJ
DJ
DJ
DJ
DJ
DJ
DJ
DJ
DJ
DJ
DJ
DJ
DJ
DJ
DJ
cJ
cm
cm
cm
cm
cm
cm
cm
cm
EZ
ab
ab
rE
rE
Gv
rE
rE
rE
rE
rE
rE
rE
rE
rE
rE
rE
rE
rE
rE
rE
rE
rE
Gv
rE
rE
ab
ab
EZ
cm
cm
cm
cm
cm
cm
cm
cm
cJ
DJ
DJ
DJ
DJ
DJ
DJ
DJ
DJ
DJ
DJ
DJ
DJ
DJ
DJ
DJ
"}
(62,1,1) = {"
DJ
DJ
DJ
DJ
DJ
DJ
DJ
DJ
DJ
DJ
DJ
DJ
DJ
DJ
DJ
cJ
cJ
cJ
cJ
cJ
cJ
cJ
cJ
cJ
cJ
ab
ab
rE
rE
Gv
ab
ab
ab
ab
ab
ab
ab
rE
rE
rE
ab
ab
ab
ab
ab
ab
ab
Gv
rE
rE
ab
ab
cJ
cJ
cJ
cJ
cJ
cJ
cJ
cJ
cJ
cJ
DJ
DJ
DJ
DJ
DJ
DJ
DJ
DJ
DJ
DJ
DJ
DJ
DJ
DJ
DJ
"}
(63,1,1) = {"
DJ
DJ
DJ
DJ
DJ
DJ
DJ
DJ
DJ
DJ
DJ
DJ
DJ
DJ
DJ
DJ
DJ
DJ
DJ
DJ
DJ
DJ
DJ
DJ
cJ
ab
ab
ab
rE
ab
ab
ab
ab
bI
ab
ab
ab
ab
ab
ab
ab
ab
ab
bI
ab
ab
ab
ab
rE
ab
ab
ab
cJ
DJ
DJ
DJ
DJ
DJ
DJ
DJ
DJ
DJ
DJ
DJ
DJ
DJ
DJ
DJ
DJ
DJ
DJ
DJ
DJ
DJ
DJ
DJ
DJ
"}
(64,1,1) = {"
DJ
DJ
DJ
DJ
DJ
DJ
DJ
DJ
DJ
DJ
DJ
DJ
DJ
DJ
DJ
DJ
DJ
DJ
DJ
DJ
DJ
DJ
DJ
DJ
cJ
ab
ab
ab
rE
ab
ab
ab
ab
bI
ab
ab
ab
ab
ab
ab
ab
ab
ab
bI
ab
ab
ab
ab
rE
ab
ab
ab
cJ
DJ
DJ
DJ
DJ
DJ
DJ
DJ
DJ
DJ
DJ
DJ
DJ
DJ
DJ
DJ
DJ
DJ
DJ
DJ
DJ
DJ
DJ
DJ
DJ
"}
(65,1,1) = {"
DJ
DJ
DJ
DJ
DJ
DJ
DJ
DJ
DJ
DJ
DJ
DJ
DJ
DJ
DJ
DJ
DJ
DJ
DJ
DJ
DJ
DJ
DJ
DJ
cJ
ab
ab
ab
rE
ab
ab
ab
Lz
Lz
Lz
Lz
Lz
Lz
Lz
Lz
Lz
Lz
Lz
Lz
Lz
ab
ab
ab
rE
ab
ab
ab
cJ
DJ
DJ
DJ
DJ
DJ
DJ
DJ
DJ
DJ
DJ
DJ
DJ
DJ
DJ
DJ
DJ
DJ
DJ
DJ
DJ
DJ
DJ
DJ
DJ
"}
(66,1,1) = {"
DJ
DJ
DJ
DJ
DJ
DJ
DJ
DJ
DJ
DJ
DJ
DJ
DJ
DJ
DJ
DJ
DJ
DJ
DJ
DJ
DJ
DJ
DJ
DJ
cJ
ab
ab
ab
Gv
ab
ab
ab
Lz
cJ
cJ
cJ
cJ
cJ
cJ
cJ
cJ
cJ
cJ
cJ
Lz
ab
ab
ab
Gv
ab
ab
ab
cJ
DJ
DJ
DJ
DJ
DJ
DJ
DJ
DJ
DJ
DJ
DJ
DJ
DJ
DJ
DJ
DJ
DJ
DJ
DJ
DJ
DJ
DJ
DJ
DJ
"}
(67,1,1) = {"
DJ
DJ
DJ
DJ
DJ
DJ
DJ
DJ
DJ
DJ
DJ
DJ
DJ
DJ
DJ
DJ
DJ
DJ
DJ
DJ
DJ
DJ
DJ
DJ
cJ
ab
ab
rE
Gv
rE
ab
ab
Lz
cJ
DJ
DJ
DJ
DJ
DJ
DJ
DJ
DJ
DJ
cJ
Lz
ab
ab
rE
Gv
rE
ab
ab
cJ
DJ
DJ
DJ
DJ
DJ
DJ
DJ
DJ
DJ
DJ
DJ
DJ
DJ
DJ
DJ
DJ
DJ
DJ
DJ
DJ
DJ
DJ
DJ
DJ
"}
(68,1,1) = {"
DJ
DJ
DJ
DJ
DJ
DJ
DJ
DJ
DJ
DJ
DJ
DJ
DJ
DJ
DJ
DJ
DJ
DJ
DJ
DJ
DJ
DJ
DJ
DJ
cJ
ab
sq
Gv
Gv
Gv
sq
ab
Lz
cJ
DJ
DJ
DJ
DJ
DJ
DJ
DJ
DJ
DJ
cJ
Lz
ab
sq
Gv
Gv
Gv
sq
ab
cJ
DJ
DJ
DJ
DJ
DJ
DJ
DJ
DJ
DJ
DJ
DJ
DJ
DJ
DJ
DJ
DJ
DJ
DJ
DJ
DJ
DJ
DJ
DJ
DJ
"}
(69,1,1) = {"
DJ
DJ
DJ
DJ
DJ
DJ
DJ
DJ
DJ
DJ
DJ
DJ
DJ
DJ
DJ
DJ
DJ
DJ
DJ
DJ
DJ
DJ
DJ
DJ
cJ
ab
ab
rE
Gv
rE
ab
ab
Lz
cJ
DJ
DJ
DJ
DJ
DJ
DJ
DJ
DJ
DJ
cJ
Lz
ab
ab
rE
Gv
rE
ab
ab
cJ
DJ
DJ
DJ
DJ
DJ
DJ
DJ
DJ
DJ
DJ
DJ
DJ
DJ
DJ
DJ
DJ
DJ
DJ
DJ
DJ
DJ
DJ
DJ
DJ
"}
(70,1,1) = {"
DJ
DJ
DJ
DJ
DJ
DJ
DJ
DJ
DJ
DJ
DJ
DJ
DJ
DJ
DJ
DJ
DJ
DJ
DJ
DJ
DJ
DJ
DJ
DJ
cJ
ab
ab
ab
Gv
ab
ab
ab
Lz
cJ
DJ
DJ
DJ
DJ
DJ
DJ
DJ
DJ
DJ
cJ
Lz
ab
ab
ab
Gv
ab
ab
ab
cJ
DJ
DJ
DJ
DJ
DJ
DJ
DJ
DJ
DJ
DJ
DJ
DJ
DJ
DJ
DJ
DJ
DJ
DJ
DJ
DJ
DJ
DJ
DJ
DJ
"}
(71,1,1) = {"
DJ
DJ
DJ
DJ
DJ
DJ
DJ
DJ
DJ
DJ
DJ
DJ
DJ
DJ
DJ
DJ
DJ
DJ
DJ
DJ
DJ
DJ
DJ
DJ
cJ
ab
ab
ab
rE
ab
ab
ab
Lz
cJ
cJ
cJ
cJ
cJ
cJ
cJ
cJ
cJ
cJ
cJ
Lz
ab
ab
ab
rE
ab
ab
ab
cJ
DJ
DJ
DJ
DJ
DJ
DJ
DJ
DJ
DJ
DJ
DJ
DJ
DJ
DJ
DJ
DJ
DJ
DJ
DJ
DJ
DJ
DJ
DJ
DJ
"}
(72,1,1) = {"
DJ
DJ
DJ
DJ
DJ
DJ
DJ
DJ
DJ
DJ
DJ
DJ
DJ
DJ
DJ
DJ
DJ
DJ
DJ
DJ
DJ
DJ
DJ
DJ
cJ
cJ
cJ
cx
cx
cx
cJ
cJ
cJ
cJ
Yq
Yq
Yq
Yq
Yq
Yq
Yq
Yq
Yq
cJ
cJ
cJ
cJ
cx
cx
cx
cJ
cJ
cJ
DJ
DJ
DJ
DJ
DJ
DJ
DJ
DJ
DJ
DJ
DJ
DJ
DJ
DJ
DJ
DJ
DJ
DJ
DJ
DJ
DJ
DJ
DJ
DJ
"}
(73,1,1) = {"
DJ
DJ
DJ
DJ
DJ
DJ
DJ
DJ
DJ
DJ
DJ
DJ
DJ
DJ
DJ
DJ
DJ
DJ
DJ
DJ
DJ
DJ
DJ
DJ
DJ
DJ
cJ
rE
rE
rE
sP
sP
sP
Yq
Yq
Yq
Yq
Yq
ab
Yq
Yq
Yq
Yq
Yq
sP
sP
sP
rE
rE
rE
cJ
DJ
DJ
DJ
DJ
DJ
DJ
DJ
DJ
DJ
DJ
DJ
DJ
DJ
DJ
DJ
DJ
DJ
DJ
DJ
DJ
DJ
DJ
DJ
DJ
DJ
DJ
"}
(74,1,1) = {"
DJ
DJ
DJ
DJ
DJ
DJ
DJ
DJ
DJ
DJ
DJ
DJ
DJ
DJ
DJ
DJ
DJ
DJ
DJ
DJ
DJ
DJ
DJ
DJ
DJ
DJ
cJ
rE
QH
rE
sP
sP
sP
Yq
Yq
Yq
Yq
ab
eF
ab
Yq
Yq
Yq
Yq
sP
sP
sP
rE
QH
rE
cJ
DJ
DJ
DJ
DJ
DJ
DJ
DJ
DJ
DJ
DJ
DJ
DJ
DJ
DJ
DJ
DJ
DJ
DJ
DJ
DJ
DJ
DJ
DJ
DJ
DJ
DJ
"}
(75,1,1) = {"
DJ
DJ
DJ
DJ
DJ
DJ
DJ
DJ
DJ
DJ
DJ
DJ
DJ
DJ
DJ
DJ
DJ
DJ
DJ
DJ
DJ
DJ
DJ
DJ
DJ
DJ
cJ
rE
rE
rE
sP
sP
sP
Yq
Yq
Yq
Yq
Yq
ab
Yq
Yq
Yq
Yq
Yq
sP
sP
sP
rE
rE
rE
cJ
DJ
DJ
DJ
DJ
DJ
DJ
DJ
DJ
DJ
DJ
DJ
DJ
DJ
DJ
DJ
DJ
DJ
DJ
DJ
DJ
DJ
DJ
DJ
DJ
DJ
DJ
"}
(76,1,1) = {"
DJ
DJ
DJ
DJ
DJ
DJ
DJ
DJ
DJ
DJ
DJ
DJ
DJ
DJ
DJ
DJ
DJ
DJ
DJ
DJ
DJ
DJ
DJ
DJ
DJ
DJ
cJ
cJ
cJ
cJ
cJ
cJ
cJ
cJ
Yq
Yq
Yq
Yq
Yq
Yq
Yq
Yq
Yq
cJ
cJ
cJ
cJ
cJ
cJ
cJ
cJ
DJ
DJ
DJ
DJ
DJ
DJ
DJ
DJ
DJ
DJ
DJ
DJ
DJ
DJ
DJ
DJ
DJ
DJ
DJ
DJ
DJ
DJ
DJ
DJ
DJ
DJ
"}
(77,1,1) = {"
DJ
DJ
DJ
DJ
DJ
DJ
DJ
DJ
DJ
DJ
DJ
DJ
DJ
DJ
DJ
DJ
DJ
DJ
DJ
DJ
DJ
DJ
DJ
DJ
DJ
DJ
DJ
DJ
DJ
DJ
DJ
DJ
DJ
cJ
cJ
cJ
cJ
cJ
cJ
cJ
cJ
cJ
cJ
cJ
DJ
DJ
DJ
DJ
DJ
DJ
DJ
DJ
DJ
DJ
DJ
DJ
DJ
DJ
DJ
DJ
DJ
DJ
DJ
DJ
DJ
DJ
DJ
DJ
DJ
DJ
DJ
DJ
DJ
DJ
DJ
DJ
DJ
"}
