//MAP CONVERTED BY dmm2tgm.py THIS HEADER COMMENT PREVENTS RECONVERSION, DO NOT REMOVE
"ck" = (
/turf/closed/indestructible/syndicate,
/area/ctf)
"cl" = (
/obj/structure/window/reinforced{
	dir = 4;
	resistance_flags = 64
	},
/obj/structure/shuttle/engine/heater{
	dir = 8
	},
/turf/closed/indestructible/syndicate,
/area/ctf)
"cu" = (
/obj/machinery/capture_the_flag/green,
/turf/open/floor/circuit/green,
/area/ctf)
"cy" = (
/obj/machinery/computer{
	dir = 8;
	resistance_flags = 64
	},
/turf/open/floor/pod/light,
/area/ctf)
"cK" = (
/obj/structure/window/shuttle{
	max_integrity = 5000;
	name = "hardened window";
	obj_integrity = 5000
	},
/turf/open/floor/plating,
/area/ctf)
"cO" = (
/obj/item/ctf/green,
/turf/open/floor/circuit/green/anim,
/area/ctf)
"dq" = (
/obj/structure/window/shuttle{
	max_integrity = 5000;
	name = "hardened window";
	obj_integrity = 5000
	},
/obj/structure/window/shuttle{
	max_integrity = 5000;
	name = "hardened window";
	obj_integrity = 5000
	},
/turf/open/floor/plating,
/area/ctf)
"dS" = (
/obj/machinery/computer{
	dir = 4;
	resistance_flags = 64
	},
/turf/open/floor/pod/light,
/area/ctf)
"fa" = (
/obj/structure/shuttle/engine/huge,
/turf/template_noop,
/area/ctf)
"fj" = (
/obj/structure/table/abductor,
/turf/open/floor/plating/abductor2,
/area/ctf)
"fl" = (
/obj/structure/table/abductor,
/turf/open/floor/plating/abductor,
/area/ctf)
"fS" = (
/turf/closed/indestructible/alien,
/area/ctf)
"fU" = (
/turf/closed/indestructible/riveted/plastinum,
/area/ctf)
"gw" = (
/obj/structure/barricade/security/ctf,
/turf/open/floor/mineral/titanium/tiled,
/area/ctf)
"gC" = (
/obj/structure/table/reinforced/ctf,
/turf/open/floor/mineral/plastitanium,
/area/ctf)
"hc" = (
/turf/template_noop,
/area/template_noop)
"ho" = (
/turf/open/floor/circuit/off,
/area/ctf)
"hW" = (
/turf/open/floor/plating/airless,
/area/ctf)
"jq" = (
/obj/structure/barricade/security/ctf,
/turf/open/floor/mineral/titanium/white,
/area/ctf)
"jR" = (
/obj/machinery/door/poddoor/shutters/radiation{
	id = "vault";
	name = "secure containment vault";
	resistance_flags = 64
	},
/turf/open/floor/mineral/titanium/white,
/area/ctf)
"kU" = (
/obj/effect/powerup/ammo,
/turf/open/floor/circuit/red/anim,
/area/ctf)
"lI" = (
/obj/structure/window/reinforced{
	dir = 1;
	resistance_flags = 64
	},
/obj/structure/shuttle/engine/heater,
/turf/closed/indestructible/syndicate,
/area/ctf)
"lS" = (
/obj/structure/sign/warning/radiation/rad_area{
	resistance_flags = 64
	},
/turf/closed/indestructible/riveted/plastinum,
/area/ctf)
"mb" = (
/obj/effect/mob_spawn/human/abductor,
/obj/structure/table/optable/abductor,
/turf/open/floor/plating/abductor2,
/area/centcom)
"me" = (
/turf/open/floor/mineral/plastitanium,
/area/ctf)
"mr" = (
/turf/open/floor/engine,
/area/ctf)
"mW" = (
/turf/open/floor/circuit,
/area/ctf)
"nj" = (
/obj/structure/barricade/security/ctf,
/turf/open/floor/pod/light,
/area/ctf)
"nT" = (
/obj/structure/window/reinforced{
	resistance_flags = 64
	},
/turf/open/floor/mineral/titanium/tiled,
/area/ctf)
"nV" = (
/obj/structure/window/reinforced{
	dir = 8;
	resistance_flags = 64
	},
/turf/open/floor/mineral/titanium/tiled,
/area/ctf)
"oL" = (
/obj/structure/window/reinforced{
	dir = 1;
	resistance_flags = 64
	},
/turf/open/floor/mineral/titanium/tiled,
/area/ctf)
"pR" = (
/obj/machinery/capture_the_flag/red,
/turf/open/floor/circuit/red,
/area/ctf)
"rI" = (
/obj/structure/shuttle/engine/propulsion{
	dir = 4
	},
/turf/open/floor/plating/airless,
/area/ctf)
"rR" = (
/obj/structure/shuttle/engine/large,
/turf/open/floor/plating/airless,
/area/ctf)
"sz" = (
/turf/open/floor/mineral/titanium/purple,
/area/ctf)
"tW" = (
/obj/machinery/button/door{
	id = "vault";
	name = "Vault Access";
	pixel_x = -28;
	resistance_flags = 64
	},
/turf/open/floor/engine,
/area/ctf)
"uz" = (
/obj/structure/table/reinforced/ctf,
/obj/machinery/button/door{
	id = "vault";
	name = "Vault Access";
	resistance_flags = 64
	},
/turf/open/floor/mineral/titanium/white,
/area/ctf)
"wO" = (
/turf/open/floor/pod/dark,
/area/ctf)
"xU" = (
/obj/machinery/computer{
	resistance_flags = 64
	},
/turf/open/floor/mineral/plastitanium,
/area/ctf)
"zx" = (
/turf/open/floor/plating/abductor2,
/area/centcom)
"Cq" = (
/obj/effect/powerup/ammo,
/turf/open/floor/circuit,
/area/ctf)
"CU" = (
/obj/structure/window/reinforced{
	dir = 4;
	resistance_flags = 64
	},
/turf/open/floor/mineral/titanium/tiled,
/area/ctf)
"Db" = (
/turf/open/floor/iron,
/area/ctf)
"FP" = (
/obj/structure/window/reinforced{
	dir = 8;
	resistance_flags = 64
	},
/obj/structure/shuttle/engine/heater{
	dir = 4
	},
/turf/closed/indestructible/syndicate,
/area/ctf)
"Gx" = (
/turf/open/floor/plating/abductor,
/area/centcom)
"HZ" = (
/obj/effect/powerup/speed{
	respawn_time = 600
	},
/turf/open/floor/circuit,
/area/ctf)
"Jt" = (
/turf/open/floor/mineral/titanium/tiled/white,
/area/ctf)
"Ju" = (
/turf/open/floor/circuit/red/anim,
/area/ctf)
"JO" = (
/turf/open/floor/circuit/green,
/area/ctf)
"KO" = (
/obj/structure/shuttle/engine/heater,
/obj/structure/window/reinforced{
	dir = 1
	},
/turf/closed/wall/mineral/titanium,
/area/ctf)
"KZ" = (
/obj/effect/powerup/ammo,
/turf/open/floor/circuit/green/anim,
/area/ctf)
"LQ" = (
/turf/open/floor/circuit/green/anim,
/area/ctf)
"LS" = (
/obj/item/ctf/red,
/turf/open/floor/circuit/red/anim,
/area/ctf)
"MC" = (
/obj/structure/barricade/security/ctf,
/turf/open/floor/iron,
/area/ctf)
"Na" = (
/turf/closed/indestructible/opsglass,
/area/ctf)
"OQ" = (
/obj/structure/barricade/security/ctf,
/turf/open/floor/circuit/off,
/area/ctf)
"OX" = (
/obj/machinery/button/door{
	id = "vault";
	name = "Vault Access";
	pixel_x = 28;
	resistance_flags = 64
	},
/turf/open/floor/engine,
/area/ctf)
"Pn" = (
/obj/structure/trap/ctf/green,
/turf/open/floor/iron,
/area/ctf)
"Qe" = (
/turf/template_noop,
/area/ctf)
"Qt" = (
/turf/open/floor/mineral/titanium/white,
/area/ctf)
"Ri" = (
/obj/structure/trap/ctf/red,
/turf/open/floor/iron,
/area/ctf)
"RV" = (
/turf/open/floor/mineral/titanium/tiled,
/area/ctf)
"SS" = (
/obj/structure/shuttle/engine/propulsion,
/turf/open/floor/plating/airless,
/area/ctf)
"SU" = (
/turf/open/floor/circuit/red,
/area/ctf)
"Tb" = (
/obj/structure/table/reinforced/ctf,
/turf/open/floor/mineral/titanium/white,
/area/ctf)
"Us" = (
/turf/open/floor/pod/light,
/area/ctf)
"Wd" = (
/obj/structure/shuttle/engine/propulsion{
	dir = 8
	},
/turf/open/floor/plating/airless,
/area/ctf)
"Wt" = (
/obj/structure/table/reinforced/ctf,
/turf/open/floor/pod/light,
/area/ctf)
"Zk" = (
/obj/machinery/computer{
	resistance_flags = 64
	},
/turf/open/floor/mineral/titanium/white,
/area/ctf)

(1,1,1) = {"
hc
hc
hc
hc
hc
fU
fU
fU
fU
fU
fU
fU
fU
fU
fU
fU
fU
fU
fU
fU
fU
fU
fU
fU
fU
fU
fU
fU
fU
fU
fU
fU
fU
fU
fU
fU
hc
hc
hc
hc
hc
hc
"}
(2,1,1) = {"
hc
hc
hc
hc
fU
fU
Db
Db
Db
Db
Db
Db
MC
Db
Db
Db
MC
Db
Db
Db
Db
Db
Db
Db
MC
Db
Db
Db
MC
Db
Db
Db
Db
Db
Db
fU
fU
hc
hc
hc
hc
hc
"}
(3,1,1) = {"
hc
hc
hc
hc
fU
Db
Db
MC
Db
Db
Db
Db
Db
Db
Db
Db
Db
Db
Db
ho
SU
ho
Db
Db
Db
Db
Db
Db
Db
Db
Db
Db
Db
MC
Db
Db
fU
hc
hc
hc
hc
hc
"}
(4,1,1) = {"
hc
hc
hc
hc
fU
Db
MC
MC
MC
Db
Db
Db
Db
Db
Db
Db
Db
Db
Db
SU
pR
SU
Db
Db
Db
Db
Db
Db
Db
Db
Db
Db
MC
MC
MC
Db
fU
hc
hc
hc
hc
hc
"}
(5,1,1) = {"
hc
hc
hc
hc
fU
Db
Db
MC
Db
Db
Db
Db
Db
Db
Db
Db
Db
Db
Db
ho
SU
ho
Db
Db
Db
Db
Db
Db
Db
Db
Db
Db
Db
MC
Db
Db
fU
hc
hc
hc
hc
hc
"}
(6,1,1) = {"
hc
hc
hc
hc
fU
Db
Db
Db
Db
Db
Db
Db
MC
Db
Db
Db
MC
Db
Db
Db
Db
Db
Db
Db
MC
Db
Db
Db
MC
Db
Db
Db
Db
Db
Db
Db
fU
hc
hc
hc
hc
hc
"}
(7,1,1) = {"
hc
hc
hc
hc
fU
fU
Ri
Ri
Ri
fU
fU
fU
fU
fU
fU
fU
fU
cK
cK
cK
cK
cK
cK
cK
fU
fU
fU
fU
fU
fU
fU
fU
Ri
Ri
Ri
fU
fU
hc
hc
hc
hc
hc
"}
(8,1,1) = {"
hc
hc
hc
hc
fU
Db
Db
Db
Db
Db
fU
hc
hc
hc
hc
hc
hc
hc
hc
hc
hc
hc
hc
hc
hc
hc
hc
hc
hc
hc
fU
Db
Db
Db
Db
Db
fU
hc
hc
hc
hc
hc
"}
(9,1,1) = {"
hc
hc
hc
hc
fU
Db
Db
MC
Db
Db
fU
hc
hc
hc
hc
hc
ck
hc
hc
hc
hc
hc
hc
hc
ck
hc
hc
hc
hc
hc
fU
Db
Db
MC
Db
Db
fU
hc
hc
hc
hc
hc
"}
(10,1,1) = {"
hc
hc
hc
hc
fU
Db
MC
MC
MC
Db
fU
hc
hc
hc
hc
hc
ck
ck
Wd
Wd
Wd
Wd
Wd
ck
ck
hc
hc
hc
hc
hc
fU
Db
MC
MC
MC
Db
fU
hc
hc
hc
hc
hc
"}
(11,1,1) = {"
hc
hc
hc
hc
fU
Db
Db
MC
Db
Db
fU
hc
hc
hc
hc
hc
ck
ck
cl
cl
cl
cl
cl
ck
ck
hc
hc
hc
hc
hc
fU
Db
Db
MC
Db
Db
fU
hc
hc
hc
hc
hc
"}
(12,1,1) = {"
hc
hc
hc
hc
fU
Db
Db
Db
Db
Db
fU
hc
hc
hc
hc
hc
hc
ck
ck
ho
kU
ho
ck
ck
hc
hc
hc
hc
hc
hc
fU
Db
Db
Db
Db
Db
fU
hc
hc
hc
hc
hc
"}
(13,1,1) = {"
hc
hc
hc
hc
fU
ck
Us
Us
Us
ck
ck
ck
ck
ck
ck
ck
ck
ck
Us
Us
ho
Us
Us
ck
ck
ck
ck
ck
ck
ck
ck
ck
Us
Us
Us
ck
fU
hc
hc
hc
hc
hc
"}
(14,1,1) = {"
hc
hc
hc
hc
hc
ck
wO
wO
wO
wO
wO
wO
wO
wO
wO
wO
wO
wO
Us
Us
nj
Us
Us
wO
wO
wO
wO
wO
wO
wO
wO
wO
wO
wO
wO
ck
hc
hc
hc
hc
hc
hc
"}
(15,1,1) = {"
hc
hc
hc
hc
hc
ck
wO
wO
wO
wO
wO
wO
wO
wO
wO
wO
wO
wO
Us
nj
nj
nj
Us
wO
wO
wO
wO
wO
wO
wO
wO
wO
wO
wO
wO
ck
hc
hc
hc
hc
hc
hc
"}
(16,1,1) = {"
hc
hc
hc
hc
hc
ck
ck
ck
ck
wO
wO
wO
wO
wO
wO
wO
wO
wO
Us
Us
nj
Us
Us
wO
wO
wO
wO
wO
wO
wO
wO
Us
Us
Us
ck
ck
hc
hc
hc
hc
hc
hc
"}
(17,1,1) = {"
hc
hc
hc
hc
hc
hc
hc
hc
ck
ck
ck
Us
Us
Us
ck
wO
wO
ck
Us
Us
Us
Us
Us
wO
wO
wO
wO
wO
wO
ck
ck
Us
Us
Us
fU
hc
hc
hc
hc
hc
hc
hc
"}
(18,1,1) = {"
hc
hc
hc
hc
hc
hc
hc
hc
hc
hc
ck
Us
Us
Us
ck
wO
wO
ck
Us
Us
Us
Us
Us
ck
wO
wO
ck
ck
ck
ck
fU
Us
Us
Us
fU
hc
hc
hc
hc
hc
hc
hc
"}
(19,1,1) = {"
hc
hc
hc
hc
hc
hc
hc
hc
hc
hc
ck
Us
Us
Us
ck
ck
ck
ck
Us
OQ
Ju
OQ
Us
ck
ck
ck
ck
hc
hc
hc
fU
Us
Us
Us
fU
hc
hc
hc
hc
hc
hc
hc
"}
(20,1,1) = {"
hc
hc
hc
hc
hc
hc
hc
hc
hc
hc
ck
Us
Us
Us
ck
hc
hc
ck
Us
Ju
LS
Ju
Us
ck
hc
hc
hc
hc
hc
hc
fU
Us
Us
Us
fU
hc
hc
hc
hc
hc
hc
hc
"}
(21,1,1) = {"
hc
hc
hc
hc
hc
hc
hc
hc
hc
hc
ck
Us
Us
Us
ck
hc
hc
ck
Us
OQ
Ju
OQ
Us
ck
hc
hc
hc
fU
cK
cK
fU
Us
Us
Us
fU
cK
cK
fU
hc
hc
hc
hc
"}
(22,1,1) = {"
hc
hc
hc
hc
hc
hc
hc
hc
hc
hc
ck
Us
Us
Us
ck
hc
hc
ck
Us
Us
Us
Us
Us
ck
hc
hc
fU
fU
RV
RV
sz
sz
sz
sz
sz
RV
RV
fU
fU
hc
hc
hc
"}
(23,1,1) = {"
hc
hc
hc
hc
hc
hc
hc
hc
hc
hc
ck
Us
Us
Us
ck
hc
hc
ck
Na
Wt
cy
Wt
Na
ck
hc
hc
cK
RV
RV
sz
sz
sz
gw
sz
sz
sz
RV
RV
cK
hc
hc
hc
"}
(24,1,1) = {"
hc
hc
hc
hc
hc
hc
hc
hc
hc
hc
ck
Us
Us
Us
ck
hc
hc
hc
Na
Na
Na
Na
Na
hc
hc
hc
cK
RV
sz
sz
sz
RV
RV
RV
sz
sz
sz
RV
cK
hc
hc
hc
"}
(25,1,1) = {"
hc
hc
hc
hc
hc
hc
Na
ck
ck
ck
ck
wO
wO
wO
ck
ck
ck
hc
hc
hc
hc
hc
hc
hc
hc
hc
cK
sz
sz
sz
CU
fS
fS
fS
CU
sz
sz
sz
cK
hc
hc
hc
"}
(26,1,1) = {"
hc
hc
hc
hc
hc
Na
Na
Jt
Jt
Jt
Jt
Jt
Jt
Jt
Jt
lI
SS
hc
hc
hc
hc
hc
hc
hc
hc
hc
fU
sz
sz
nT
fl
zx
Gx
zx
fl
oL
sz
sz
fU
hc
hc
hc
"}
(27,1,1) = {"
hc
hc
hc
hc
hc
Na
gC
me
me
me
me
me
me
me
me
lI
SS
hc
hc
hc
hc
hc
hc
hc
hc
hc
fU
sz
gw
nT
fj
Gx
mb
Gx
fj
oL
gw
sz
fU
hc
hc
hc
"}
(28,1,1) = {"
hc
hc
hc
hc
hc
Na
xU
me
me
gC
gC
gC
gC
me
me
lI
SS
hc
hc
hc
hc
hc
hc
hc
hc
hc
fU
sz
sz
nT
fl
zx
Gx
zx
fl
oL
sz
sz
fU
hc
hc
hc
"}
(29,1,1) = {"
hc
hc
hc
hc
hc
Na
gC
me
me
me
me
me
me
me
me
lI
SS
hc
hc
hc
hc
hc
hc
hc
hc
hc
cK
sz
sz
sz
nV
fS
fS
fS
nV
sz
sz
sz
cK
hc
hc
hc
"}
(30,1,1) = {"
hc
hc
hc
hc
hc
Na
Na
Jt
Jt
Jt
Jt
Jt
Jt
Jt
Jt
lI
SS
hc
hc
hc
hc
hc
hc
hc
hc
hc
cK
RV
sz
sz
sz
RV
RV
RV
sz
sz
sz
RV
cK
hc
hc
hc
"}
(31,1,1) = {"
hc
hc
hc
hc
hc
hc
Na
Us
Us
Us
ck
ck
ck
ck
ck
ck
ck
hc
hc
hc
hc
hc
hc
hc
hc
hc
cK
RV
RV
sz
sz
sz
gw
sz
sz
sz
RV
RV
cK
hc
hc
hc
"}
(32,1,1) = {"
hc
hc
hc
hc
hc
hc
ck
Us
Us
Us
ck
hc
hc
hc
hc
hc
hc
hc
hc
hc
hc
hc
hc
hc
hc
hc
fU
fU
RV
RV
sz
sz
sz
sz
sz
RV
RV
fU
fU
hc
hc
hc
"}
(33,1,1) = {"
hc
hc
hc
hc
hc
hc
ck
Us
Us
Us
ck
hc
hc
hc
hc
hc
hc
hc
hc
hc
hc
hc
hc
hc
hc
hc
hc
fU
cK
cK
fU
Us
Us
Us
fU
cK
cK
fU
hc
hc
hc
hc
"}
(34,1,1) = {"
hc
hc
hc
hc
hc
hc
ck
Us
Us
Us
ck
hc
hc
hc
hc
hc
hc
hc
hc
hc
hc
hc
hc
hc
hc
hc
hc
hc
hc
hc
fU
Us
Us
Us
fU
hc
hc
hc
hc
hc
hc
hc
"}
(35,1,1) = {"
hc
hc
hc
hc
hc
hc
ck
Us
Us
Us
ck
hc
hc
hc
hc
hc
hc
hc
hc
fU
cK
cK
cK
cK
cK
cK
fU
hc
hc
fU
fU
Qt
Qt
Qt
fU
fU
fU
fU
fU
fU
hc
hc
"}
(36,1,1) = {"
hc
hc
hc
hc
hc
hc
ck
Us
Us
Us
ck
hc
hc
hc
fU
cK
cK
cK
cK
fU
Qt
Qt
Qt
Qt
Qt
Qt
fU
fU
fU
fU
Qt
Qt
Qt
Qt
Qt
Qt
Qt
fU
fU
fU
fU
hc
"}
(37,1,1) = {"
hc
hc
hc
hc
hc
hc
ck
Us
Us
Us
fU
cK
cK
cK
fU
Qt
Qt
Qt
Qt
Qt
Qt
Qt
Qt
Qt
Qt
Qt
Qt
Qt
Qt
Qt
Qt
Qt
Qt
Qt
Qt
Qt
Qt
fU
KO
hW
hW
fa
"}
(38,1,1) = {"
hc
hc
hc
hc
hc
hc
fU
Qt
Qt
Qt
fU
Qt
Qt
Qt
Qt
Qt
Qt
Qt
Qt
Qt
Qt
Qt
Qt
Qt
Qt
Qt
Qt
Qt
Qt
Qt
Qt
Qt
Qt
Qt
Qt
Qt
Qt
fU
KO
hW
hW
Qe
"}
(39,1,1) = {"
hc
hc
fU
fU
fU
fU
fU
Qt
Qt
Qt
Qt
Qt
Qt
Qt
Qt
Qt
Qt
Qt
Qt
Qt
Qt
Qt
Tb
Tb
Tb
Qt
Qt
Qt
Qt
Qt
Qt
Qt
Qt
fU
jq
Qt
jq
fU
KO
hW
hW
Qe
"}
(40,1,1) = {"
cK
cK
fU
Tb
fU
Qt
Qt
Qt
Qt
Qt
Qt
Qt
Qt
Qt
Qt
Qt
Qt
Qt
Qt
Qt
fU
lS
fU
fU
fU
lS
fU
Qt
jq
Qt
Qt
jq
Qt
fU
Qt
Qt
Qt
fU
KO
hW
rR
hc
"}
(41,1,1) = {"
cK
Tb
Tb
Qt
fU
Qt
Qt
jq
jq
jq
Qt
Qt
Qt
Qt
Qt
Qt
fU
Qt
Qt
Qt
fU
mr
mr
tW
mr
mr
fU
Qt
jq
Qt
Qt
jq
Qt
fU
Qt
Qt
Qt
fU
KO
hW
hW
hc
"}
(42,1,1) = {"
cK
Zk
Qt
Qt
Qt
Qt
Qt
Qt
Tb
Qt
Qt
Qt
Qt
Qt
Qt
Qt
fU
Qt
Qt
Qt
jR
mr
OQ
mW
OQ
mr
jR
Qt
Qt
Qt
Qt
Qt
Qt
fU
Qt
ho
Qt
fU
KO
hW
hW
fa
"}
(43,1,1) = {"
cK
uz
Qt
Qt
Qt
Qt
Qt
Qt
Tb
Qt
Qt
fU
fU
fU
fU
fU
fU
Qt
Qt
Qt
jR
mr
mW
HZ
mW
mr
jR
Qt
Qt
Qt
Qt
Qt
Qt
fU
ho
Cq
ho
fU
KO
hW
hW
Qe
"}
(44,1,1) = {"
cK
Zk
Qt
Qt
Qt
Qt
Qt
Qt
Tb
Qt
Qt
Qt
Qt
Qt
Qt
Qt
fU
Qt
Qt
Qt
jR
mr
OQ
mW
OQ
mr
jR
Qt
Qt
Qt
Qt
Qt
Qt
fU
Qt
ho
Qt
fU
KO
hW
hW
Qe
"}
(45,1,1) = {"
cK
Tb
Tb
Qt
fU
Qt
Qt
jq
jq
jq
Qt
Qt
Qt
Qt
Qt
Qt
fU
Qt
Qt
Qt
lS
mr
mr
OX
mr
mr
fU
Qt
jq
Qt
Qt
jq
Qt
fU
Qt
Qt
Qt
fU
KO
hW
rR
hc
"}
(46,1,1) = {"
cK
cK
fU
Tb
fU
Qt
Qt
Qt
Qt
Qt
Qt
Qt
Qt
Qt
Qt
Qt
Qt
Qt
Qt
Qt
fU
lS
fU
fU
fU
lS
fU
Qt
jq
Qt
Qt
jq
Qt
fU
Qt
Qt
Qt
fU
KO
hW
hW
hc
"}
(47,1,1) = {"
hc
hc
fU
fU
fU
fU
fU
Qt
Qt
Qt
Qt
Qt
Qt
Qt
Qt
Qt
Qt
Qt
Qt
Qt
Qt
Qt
Tb
Tb
Tb
Qt
Qt
Qt
Qt
Qt
Qt
Qt
Qt
fU
jq
Qt
jq
fU
KO
hW
hW
fa
"}
(48,1,1) = {"
hc
hc
hc
hc
hc
hc
fU
Qt
Qt
Qt
fU
Qt
Qt
Qt
Qt
Qt
Qt
Qt
Qt
Qt
Qt
Qt
Qt
Qt
Qt
Qt
Qt
Qt
Qt
Qt
Qt
Qt
Qt
Qt
Qt
Qt
Qt
fU
KO
hW
hW
Qe
"}
(49,1,1) = {"
hc
hc
hc
hc
hc
hc
ck
Us
Us
Us
fU
cK
cK
cK
fU
Qt
Qt
Qt
Qt
Qt
Qt
Qt
Qt
Qt
Qt
Qt
Qt
Qt
Qt
Qt
Qt
Qt
Qt
Qt
Qt
Qt
Qt
fU
KO
hW
hW
Qe
"}
(50,1,1) = {"
hc
hc
hc
hc
hc
hc
ck
Us
Us
Us
ck
hc
hc
hc
fU
cK
cK
cK
cK
fU
Qt
Qt
Qt
Qt
Qt
Qt
fU
fU
fU
fU
Qt
Qt
Qt
Qt
Qt
Qt
Qt
fU
fU
fU
fU
hc
"}
(51,1,1) = {"
hc
hc
hc
hc
hc
hc
ck
Us
Us
Us
ck
hc
hc
hc
hc
hc
hc
hc
hc
fU
cK
cK
dq
cK
cK
cK
fU
hc
hc
fU
fU
Qt
Qt
Qt
fU
fU
fU
fU
fU
fU
hc
hc
"}
(52,1,1) = {"
hc
hc
hc
hc
hc
hc
ck
Us
Us
Us
ck
hc
hc
hc
hc
hc
hc
hc
hc
hc
hc
hc
hc
hc
hc
hc
hc
hc
hc
hc
fU
Us
Us
Us
fU
hc
hc
hc
hc
hc
hc
hc
"}
(53,1,1) = {"
hc
hc
hc
hc
hc
hc
ck
Us
Us
Us
ck
hc
hc
hc
hc
hc
hc
hc
hc
hc
hc
hc
hc
hc
hc
hc
hc
fU
cK
cK
fU
Us
Us
Us
fU
cK
cK
fU
hc
hc
hc
hc
"}
(54,1,1) = {"
hc
hc
hc
hc
hc
hc
ck
Us
Us
Us
ck
hc
hc
hc
hc
hc
hc
hc
hc
hc
hc
hc
hc
hc
hc
hc
fU
fU
RV
RV
sz
sz
sz
sz
sz
RV
RV
fU
fU
hc
hc
hc
"}
(55,1,1) = {"
hc
hc
hc
hc
hc
hc
Na
Us
Us
Us
ck
ck
ck
ck
ck
ck
ck
hc
hc
hc
hc
hc
hc
hc
hc
hc
cK
RV
RV
sz
sz
sz
gw
sz
sz
sz
RV
RV
cK
hc
hc
hc
"}
(56,1,1) = {"
hc
hc
hc
hc
hc
Na
Na
Jt
Jt
Jt
Jt
Jt
Jt
Jt
Jt
lI
SS
hc
hc
hc
hc
hc
hc
hc
hc
hc
cK
RV
sz
sz
sz
RV
RV
RV
sz
sz
sz
RV
cK
hc
hc
hc
"}
(57,1,1) = {"
hc
hc
hc
hc
hc
Na
gC
me
me
me
me
me
me
me
me
lI
SS
hc
hc
hc
hc
hc
hc
hc
hc
hc
cK
sz
sz
sz
CU
fS
fS
fS
CU
sz
sz
sz
cK
hc
hc
hc
"}
(58,1,1) = {"
hc
hc
hc
hc
hc
Na
xU
me
me
gC
gC
gC
gC
me
me
lI
SS
hc
hc
hc
hc
hc
hc
hc
hc
hc
fU
sz
sz
nT
fl
zx
Gx
zx
fl
oL
sz
sz
fU
hc
hc
hc
"}
(59,1,1) = {"
hc
hc
hc
hc
hc
Na
gC
me
me
me
me
me
me
me
me
lI
SS
hc
hc
hc
hc
hc
hc
hc
hc
hc
fU
sz
gw
nT
fj
Gx
mb
Gx
fj
oL
gw
sz
fU
hc
hc
hc
"}
(60,1,1) = {"
hc
hc
hc
hc
hc
Na
Na
Jt
Jt
Jt
Jt
Jt
Jt
Jt
Jt
lI
SS
hc
hc
hc
hc
hc
hc
hc
hc
hc
fU
sz
sz
nT
fl
zx
Gx
zx
fl
oL
sz
sz
fU
hc
hc
hc
"}
(61,1,1) = {"
hc
hc
hc
hc
hc
hc
Na
ck
ck
ck
ck
Us
Us
Us
ck
ck
ck
hc
hc
hc
hc
hc
hc
hc
hc
hc
cK
sz
sz
sz
nV
fS
fS
fS
nV
sz
sz
sz
cK
hc
hc
hc
"}
(62,1,1) = {"
hc
hc
hc
hc
hc
hc
hc
hc
hc
hc
ck
Us
Us
Us
ck
hc
hc
hc
Na
Na
Na
Na
Na
hc
hc
hc
cK
RV
sz
sz
sz
RV
RV
RV
sz
sz
sz
RV
cK
hc
hc
hc
"}
(63,1,1) = {"
hc
hc
hc
hc
hc
hc
hc
hc
hc
hc
ck
Us
Us
Us
ck
hc
hc
ck
Na
Wt
dS
Wt
Na
ck
hc
hc
cK
RV
RV
sz
sz
sz
gw
sz
sz
sz
RV
RV
cK
hc
hc
hc
"}
(64,1,1) = {"
hc
hc
hc
hc
hc
hc
hc
hc
hc
hc
ck
Us
Us
Us
ck
hc
hc
ck
Us
Us
Us
Us
Us
ck
hc
hc
fU
fU
RV
RV
sz
sz
sz
sz
sz
RV
RV
fU
fU
hc
hc
hc
"}
(65,1,1) = {"
hc
hc
hc
hc
hc
hc
hc
hc
hc
hc
ck
Us
Us
Us
ck
hc
hc
ck
Us
OQ
LQ
OQ
Us
ck
hc
hc
hc
fU
cK
cK
fU
Us
Us
Us
fU
cK
cK
fU
hc
hc
hc
hc
"}
(66,1,1) = {"
hc
hc
hc
hc
hc
hc
hc
hc
hc
hc
ck
Us
Us
Us
ck
hc
hc
ck
Us
LQ
cO
LQ
Us
ck
hc
hc
hc
hc
hc
hc
fU
Us
Us
Us
fU
hc
hc
hc
hc
hc
hc
hc
"}
(67,1,1) = {"
hc
hc
hc
hc
hc
hc
hc
hc
hc
hc
ck
Us
Us
Us
ck
ck
ck
ck
Us
OQ
LQ
OQ
Us
ck
ck
ck
ck
hc
hc
hc
fU
Us
Us
Us
fU
hc
hc
hc
hc
hc
hc
hc
"}
(68,1,1) = {"
hc
hc
hc
hc
hc
hc
hc
hc
hc
hc
ck
Us
Us
Us
ck
wO
wO
ck
Us
Us
Us
Us
Us
wO
wO
wO
ck
ck
ck
ck
fU
Us
Us
Us
fU
hc
hc
hc
hc
hc
hc
hc
"}
(69,1,1) = {"
hc
hc
hc
hc
hc
hc
hc
hc
ck
ck
ck
Us
Us
Us
ck
wO
wO
ck
Us
Us
Us
Us
Us
wO
wO
wO
wO
wO
wO
ck
ck
Us
Us
Us
fU
hc
hc
hc
hc
hc
hc
hc
"}
(70,1,1) = {"
hc
hc
hc
hc
hc
ck
ck
ck
ck
wO
wO
wO
wO
wO
wO
wO
wO
wO
Us
Us
nj
Us
Us
wO
wO
wO
wO
wO
wO
wO
wO
Us
Us
Us
ck
ck
hc
hc
hc
hc
hc
hc
"}
(71,1,1) = {"
hc
hc
hc
hc
hc
ck
wO
wO
wO
wO
wO
wO
wO
wO
wO
wO
wO
wO
Us
nj
nj
nj
Us
wO
wO
wO
wO
wO
wO
wO
wO
wO
wO
wO
wO
ck
hc
hc
hc
hc
hc
hc
"}
(72,1,1) = {"
hc
hc
hc
hc
hc
ck
wO
wO
wO
wO
wO
wO
wO
wO
wO
wO
wO
wO
Us
Us
nj
Us
Us
wO
wO
wO
wO
wO
wO
wO
wO
wO
wO
wO
wO
ck
hc
hc
hc
hc
hc
hc
"}
(73,1,1) = {"
hc
hc
hc
hc
fU
ck
Us
Us
Us
ck
ck
ck
ck
ck
ck
ck
ck
ck
Us
Us
ho
Us
Us
ck
ck
ck
ck
ck
ck
ck
ck
ck
Us
Us
Us
ck
fU
hc
hc
hc
hc
hc
"}
(74,1,1) = {"
hc
hc
hc
hc
fU
Db
Db
Db
Db
Db
fU
hc
hc
hc
hc
hc
hc
ck
ck
ho
KZ
ho
ck
ck
hc
hc
hc
hc
hc
hc
fU
Db
Db
Db
Db
Db
fU
hc
hc
hc
hc
hc
"}
(75,1,1) = {"
hc
hc
hc
hc
fU
Db
Db
MC
Db
Db
fU
hc
hc
hc
hc
hc
ck
ck
FP
FP
FP
FP
FP
ck
ck
hc
hc
hc
hc
hc
fU
Db
Db
MC
Db
Db
fU
hc
hc
hc
hc
hc
"}
(76,1,1) = {"
hc
hc
hc
hc
fU
Db
MC
MC
MC
Db
fU
hc
hc
hc
hc
hc
ck
ck
rI
rI
rI
rI
rI
ck
ck
hc
hc
hc
hc
hc
fU
Db
MC
MC
MC
Db
fU
hc
hc
hc
hc
hc
"}
(77,1,1) = {"
hc
hc
hc
hc
fU
Db
Db
MC
Db
Db
fU
hc
hc
hc
hc
hc
ck
hc
hc
hc
hc
hc
hc
hc
ck
hc
hc
hc
hc
hc
fU
Db
Db
MC
Db
Db
fU
hc
hc
hc
hc
hc
"}
(78,1,1) = {"
hc
hc
hc
hc
fU
Db
Db
Db
Db
Db
fU
hc
hc
hc
hc
hc
hc
hc
hc
hc
hc
hc
hc
hc
hc
hc
hc
hc
hc
hc
fU
Db
Db
Db
Db
Db
fU
hc
hc
hc
hc
hc
"}
(79,1,1) = {"
hc
hc
hc
hc
fU
fU
Pn
Pn
Pn
fU
fU
fU
fU
fU
fU
fU
fU
cK
cK
cK
cK
cK
cK
cK
fU
fU
fU
fU
fU
fU
fU
fU
Pn
Pn
Pn
fU
fU
hc
hc
hc
hc
hc
"}
(80,1,1) = {"
hc
hc
hc
hc
fU
Db
Db
Db
Db
Db
Db
Db
MC
Db
Db
Db
MC
Db
Db
Db
Db
Db
Db
Db
MC
Db
Db
Db
MC
Db
Db
Db
Db
Db
Db
Db
fU
hc
hc
hc
hc
hc
"}
(81,1,1) = {"
hc
hc
hc
hc
fU
Db
Db
MC
Db
Db
Db
Db
Db
Db
Db
Db
Db
Db
Db
ho
JO
ho
Db
Db
Db
Db
Db
Db
Db
Db
Db
Db
Db
MC
Db
Db
fU
hc
hc
hc
hc
hc
"}
(82,1,1) = {"
hc
hc
hc
hc
fU
Db
MC
MC
MC
Db
Db
Db
Db
Db
Db
Db
Db
Db
Db
JO
cu
JO
Db
Db
Db
Db
Db
Db
Db
Db
Db
Db
MC
MC
MC
Db
fU
hc
hc
hc
hc
hc
"}
(83,1,1) = {"
hc
hc
hc
hc
fU
Db
Db
MC
Db
Db
Db
Db
Db
Db
Db
Db
Db
Db
Db
ho
JO
ho
Db
Db
Db
Db
Db
Db
Db
Db
Db
Db
Db
MC
Db
Db
fU
hc
hc
hc
hc
hc
"}
(84,1,1) = {"
hc
hc
hc
hc
fU
fU
Db
Db
Db
Db
Db
Db
MC
Db
Db
Db
MC
Db
Db
Db
Db
Db
Db
Db
MC
Db
Db
Db
MC
Db
Db
Db
Db
Db
Db
fU
fU
hc
hc
hc
hc
hc
"}
(85,1,1) = {"
hc
hc
hc
hc
hc
fU
fU
fU
fU
fU
fU
fU
fU
fU
fU
fU
fU
fU
fU
fU
fU
fU
fU
fU
fU
fU
fU
fU
fU
fU
fU
fU
fU
fU
fU
fU
hc
hc
hc
hc
hc
hc
"}
