//MAP CONVERTED BY dmm2tgm.py THIS HEADER COMMENT PREVENTS RECONVERSION, DO NOT REMOVE
"a" = (
/turf/template_noop,
/area/template_noop)
"c" = (
/obj/item/gun/ballistic/shotgun/toy/crossbow,
/turf/open/floor/mineral/titanium/white/airless,
/area/ruin/space/has_grav)
"h" = (
/obj/machinery/computer/terminal/derelict,
/turf/open/floor/mineral/titanium/white/airless,
/area/ruin/space/has_grav)
"k" = (
/obj/structure/chair/comfy/shuttle{
	dir = 4
	},
/mob/living/simple_animal/hostile/asteroid/hivelord,
/turf/open/floor/mineral/titanium/white/airless,
/area/ruin/space/has_grav)
"p" = (
/turf/open/misc/asteroid/airless,
/area/ruin/space/has_grav)
"A" = (
/obj/structure/window/reinforced/shuttle{
	broken = 1
	},
/obj/structure/grille/broken,
/turf/open/floor/mineral/titanium/white/airless,
/area/ruin/space/has_grav)
"D" = (
/obj/structure/chair/comfy/shuttle,
/mob/living/simple_animal/hostile/asteroid/hivelord,
/turf/open/floor/mineral/titanium/white/airless,
/area/ruin/space/has_grav)
"E" = (
/obj/structure/chair/comfy/shuttle{
	dir = 8
	},
/turf/open/floor/mineral/titanium/white/airless,
/area/ruin/space/has_grav)
"H" = (
/obj/machinery/power/shuttle_engine/propulsion,
/turf/open/misc/asteroid/airless,
/area/ruin/space/has_grav)
"O" = (
/obj/machinery/door/airlock/titanium/glass,
/turf/open/misc/asteroid/airless,
/area/ruin/space/has_grav)
"P" = (
/turf/closed/wall/mineral/titanium,
/area/ruin/space/has_grav)
"Q" = (
/obj/effect/mob_spawn/corpse/human{
	husk = true;
	outfit = /obj/item/clothing/under/rank/rnd/roboticist
	},
/turf/open/floor/mineral/titanium/white/airless,
/area/ruin/space/has_grav)
"S" = (
/mob/living/simple_animal/hostile/asteroid/hivelord,
/turf/open/floor/mineral/titanium/white/airless,
/area/ruin/space/has_grav)
"T" = (
/obj/structure/window/reinforced/shuttle,
/obj/structure/grille/broken,
/turf/open/misc/asteroid/airless,
/area/ruin/space/has_grav)
"U" = (
/turf/open/floor/mineral/titanium/white/airless,
/area/ruin/space/has_grav)
"W" = (
/obj/structure/chair/comfy/shuttle{
	dir = 1
	},
/turf/open/floor/mineral/titanium/white/airless,
/area/ruin/space/has_grav)
"X" = (
/turf/closed/mineral/random,
/area/ruin/space/has_grav)
"Y" = (
/obj/structure/chair/comfy/shuttle{
	dir = 4
	},
/turf/open/floor/mineral/titanium/white/airless,
/area/ruin/space/has_grav)

(1,1,1) = {"
a
a
a
a
a
a
a
a
a
a
a
a
a
a
a
a
a
a
a
a
a
a
a
a
a
a
a
a
a
a
a
a
a
a
a
"}
(2,1,1) = {"
a
a
a
a
a
a
a
a
a
a
a
a
a
a
a
a
a
a
a
a
a
a
a
a
a
a
a
a
a
a
a
a
a
a
a
"}
(3,1,1) = {"
a
a
a
a
a
a
a
a
a
a
a
a
a
a
a
a
a
a
a
a
a
a
a
a
a
a
a
a
a
a
a
a
a
a
a
"}
(4,1,1) = {"
a
a
a
a
X
X
a
a
a
a
a
a
a
a
a
X
X
X
X
X
X
a
a
a
a
a
a
a
a
a
a
a
X
X
a
"}
(5,1,1) = {"
a
a
a
X
X
X
a
a
a
a
a
a
a
X
X
X
X
X
X
X
X
X
a
a
a
a
a
a
a
a
a
a
X
X
a
"}
(6,1,1) = {"
a
a
a
a
X
X
X
a
a
a
a
a
p
X
X
X
X
X
X
X
X
X
X
X
X
p
p
a
a
a
a
a
X
a
a
"}
(7,1,1) = {"
a
a
a
a
X
X
X
a
a
a
a
p
X
X
X
X
X
X
X
X
X
X
X
X
X
X
p
p
a
a
a
a
a
a
a
"}
(8,1,1) = {"
a
a
a
a
a
a
a
a
a
a
a
p
X
X
X
X
X
X
X
X
X
X
X
X
X
X
p
p
a
a
a
a
a
a
a
"}
(9,1,1) = {"
a
a
a
a
a
a
a
a
a
a
a
p
X
X
X
X
X
X
X
X
X
X
X
X
X
X
X
p
a
a
a
a
a
a
a
"}
(10,1,1) = {"
a
a
a
a
a
a
a
a
a
a
p
p
X
X
X
X
X
X
X
X
X
X
X
X
X
X
X
p
a
a
a
a
a
a
a
"}
(11,1,1) = {"
a
a
a
a
a
a
a
a
a
p
p
X
X
X
X
X
X
X
X
X
X
X
X
X
X
X
X
p
a
a
a
a
a
a
a
"}
(12,1,1) = {"
a
a
a
a
a
a
a
a
p
p
X
X
p
X
X
X
X
X
X
X
X
X
X
X
X
X
X
p
a
a
a
a
a
a
a
"}
(13,1,1) = {"
a
a
a
a
a
a
a
a
p
p
p
p
p
X
X
X
X
X
X
X
X
X
X
X
X
X
X
p
a
a
a
a
a
a
a
"}
(14,1,1) = {"
a
a
a
a
a
a
a
a
p
p
X
X
X
X
X
X
X
X
X
X
X
X
X
X
p
p
p
p
a
a
a
a
a
a
a
"}
(15,1,1) = {"
a
a
a
a
a
a
a
a
p
X
X
X
X
X
X
X
X
X
X
X
X
X
X
p
p
p
p
p
a
a
a
X
a
a
a
"}
(16,1,1) = {"
a
a
a
a
X
a
a
a
p
X
X
X
X
X
X
X
X
p
p
p
p
p
p
p
p
p
p
a
a
a
X
X
a
a
a
"}
(17,1,1) = {"
a
a
a
a
X
a
a
a
X
X
X
X
X
X
X
X
p
p
p
p
p
p
p
p
p
p
p
a
a
a
a
a
a
a
a
"}
(18,1,1) = {"
a
a
a
a
a
a
a
a
X
X
X
X
X
X
p
P
P
P
H
p
p
p
p
p
p
p
p
p
a
a
a
a
a
a
a
"}
(19,1,1) = {"
a
a
a
a
a
a
a
a
p
X
X
X
p
p
P
k
Y
Y
P
p
p
p
p
p
p
p
p
p
a
a
a
a
a
a
a
"}
(20,1,1) = {"
a
a
a
a
a
a
a
a
X
X
X
X
p
T
D
Q
S
U
W
P
p
p
p
p
p
p
p
p
a
a
a
a
a
a
a
"}
(21,1,1) = {"
a
a
a
a
a
a
a
a
p
p
p
p
p
P
h
S
c
U
U
O
p
p
p
p
p
p
p
p
a
a
a
X
X
X
a
"}
(22,1,1) = {"
a
a
a
a
a
a
a
a
p
p
p
X
X
X
A
E
U
U
W
P
p
p
p
p
p
p
p
p
a
a
a
X
X
X
a
"}
(23,1,1) = {"
a
a
a
a
a
a
a
a
X
X
X
X
X
X
X
X
X
E
P
p
p
p
p
p
p
p
p
p
a
a
a
a
X
X
a
"}
(24,1,1) = {"
a
a
a
a
a
a
a
a
p
X
X
X
X
X
X
X
P
P
H
p
p
p
p
p
p
p
p
p
a
a
a
a
a
a
a
"}
(25,1,1) = {"
a
a
a
a
a
a
a
a
p
X
X
X
X
X
X
p
p
p
p
p
p
p
p
X
X
X
p
a
a
a
a
a
a
a
a
"}
(26,1,1) = {"
a
a
a
a
a
a
a
a
p
X
X
X
X
X
X
X
p
p
p
X
X
X
X
X
X
X
p
a
a
a
a
a
a
a
a
"}
(27,1,1) = {"
a
a
a
X
a
a
a
a
p
p
X
X
X
X
X
X
X
X
X
X
X
X
X
X
X
X
p
a
a
a
a
a
a
a
a
"}
(28,1,1) = {"
a
a
a
a
a
a
a
a
p
p
p
X
X
X
X
X
X
X
X
X
X
X
X
p
p
p
p
a
a
a
a
a
a
a
a
"}
(29,1,1) = {"
a
a
a
a
a
a
a
a
a
p
p
X
X
X
X
X
X
X
X
X
X
X
X
p
p
a
a
a
a
a
a
a
a
a
a
"}
(30,1,1) = {"
a
a
a
a
a
a
a
a
a
a
p
X
X
X
X
X
X
X
p
p
p
p
p
p
a
a
a
a
a
a
X
X
X
a
a
"}
(31,1,1) = {"
a
a
a
a
a
a
a
a
a
a
a
p
p
X
X
X
X
X
p
p
p
p
p
a
a
a
a
a
a
a
a
a
a
a
a
"}
(32,1,1) = {"
a
a
a
a
a
a
a
a
a
a
a
a
p
p
p
p
p
p
p
a
a
a
a
a
a
a
a
a
a
a
a
a
a
a
a
"}
(33,1,1) = {"
a
a
a
a
a
a
a
a
a
a
a
a
a
a
a
a
a
a
a
a
a
a
a
a
a
a
a
a
a
a
a
a
a
a
a
"}
(34,1,1) = {"
a
a
a
a
a
a
a
a
a
a
a
a
a
a
a
a
a
a
a
a
a
a
a
a
a
a
a
a
a
a
a
a
a
a
a
"}
(35,1,1) = {"
a
a
a
a
a
a
a
a
a
a
a
a
a
a
a
a
a
a
a
a
a
a
a
a
a
a
a
a
a
a
a
a
a
a
a
"}
