//MAP CONVERTED BY dmm2tgm.py THIS HEADER COMMENT PREVENTS RECONVERSION, DO NOT REMOVE
"a" = (
/turf/open/water/deep_beach,
/area/space)

(1,1,1) = {"
a
a
a
"}
(2,1,1) = {"
a
a
a
"}
(3,1,1) = {"
a
a
a
"}
