//MAP CONVERTED BY dmm2tgm.py THIS HEADER COMMENT PREVENTS RECONVERSION, DO NOT REMOVE
"a" = (
/turf/open/floor/holofloor/plating,
/area/template_noop)
"h" = (
/obj/structure/table/reinforced/plastitaniumglass,
/obj/structure/window/reinforced,
/obj/machinery/trading_card_holder/red{
	pixel_y = 9;
	pixel_x = 8;
	summon_offset_x = -1
	},
/obj/machinery/trading_card_holder/red{
	pixel_y = 12;
	pixel_x = -3;
	summon_offset_x = -2
	},
/obj/structure/window/reinforced{
	dir = 8
	},
/turf/open/floor/holofloor/plating,
/area/template_noop)
"l" = (
/obj/structure/window/reinforced,
/turf/open/floor/holofloor/plating,
/area/template_noop)
"n" = (
/obj/structure/table/reinforced/plastitaniumglass,
/obj/structure/window/reinforced{
	dir = 1
	},
/obj/machinery/trading_card_holder{
	pixel_y = 5;
	pixel_x = -8;
	summon_offset_x = 1
	},
/obj/machinery/trading_card_holder{
	pixel_y = 2;
	pixel_x = 3;
	summon_offset_x = 2
	},
/obj/structure/window/reinforced{
	dir = 4
	},
/turf/open/floor/holofloor/plating,
/area/template_noop)
"p" = (
/obj/structure/table/reinforced/plastitaniumglass,
/obj/structure/window/reinforced,
/obj/machinery/trading_card_holder/red{
	pixel_y = 6
	},
/obj/machinery/trading_card_holder/red{
	pixel_y = 7;
	pixel_x = -12;
	summon_offset_x = -1
	},
/obj/machinery/trading_card_holder/red{
	pixel_y = 7;
	pixel_x = 12;
	summon_offset_x = 1
	},
/turf/open/floor/holofloor/plating,
/area/template_noop)
"q" = (
/turf/open/floor/holofloor/stairs/right{
	dir = 1
	},
/area/template_noop)
"u" = (
/obj/structure/table/reinforced/plastitaniumglass,
/obj/structure/window/reinforced,
/obj/machinery/trading_card_holder/red{
	pixel_y = 9;
	pixel_x = -8;
	summon_offset_x = 1
	},
/obj/machinery/trading_card_holder/red{
	pixel_y = 12;
	pixel_x = 3;
	summon_offset_x = 2
	},
/obj/structure/window/reinforced{
	dir = 4
	},
/turf/open/floor/holofloor/plating,
/area/template_noop)
"z" = (
/obj/structure/table/reinforced/plastitaniumglass,
/obj/structure/window/reinforced{
	dir = 8
	},
/turf/open/floor/holofloor/plating,
/area/template_noop)
"A" = (
/turf/open/floor/holofloor/stairs/left,
/area/template_noop)
"C" = (
/obj/structure/table/reinforced/plastitaniumglass,
/obj/structure/window/reinforced{
	dir = 1
	},
/obj/machinery/trading_card_holder{
	pixel_y = 5;
	pixel_x = 8;
	summon_offset_x = -1
	},
/obj/machinery/trading_card_holder{
	pixel_y = 2;
	pixel_x = -3;
	summon_offset_x = -2
	},
/obj/structure/window/reinforced{
	dir = 8
	},
/turf/open/floor/holofloor/plating,
/area/template_noop)
"D" = (
/obj/structure/window/reinforced{
	dir = 8
	},
/turf/open/floor/holofloor/hyperspace,
/area/template_noop)
"F" = (
/obj/structure/table/reinforced/plastitaniumglass,
/obj/structure/window/reinforced{
	dir = 4
	},
/turf/open/floor/holofloor/plating,
/area/template_noop)
"I" = (
/obj/structure/window/reinforced{
	dir = 4
	},
/turf/open/floor/holofloor/hyperspace,
/area/template_noop)
"K" = (
/turf/open/floor/holofloor/stairs/right,
/area/template_noop)
"N" = (
/obj/structure/table/reinforced/plastitaniumglass,
/obj/structure/window/reinforced{
	dir = 1
	},
/obj/machinery/trading_card_holder{
	pixel_y = 8
	},
/obj/machinery/trading_card_holder{
	pixel_y = 7;
	pixel_x = 12;
	summon_offset_x = 1
	},
/obj/machinery/trading_card_holder{
	pixel_y = 7;
	pixel_x = -12;
	summon_offset_x = -1
	},
/turf/open/floor/holofloor/plating,
/area/template_noop)
"O" = (
/obj/structure/table/reinforced/plastitaniumglass,
/obj/structure/window/reinforced{
	dir = 4
	},
/obj/item/coin/thunderdome,
/turf/open/floor/holofloor/plating,
/area/template_noop)
"P" = (
/turf/open/floor/holofloor/stairs/left{
	dir = 1
	},
/area/template_noop)
"S" = (
/turf/open/floor/holofloor/hyperspace,
/area/template_noop)
"V" = (
/obj/structure/table/reinforced/plastitaniumglass,
/obj/structure/window/reinforced{
	dir = 8
	},
/obj/item/coin/thunderdome,
/turf/open/floor/holofloor/plating,
/area/template_noop)
"W" = (
/turf/open/floor/holofloor/stairs/medium{
	dir = 1
	},
/area/template_noop)
"Y" = (
/obj/structure/window/reinforced{
	dir = 1
	},
/turf/open/floor/holofloor/plating,
/area/template_noop)
"Z" = (
/turf/open/floor/holofloor/stairs/medium,
/area/template_noop)

(1,1,1) = {"
a
a
a
a
a
a
a
a
a
a
"}
(2,1,1) = {"
a
a
a
l
D
D
Y
a
a
a
"}
(3,1,1) = {"
a
a
a
l
S
S
Y
a
a
a
"}
(4,1,1) = {"
a
P
z
h
S
S
C
V
A
a
"}
(5,1,1) = {"
a
W
a
p
S
S
N
a
Z
a
"}
(6,1,1) = {"
a
q
O
u
S
S
n
F
K
a
"}
(7,1,1) = {"
a
a
a
l
S
S
Y
a
a
a
"}
(8,1,1) = {"
a
a
a
l
I
I
Y
a
a
a
"}
(9,1,1) = {"
a
a
a
a
a
a
a
a
a
a
"}
