//MAP CONVERTED BY dmm2tgm.py THIS HEADER COMMENT PREVENTS RECONVERSION, DO NOT REMOVE
"b" = (
/obj/effect/turf_decal/trimline/red/filled/line{
	dir = 1
	},
/turf/open/floor/holofloor,
/area/template_noop)
"c" = (
/obj/effect/turf_decal/caution,
/turf/open/floor/holofloor/dark,
/area/template_noop)
"d" = (
/obj/effect/turf_decal/trimline/red/filled/line{
	dir = 8
	},
/turf/open/floor/holofloor,
/area/template_noop)
"e" = (
/obj/effect/turf_decal/board_number/two{
	pixel_y = 21
	},
/turf/open/floor/holofloor,
/area/template_noop)
"f" = (
/obj/effect/turf_decal/trimline/red/filled/line{
	dir = 9
	},
/obj/machinery/flasher/directional/east{
	id = "Holodeck Cell 3";
	pixel_x = 0
	},
/obj/structure/window/reinforced/spawner/directional/north,
/turf/open/floor/holofloor/white,
/area/template_noop)
"g" = (
/obj/structure/table,
/obj/machinery/button/flasher{
	id = "Holodeck Cell 2";
	name = "Cell 2";
	pixel_y = 8
	},
/obj/machinery/button/flasher{
	id = "Holodeck Cell 4";
	name = "Cell 4";
	pixel_y = -3
	},
/obj/item/restraints/handcuffs{
	pixel_x = -17;
	pixel_y = 9
	},
/obj/item/restraints/handcuffs{
	pixel_x = -17;
	pixel_y = -3
	},
/turf/open/floor/holofloor/dark,
/area/template_noop)
"h" = (
/obj/machinery/computer/security{
	dir = 4
	},
/turf/open/floor/holofloor/dark,
/area/template_noop)
"j" = (
/obj/structure/bed,
/obj/effect/turf_decal/trimline/red/filled/line{
	dir = 9
	},
/obj/item/bedsheet/red,
/turf/open/floor/holofloor/white,
/area/template_noop)
"k" = (
/obj/structure/chair/e_chair{
	dir = 1
	},
/obj/effect/turf_decal/bot,
/turf/open/floor/holofloor/dark,
/area/template_noop)
"l" = (
/obj/machinery/status_display/door_timer{
	id = "Holodeck Cell 2";
	req_access = null;
	name = "Cell 2"
	},
/obj/structure/table,
/turf/open/floor/holofloor/dark,
/area/template_noop)
"n" = (
/obj/effect/turf_decal/trimline/red/filled/line{
	dir = 10
	},
/obj/structure/closet/secure_closet/brig/holodeck{
	id = "Holodeck Cell 4"
	},
/turf/open/floor/holofloor/white,
/area/template_noop)
"o" = (
/obj/effect/turf_decal/board_number/four,
/turf/open/floor/holofloor,
/area/template_noop)
"p" = (
/obj/effect/turf_decal/trimline/red/filled/line{
	dir = 5
	},
/obj/item/instrument/harmonica,
/obj/machinery/door/window/brigdoor/security/holodeck/left/directional/north{
	id = "Holodeck Cell 3";
	name = "Cell 3"
	},
/turf/open/floor/holofloor/white,
/area/template_noop)
"q" = (
/obj/effect/turf_decal/board_number/one{
	pixel_y = 21
	},
/turf/open/floor/holofloor,
/area/template_noop)
"r" = (
/obj/effect/turf_decal/trimline/red/filled/line{
	dir = 6
	},
/obj/structure/closet/secure_closet/brig/holodeck{
	id = "Holodeck Cell 3"
	},
/turf/open/floor/holofloor/white,
/area/template_noop)
"s" = (
/turf/open/floor/holofloor,
/area/template_noop)
"t" = (
/obj/item/book/manual/wiki/security_space_law{
	pixel_y = 13
	},
/obj/structure/table,
/obj/machinery/recharger,
/obj/item/restraints/handcuffs{
	pixel_x = -17;
	pixel_y = 9
	},
/obj/item/restraints/handcuffs{
	pixel_x = -17;
	pixel_y = -3
	},
/turf/open/floor/holofloor/dark,
/area/template_noop)
"u" = (
/obj/effect/turf_decal/trimline/red/filled/line{
	dir = 5
	},
/obj/structure/closet/secure_closet/brig/holodeck{
	id = "Holodeck Cell 1"
	},
/turf/open/floor/holofloor/white,
/area/template_noop)
"v" = (
/obj/effect/turf_decal/trimline/red/filled/line{
	dir = 9
	},
/obj/structure/closet/secure_closet/brig/holodeck{
	id = "Holodeck Cell 2"
	},
/turf/open/floor/holofloor/white,
/area/template_noop)
"x" = (
/obj/effect/turf_decal/trimline/red/filled/line{
	dir = 5
	},
/obj/structure/bed,
/obj/item/bedsheet/red,
/turf/open/floor/holofloor/white,
/area/template_noop)
"y" = (
/obj/structure/window/reinforced/fulltile,
/turf/open/floor/holofloor/dark,
/area/template_noop)
"z" = (
/obj/machinery/computer/records/security{
	dir = 8
	},
/turf/open/floor/holofloor/dark,
/area/template_noop)
"A" = (
/obj/effect/turf_decal/trimline/red/filled/warning{
	dir = 1
	},
/turf/open/floor/holofloor/dark,
/area/template_noop)
"B" = (
/obj/structure/closet{
	name = "evidence closet"
	},
/turf/open/floor/holofloor/dark,
/area/template_noop)
"C" = (
/obj/effect/turf_decal/trimline/red/filled/line{
	dir = 6
	},
/obj/item/coin/antagtoken,
/obj/machinery/door/window/brigdoor/security/holodeck/left/directional/south{
	id = "Holodeck Cell 1";
	name = "Cell 1"
	},
/turf/open/floor/holofloor/white,
/area/template_noop)
"D" = (
/obj/machinery/status_display/door_timer{
	id = "Holodeck Cell 1";
	name = "Cell 1";
	req_access = null
	},
/obj/structure/table,
/turf/open/floor/holofloor/dark,
/area/template_noop)
"G" = (
/obj/effect/turf_decal/trimline/red/filled/corner{
	dir = 4
	},
/turf/open/floor/holofloor,
/area/template_noop)
"H" = (
/obj/effect/turf_decal/trimline/red/filled/line{
	dir = 6
	},
/obj/machinery/flasher/directional/west{
	id = "Holodeck Cell 2";
	pixel_x = 1
	},
/obj/structure/window/reinforced/spawner/directional/south,
/turf/open/floor/holofloor/white,
/area/template_noop)
"I" = (
/obj/effect/turf_decal/trimline/red/filled/line{
	dir = 10
	},
/obj/machinery/flasher/directional/east{
	id = "Holodeck Cell 1";
	pixel_x = 0
	},
/obj/structure/window/reinforced/spawner/directional/south,
/turf/open/floor/holofloor/white,
/area/template_noop)
"J" = (
/obj/effect/turf_decal/trimline/red/filled/warning,
/turf/open/floor/holofloor/dark,
/area/template_noop)
"K" = (
/obj/effect/turf_decal/trimline/red/filled/line,
/turf/open/floor/holofloor,
/area/template_noop)
"L" = (
/obj/effect/turf_decal/trimline/red/filled/corner{
	dir = 8
	},
/turf/open/floor/holofloor,
/area/template_noop)
"M" = (
/obj/effect/turf_decal/trimline/red/filled/corner{
	dir = 1
	},
/turf/open/floor/holofloor,
/area/template_noop)
"N" = (
/obj/machinery/status_display/door_timer{
	id = "Holodeck Cell 4";
	req_access = null;
	name = "Cell 4"
	},
/obj/structure/table,
/turf/open/floor/holofloor/dark,
/area/template_noop)
"O" = (
/obj/effect/turf_decal/trimline/red/filled/line{
	dir = 5
	},
/obj/machinery/flasher/directional/west{
	id = "Holodeck Cell 4";
	pixel_x = 0
	},
/obj/structure/window/reinforced/spawner/directional/north,
/turf/open/floor/holofloor/white,
/area/template_noop)
"P" = (
/obj/effect/turf_decal/trimline/red/filled/line{
	dir = 9
	},
/obj/item/dice/d6,
/obj/machinery/door/window/brigdoor/security/holodeck/right/directional/north{
	name = "Cell 4";
	id = "Holodeck Cell 4"
	},
/turf/open/floor/holofloor/white,
/area/template_noop)
"Q" = (
/obj/structure/table,
/obj/machinery/button/flasher{
	id = "Holodeck Cell 3";
	name = "Cell 3";
	pixel_y = -3
	},
/obj/machinery/button/flasher{
	id = "Holodeck Cell 1";
	name = "Cell 1";
	pixel_y = 8
	},
/turf/open/floor/holofloor/dark,
/area/template_noop)
"R" = (
/obj/effect/turf_decal/board_number/three,
/turf/open/floor/holofloor,
/area/template_noop)
"S" = (
/obj/effect/turf_decal/trimline/red/filled/line{
	dir = 4
	},
/turf/open/floor/holofloor,
/area/template_noop)
"T" = (
/obj/effect/turf_decal/trimline/red/filled/line{
	dir = 6
	},
/obj/structure/bed,
/obj/item/bedsheet/red,
/turf/open/floor/holofloor/white,
/area/template_noop)
"U" = (
/obj/machinery/status_display/door_timer{
	id = "Holodeck Cell 3";
	req_access = null;
	name = "Cell 3"
	},
/obj/structure/table,
/turf/open/floor/holofloor/dark,
/area/template_noop)
"V" = (
/obj/effect/turf_decal/trimline/red/filled/warning{
	dir = 1
	},
/obj/effect/turf_decal/caution/stand_clear,
/turf/open/floor/holofloor/dark,
/area/template_noop)
"W" = (
/obj/effect/turf_decal/trimline/red/filled/line{
	dir = 10
	},
/obj/item/toy/figure/prisoner,
/obj/machinery/door/window/brigdoor/security/holodeck/right/directional/south{
	name = "Cell 2";
	id = "Holodeck Cell 2"
	},
/turf/open/floor/holofloor/white,
/area/template_noop)
"X" = (
/obj/effect/turf_decal/trimline/red/filled/corner,
/turf/open/floor/holofloor,
/area/template_noop)
"Y" = (
/obj/effect/turf_decal/trimline/red/filled/line{
	dir = 10
	},
/obj/structure/bed,
/obj/item/bedsheet/red,
/turf/open/floor/holofloor/white,
/area/template_noop)
"Z" = (
/obj/structure/chair/comfy/black,
/turf/open/floor/holofloor/dark,
/area/template_noop)

(1,1,1) = {"
j
I
s
s
s
s
s
s
f
Y
"}
(2,1,1) = {"
u
C
q
X
S
S
G
R
p
r
"}
(3,1,1) = {"
y
y
s
K
D
U
b
s
y
y
"}
(4,1,1) = {"
B
J
s
K
h
Q
b
s
A
c
"}
(5,1,1) = {"
B
J
s
K
Z
t
b
s
V
k
"}
(6,1,1) = {"
B
J
s
K
z
g
b
s
A
c
"}
(7,1,1) = {"
y
y
s
K
l
N
b
s
y
y
"}
(8,1,1) = {"
v
W
e
L
d
d
M
o
P
n
"}
(9,1,1) = {"
x
H
s
s
s
s
s
s
O
T
"}
