//MAP CONVERTED BY dmm2tgm.py THIS HEADER COMMENT PREVENTS RECONVERSION, DO NOT REMOVE
"aa" = (
/obj/effect/turf_decal/tile/neutral{
	dir = 4
	},
/obj/effect/turf_decal/tile/neutral{
	dir = 8
	},
/obj/structure/closet/secure_closet/courtroom,
/turf/open/floor/holofloor/dark,
/area/template_noop)
"ab" = (
/obj/effect/turf_decal/tile/neutral{
	dir = 4
	},
/obj/effect/turf_decal/tile/neutral{
	dir = 8
	},
/obj/structure/table/wood,
/obj/item/food/grown/harebell,
/obj/item/food/grown/harebell,
/obj/item/food/grown/harebell,
/obj/item/food/grown/harebell,
/obj/item/food/grown/harebell,
/turf/open/floor/holofloor/dark,
/area/template_noop)
"ac" = (
/obj/structure/chair{
	dir = 1
	},
/turf/open/floor/holofloor/chapel/bottom_left,
/area/template_noop)
"ad" = (
/obj/structure/table/wood/fancy,
/obj/item/clothing/suit/chaplainsuit/nun,
/obj/item/clothing/head/chaplain/nun_hood,
/obj/item/clothing/suit/chaplainsuit/holidaypriest,
/obj/effect/turf_decal/tile/neutral,
/obj/effect/turf_decal/tile/neutral{
	dir = 1
	},
/obj/effect/turf_decal/tile/neutral{
	dir = 4
	},
/obj/effect/turf_decal/tile/neutral{
	dir = 8
	},
/turf/open/floor/holofloor/dark,
/area/template_noop)
"ae" = (
/obj/effect/turf_decal/tile/neutral/anticorner/contrasted,
/turf/open/floor/holofloor/dark,
/area/template_noop)
"af" = (
/turf/open/floor/holofloor/dark,
/area/template_noop)
"ag" = (
/turf/open/floor/holofloor/chapel/top_left,
/area/template_noop)
"ah" = (
/obj/effect/turf_decal/tile/neutral{
	dir = 4
	},
/obj/effect/turf_decal/tile/neutral{
	dir = 8
	},
/obj/structure/table/wood,
/obj/item/food/grown/poppy,
/obj/item/food/grown/poppy,
/obj/item/food/grown/poppy,
/obj/item/food/grown/poppy,
/obj/item/food/grown/poppy,
/turf/open/floor/holofloor/dark,
/area/template_noop)
"ai" = (
/turf/open/floor/holofloor/chapel/bottom_right,
/area/template_noop)
"aj" = (
/obj/structure/table/wood,
/obj/item/food/grown/poppy,
/obj/item/food/grown/poppy,
/obj/item/food/grown/poppy,
/obj/item/food/grown/poppy,
/obj/item/food/grown/poppy,
/obj/effect/turf_decal/tile/neutral/opposingcorners{
	dir = 1
	},
/turf/open/floor/holofloor/dark,
/area/template_noop)
"ak" = (
/obj/structure/chair{
	dir = 1
	},
/turf/open/floor/holofloor/chapel/top_right,
/area/template_noop)
"al" = (
/obj/effect/turf_decal/tile/neutral{
	dir = 4
	},
/obj/effect/turf_decal/tile/neutral{
	dir = 8
	},
/obj/structure/table/wood,
/obj/item/folder/blue,
/obj/item/pen/red,
/turf/open/floor/holofloor/dark,
/area/template_noop)
"am" = (
/obj/item/clothing/head/helmet/chaplain/witchunter_hat,
/obj/effect/turf_decal/tile/neutral,
/obj/effect/turf_decal/tile/neutral{
	dir = 1
	},
/obj/effect/turf_decal/tile/neutral{
	dir = 4
	},
/obj/effect/turf_decal/tile/neutral{
	dir = 8
	},
/obj/structure/table/wood/fancy,
/turf/open/floor/holofloor/dark,
/area/template_noop)
"an" = (
/obj/item/gavelblock,
/obj/item/gavelhammer,
/obj/structure/table/wood,
/obj/effect/turf_decal/tile/neutral/half/contrasted{
	dir = 8
	},
/turf/open/floor/holofloor/dark,
/area/template_noop)
"ao" = (
/obj/effect/turf_decal/tile/neutral{
	dir = 4
	},
/obj/effect/turf_decal/tile/neutral{
	dir = 8
	},
/obj/structure/table/wood,
/obj/item/storage/fancy/candle_box,
/turf/open/floor/holofloor/dark,
/area/template_noop)
"ap" = (
/obj/structure/table/wood,
/obj/effect/turf_decal/tile/neutral{
	dir = 8
	},
/obj/effect/turf_decal/tile/neutral,
/turf/open/floor/holofloor/dark,
/area/template_noop)
"aq" = (
/obj/effect/turf_decal/tile/neutral{
	dir = 4
	},
/obj/effect/turf_decal/tile/neutral{
	dir = 8
	},
/obj/structure/table/wood,
/obj/item/folder/red,
/obj/item/pen/red,
/turf/open/floor/holofloor/dark,
/area/template_noop)
"ar" = (
/obj/item/gavelblock,
/obj/item/gavelhammer,
/obj/structure/table/wood,
/obj/effect/turf_decal/tile/neutral{
	dir = 8
	},
/obj/effect/turf_decal/tile/neutral,
/turf/open/floor/holofloor/dark,
/area/template_noop)
"as" = (
/obj/effect/turf_decal/tile/neutral{
	dir = 4
	},
/obj/effect/turf_decal/tile/neutral{
	dir = 8
	},
/turf/open/floor/holofloor/dark,
/area/template_noop)
"at" = (
/obj/effect/turf_decal/tile/neutral/anticorner/contrasted{
	dir = 8
	},
/turf/open/floor/holofloor/dark,
/area/template_noop)
"au" = (
/obj/structure/table/wood/fancy,
/obj/item/storage/book/bible,
/obj/effect/turf_decal/tile/neutral,
/obj/effect/turf_decal/tile/neutral{
	dir = 1
	},
/obj/effect/turf_decal/tile/neutral{
	dir = 4
	},
/obj/effect/turf_decal/tile/neutral{
	dir = 8
	},
/turf/open/floor/holofloor/dark,
/area/template_noop)
"av" = (
/obj/effect/turf_decal/tile/neutral/half/contrasted{
	dir = 1
	},
/turf/open/floor/holofloor/dark,
/area/template_noop)
"aw" = (
/obj/effect/turf_decal/tile/neutral,
/obj/effect/turf_decal/tile/neutral{
	dir = 4
	},
/turf/open/floor/holofloor/dark,
/area/template_noop)
"ax" = (
/obj/effect/turf_decal/tile/neutral,
/obj/effect/turf_decal/tile/neutral{
	dir = 1
	},
/obj/effect/turf_decal/tile/neutral{
	dir = 4
	},
/obj/effect/turf_decal/tile/neutral{
	dir = 8
	},
/turf/open/floor/holofloor/dark,
/area/template_noop)
"ay" = (
/obj/item/toy/figure/chaplain,
/obj/effect/turf_decal/tile/neutral,
/obj/effect/turf_decal/tile/neutral{
	dir = 1
	},
/obj/effect/turf_decal/tile/neutral{
	dir = 4
	},
/obj/effect/turf_decal/tile/neutral{
	dir = 8
	},
/obj/structure/table/wood/fancy,
/turf/open/floor/holofloor/dark,
/area/template_noop)
"az" = (
/obj/structure/table/wood,
/obj/item/folder/blue,
/obj/item/pen/red,
/obj/effect/turf_decal/tile/neutral/opposingcorners{
	dir = 1
	},
/turf/open/floor/holofloor/dark,
/area/template_noop)
"aA" = (
/turf/open/floor/holofloor/chapel/bottom_left,
/area/template_noop)
"aB" = (
/obj/structure/table/wood,
/obj/item/food/grown/harebell,
/obj/item/food/grown/harebell,
/obj/item/food/grown/harebell,
/obj/item/food/grown/harebell,
/obj/item/food/grown/harebell,
/obj/effect/turf_decal/tile/neutral/opposingcorners{
	dir = 1
	},
/turf/open/floor/holofloor/dark,
/area/template_noop)
"aC" = (
/obj/structure/chair{
	dir = 1
	},
/turf/open/floor/holofloor/chapel,
/area/template_noop)
"aD" = (
/obj/effect/turf_decal/tile/neutral/fourcorners,
/turf/open/floor/holofloor/dark,
/area/template_noop)
"aE" = (
/obj/structure/chair{
	dir = 1
	},
/turf/open/floor/holofloor/chapel/bottom_right,
/area/template_noop)
"aF" = (
/obj/item/clothing/suit/costume/judgerobe,
/obj/item/clothing/head/costume/powdered_wig,
/obj/effect/turf_decal/tile/neutral,
/obj/effect/turf_decal/tile/neutral{
	dir = 1
	},
/obj/effect/turf_decal/tile/neutral{
	dir = 4
	},
/obj/effect/turf_decal/tile/neutral{
	dir = 8
	},
/obj/structure/table/wood/fancy,
/turf/open/floor/holofloor/dark,
/area/template_noop)
"aG" = (
/obj/structure/table/wood,
/obj/item/storage/fancy/candle_box,
/obj/effect/turf_decal/tile/neutral/opposingcorners{
	dir = 1
	},
/turf/open/floor/holofloor/dark,
/area/template_noop)
"aH" = (
/obj/structure/table/wood/fancy,
/obj/item/book/manual/wiki/security_space_law,
/obj/effect/turf_decal/tile/neutral,
/obj/effect/turf_decal/tile/neutral{
	dir = 1
	},
/obj/effect/turf_decal/tile/neutral{
	dir = 4
	},
/obj/effect/turf_decal/tile/neutral{
	dir = 8
	},
/turf/open/floor/holofloor/dark,
/area/template_noop)
"aI" = (
/obj/effect/turf_decal/tile/neutral{
	dir = 8
	},
/obj/effect/turf_decal/tile/neutral{
	dir = 1
	},
/turf/open/floor/holofloor/dark,
/area/template_noop)
"aJ" = (
/obj/effect/turf_decal/tile/neutral/opposingcorners{
	dir = 1
	},
/turf/open/floor/holofloor/dark,
/area/template_noop)
"aK" = (
/turf/open/floor/holofloor/chapel/top_right,
/area/template_noop)
"aL" = (
/obj/structure/chair{
	dir = 1
	},
/obj/effect/turf_decal/tile/neutral{
	dir = 4
	},
/obj/effect/turf_decal/tile/neutral{
	dir = 8
	},
/turf/open/floor/holofloor/dark,
/area/template_noop)
"aM" = (
/obj/structure/chair{
	dir = 1
	},
/obj/effect/turf_decal/tile/neutral/opposingcorners{
	dir = 1
	},
/turf/open/floor/holofloor/dark,
/area/template_noop)
"aN" = (
/obj/effect/turf_decal/tile/neutral{
	dir = 8
	},
/obj/effect/turf_decal/tile/neutral{
	dir = 1
	},
/obj/effect/turf_decal/tile/neutral,
/turf/open/floor/holofloor/dark,
/area/template_noop)
"aO" = (
/obj/effect/turf_decal/tile/neutral{
	dir = 4
	},
/obj/effect/turf_decal/tile/neutral{
	dir = 8
	},
/obj/structure/table/wood,
/obj/item/paper_bin,
/turf/open/floor/holofloor/dark,
/area/template_noop)
"aP" = (
/obj/structure/closet/secure_closet/courtroom,
/obj/effect/turf_decal/tile/neutral/opposingcorners{
	dir = 1
	},
/turf/open/floor/holofloor/dark,
/area/template_noop)
"aQ" = (
/obj/structure/chair,
/turf/open/floor/holofloor/dark,
/area/template_noop)
"aR" = (
/obj/structure/table/wood,
/obj/item/hand_labeler,
/obj/effect/turf_decal/tile/neutral/opposingcorners{
	dir = 1
	},
/turf/open/floor/holofloor/dark,
/area/template_noop)
"aS" = (
/obj/effect/turf_decal/tile/neutral{
	dir = 8
	},
/obj/effect/turf_decal/tile/neutral{
	dir = 1
	},
/obj/effect/turf_decal/tile/neutral{
	dir = 4
	},
/obj/effect/turf_decal/tile/neutral,
/turf/open/floor/holofloor/dark,
/area/template_noop)
"aT" = (
/obj/structure/chair{
	dir = 1
	},
/turf/open/floor/holofloor/chapel/top_left,
/area/template_noop)
"aU" = (
/obj/effect/turf_decal/tile/neutral{
	dir = 4
	},
/obj/effect/turf_decal/tile/neutral{
	dir = 8
	},
/obj/structure/table/wood,
/obj/item/hand_labeler,
/turf/open/floor/holofloor/dark,
/area/template_noop)
"aV" = (
/obj/structure/table/wood,
/obj/item/folder/red,
/obj/item/pen/red,
/obj/effect/turf_decal/tile/neutral/opposingcorners{
	dir = 1
	},
/turf/open/floor/holofloor/dark,
/area/template_noop)
"aW" = (
/obj/effect/turf_decal/tile/neutral{
	dir = 8
	},
/obj/effect/turf_decal/tile/neutral,
/obj/effect/turf_decal/tile/neutral{
	dir = 4
	},
/turf/open/floor/holofloor/dark,
/area/template_noop)
"aX" = (
/obj/item/clothing/suit/chaplainsuit/bishoprobe,
/obj/effect/turf_decal/tile/neutral,
/obj/effect/turf_decal/tile/neutral{
	dir = 1
	},
/obj/effect/turf_decal/tile/neutral{
	dir = 4
	},
/obj/effect/turf_decal/tile/neutral{
	dir = 8
	},
/obj/structure/table/wood/fancy,
/turf/open/floor/holofloor/dark,
/area/template_noop)
"aY" = (
/obj/structure/table/wood,
/obj/effect/turf_decal/tile/neutral/half/contrasted{
	dir = 8
	},
/turf/open/floor/holofloor/dark,
/area/template_noop)
"aZ" = (
/obj/structure/table/wood,
/obj/item/paper_bin,
/obj/effect/turf_decal/tile/neutral/opposingcorners{
	dir = 1
	},
/turf/open/floor/holofloor/dark,
/area/template_noop)
"fL" = (
/obj/effect/turf_decal/tile/neutral/half/contrasted,
/turf/open/floor/holofloor/dark,
/area/template_noop)
"mQ" = (
/obj/structure/table/wood/fancy,
/obj/item/storage/book/bible,
/obj/effect/turf_decal/tile/neutral/fourcorners,
/turf/open/floor/holofloor/dark,
/area/template_noop)
"mT" = (
/obj/item/clothing/suit/costume/judgerobe,
/obj/item/clothing/head/costume/powdered_wig,
/obj/structure/table/wood/fancy,
/obj/effect/turf_decal/tile/neutral/fourcorners,
/turf/open/floor/holofloor/dark,
/area/template_noop)
"ox" = (
/obj/structure/table/wood/fancy,
/obj/item/book/manual/wiki/security_space_law,
/obj/effect/turf_decal/tile/neutral/fourcorners,
/turf/open/floor/holofloor/dark,
/area/template_noop)
"Eo" = (
/obj/item/toy/figure/chaplain,
/obj/structure/table/wood/fancy,
/obj/effect/turf_decal/tile/neutral/fourcorners,
/turf/open/floor/holofloor/dark,
/area/template_noop)
"FJ" = (
/obj/item/clothing/suit/chaplainsuit/bishoprobe,
/obj/structure/table/wood/fancy,
/obj/effect/turf_decal/tile/neutral/fourcorners,
/turf/open/floor/holofloor/dark,
/area/template_noop)
"KE" = (
/obj/item/clothing/head/helmet/chaplain/witchunter_hat,
/obj/structure/table/wood/fancy,
/obj/effect/turf_decal/tile/neutral/fourcorners,
/turf/open/floor/holofloor/dark,
/area/template_noop)
"SD" = (
/obj/structure/table/wood/fancy,
/obj/item/clothing/suit/chaplainsuit/nun,
/obj/item/clothing/head/chaplain/nun_hood,
/obj/item/clothing/suit/chaplainsuit/holidaypriest,
/obj/effect/turf_decal/tile/neutral/fourcorners,
/turf/open/floor/holofloor/dark,
/area/template_noop)

(1,1,1) = {"
aD
ag
aA
ag
ac
aT
aA
aM
aM
aP
"}
(2,1,1) = {"
Eo
aK
ai
aK
aC
ak
ai
aM
aM
aZ
"}
(3,1,1) = {"
mT
av
at
ag
ac
aT
aA
aM
aM
aV
"}
(4,1,1) = {"
SD
af
aY
aK
aC
ak
ai
aM
aM
az
"}
(5,1,1) = {"
mQ
aQ
an
aD
aD
aD
aD
aJ
aJ
aj
"}
(6,1,1) = {"
ox
af
aY
ag
ac
aT
aA
aM
aM
aB
"}
(7,1,1) = {"
KE
fL
ae
aK
aE
ak
ai
aM
aM
aG
"}
(8,1,1) = {"
FJ
ag
aA
ag
ac
aT
aA
aM
aM
aR
"}
(9,1,1) = {"
aD
aK
ai
aK
aE
ak
ai
aM
aM
aP
"}
