//MAP CONVERTED BY dmm2tgm.py THIS HEADER COMMENT PREVENTS RECONVERSION, DO NOT REMOVE
"a" = (
/turf/open/floor/holofloor/beach/water,
/area/holodeck/rec_center/beach)
"f" = (
/obj/item/shovel/spade,
/turf/open/floor/holofloor/beach/coast_t,
/area/holodeck/rec_center/beach)
"g" = (
/obj/item/toy/beach_ball,
/turf/open/floor/holofloor/beach,
/area/holodeck/rec_center/beach)
"h" = (
/obj/item/clothing/under/color/rainbow,
/obj/item/clothing/glasses/sunglasses,
/turf/open/floor/holofloor/beach,
/area/holodeck/rec_center/beach)
"k" = (
/turf/open/floor/holofloor/beach/coast_b,
/area/holodeck/rec_center/beach)
"q" = (
/obj/item/reagent_containers/glass/bucket,
/turf/open/floor/holofloor/beach/coast_t,
/area/holodeck/rec_center/beach)
"t" = (
/turf/open/floor/holofloor/carpet,
/area/holodeck/rec_center/beach)
"H" = (
/obj/effect/holodeck_effect/mobspawner/monkey,
/turf/open/floor/holofloor/beach,
/area/holodeck/rec_center/beach)
"J" = (
/turf/open/floor/holofloor/beach/coast_t,
/area/holodeck/rec_center/beach)
"M" = (
/obj/item/toy/seashell,
/turf/open/floor/holofloor/beach,
/area/holodeck/rec_center/beach)
"Q" = (
/mob/living/simple_animal/crab{
	name = "Jon"
	},
/turf/open/floor/holofloor/beach/coast_t,
/area/holodeck/rec_center/beach)
"R" = (
/turf/open/floor/holofloor/beach,
/area/holodeck/rec_center/beach)
"S" = (
/obj/structure/fluff/beach_umbrella/cap,
/turf/open/floor/holofloor/beach,
/area/holodeck/rec_center/beach)
"T" = (
/obj/effect/overlay/palmtree_l,
/obj/effect/overlay/coconut,
/turf/open/floor/holofloor/beach,
/area/holodeck/rec_center/beach)
"W" = (
/obj/structure/flora/ausbushes/sparsegrass,
/turf/open/floor/holofloor/beach,
/area/holodeck/rec_center/beach)
"X" = (
/obj/effect/overlay/palmtree_r,
/turf/open/floor/holofloor/beach,
/area/holodeck/rec_center/beach)

(1,1,1) = {"
R
R
R
R
R
R
R
J
k
a
"}
(2,1,1) = {"
R
R
R
X
R
S
R
Q
k
a
"}
(3,1,1) = {"
X
H
R
R
R
t
t
J
k
a
"}
(4,1,1) = {"
R
R
R
R
h
R
R
J
k
a
"}
(5,1,1) = {"
R
R
W
R
R
t
t
J
k
a
"}
(6,1,1) = {"
R
R
R
R
X
g
R
q
k
a
"}
(7,1,1) = {"
R
T
H
R
R
R
R
f
k
a
"}
(8,1,1) = {"
W
R
R
R
H
R
M
J
k
a
"}
(9,1,1) = {"
R
R
R
R
R
R
R
J
k
a
"}
