//MAP CONVERTED BY dmm2tgm.py THIS HEADER COMMENT PREVENTS RECONVERSION, DO NOT REMOVE
"a" = (
/obj/structure/chair/wood{
	dir = 1
	},
/turf/open/floor/holofloor/grass,
/area/holodeck/rec_center/thunderdome1218)
"f" = (
/obj/structure/window/reinforced,
/obj/item/banner/red,
/turf/open/floor/holofloor/asteroid,
/area/holodeck/rec_center/thunderdome1218)
"g" = (
/obj/structure/window/reinforced,
/obj/item/banner/blue,
/turf/open/floor/holofloor/asteroid,
/area/holodeck/rec_center/thunderdome1218)
"k" = (
/obj/structure/table/wood/fancy,
/obj/item/clothing/suit/armor/riot/knight/blue,
/obj/item/clothing/head/helmet/knight/blue,
/turf/open/floor/holofloor/grass,
/area/holodeck/rec_center/thunderdome1218)
"n" = (
/obj/machinery/door/window/westleft{
	dir = 2
	},
/turf/open/floor/holofloor/grass,
/area/holodeck/rec_center/thunderdome1218)
"p" = (
/turf/open/floor/holofloor/asteroid,
/area/holodeck/rec_center/thunderdome1218)
"r" = (
/obj/structure/table/wood,
/obj/item/scythe,
/obj/item/spear,
/obj/item/melee/chainofcommand{
	name = "chain whip"
	},
/turf/open/floor/holofloor/asteroid,
/area/holodeck/rec_center/thunderdome1218)
"s" = (
/obj/machinery/door/window/westleft{
	dir = 2;
	icon_state = "right"
	},
/turf/open/floor/holofloor/grass,
/area/holodeck/rec_center/thunderdome1218)
"x" = (
/turf/open/floor/holofloor/grass,
/area/holodeck/rec_center/thunderdome1218)
"y" = (
/obj/structure/table/wood,
/obj/item/melee/chainofcommand{
	name = "chain whip"
	},
/obj/item/spear,
/turf/open/floor/holofloor/asteroid,
/area/holodeck/rec_center/thunderdome1218)
"B" = (
/turf/open/floor/holofloor{
	icon_state = "stairs-old"
	},
/area/holodeck/rec_center/thunderdome1218)
"C" = (
/obj/structure/table/wood/fancy,
/obj/item/clothing/head/crown/fancy{
	pixel_y = 6
	},
/turf/open/floor/holofloor/grass,
/area/holodeck/rec_center/thunderdome1218)
"E" = (
/obj/structure/window/reinforced,
/turf/open/floor/holofloor/asteroid,
/area/holodeck/rec_center/thunderdome1218)
"H" = (
/obj/structure/statue/diamond/captain,
/turf/open/floor/holofloor/grass,
/area/holodeck/rec_center/thunderdome1218)
"J" = (
/obj/structure/window/reinforced,
/turf/open/floor/holofloor/grass,
/area/holodeck/rec_center/thunderdome1218)
"N" = (
/obj/structure/table/wood,
/obj/item/spear,
/turf/open/floor/holofloor/asteroid,
/area/holodeck/rec_center/thunderdome1218)
"Q" = (
/obj/structure/table/wood/fancy,
/obj/item/clothing/suit/armor/riot/knight/blue,
/obj/item/clothing/head/helmet/knight/blue,
/obj/item/claymore/weak,
/turf/open/floor/holofloor/grass,
/area/holodeck/rec_center/thunderdome1218)
"R" = (
/obj/machinery/door/window/westleft{
	dir = 2
	},
/turf/open/floor/holofloor/asteroid,
/area/holodeck/rec_center/thunderdome1218)
"T" = (
/obj/structure/table/wood,
/obj/item/tailclub,
/obj/item/spear,
/turf/open/floor/holofloor/asteroid,
/area/holodeck/rec_center/thunderdome1218)
"X" = (
/obj/structure/table/wood,
/obj/item/scythe,
/obj/item/spear,
/turf/open/floor/holofloor/asteroid,
/area/holodeck/rec_center/thunderdome1218)

(1,1,1) = {"
H
J
N
p
p
p
p
g
x
a
"}
(2,1,1) = {"
x
J
r
p
p
p
p
E
x
a
"}
(3,1,1) = {"
k
s
B
p
p
p
p
E
x
a
"}
(4,1,1) = {"
Q
J
y
p
p
p
p
R
x
a
"}
(5,1,1) = {"
C
J
X
p
p
p
p
E
x
a
"}
(6,1,1) = {"
Q
J
T
p
p
p
p
R
x
a
"}
(7,1,1) = {"
k
n
B
p
p
p
p
E
x
a
"}
(8,1,1) = {"
x
J
y
p
p
p
p
E
x
a
"}
(9,1,1) = {"
H
J
T
p
p
p
p
f
x
a
"}
