//MAP CONVERTED BY dmm2tgm.py THIS HEADER COMMENT PREVENTS RECONVERSION, DO NOT REMOVE
"a" = (
/obj/structure/infection/shield,
/turf/open/space/basic,
/area/space)
"b" = (
/obj/structure/infection/normal,
/turf/open/space/basic,
/area/space)
"c" = (
/obj/structure/infection/factory,
/turf/open/space/basic,
/area/space)
"d" = (
/obj/structure/infection/turret/core,
/turf/open/space/basic,
/area/space)
"e" = (
/obj/structure/infection/turret/beam,
/turf/open/space/basic,
/area/space)
"l" = (
/turf/open/space/basic,
/area/space)

(1,1,1) = {"
b
b
a
a
a
a
a
a
a
a
a
a
a
a
a
a
a
a
a
a
a
a
a
a
a
a
b
b
b
a
a
a
a
a
a
a
a
a
a
a
a
a
a
a
a
a
a
a
a
a
a
a
a
b
b
"}
(2,1,1) = {"
b
b
b
a
a
a
a
a
a
a
a
a
a
a
a
a
a
a
a
a
a
a
a
a
a
a
b
b
b
a
a
a
a
a
a
a
a
a
a
a
a
a
a
a
a
a
a
a
a
a
a
a
b
b
b
"}
(3,1,1) = {"
a
b
b
b
a
a
a
a
a
a
a
a
a
a
a
a
a
a
a
a
a
a
a
a
a
a
b
b
b
a
a
a
a
a
a
a
a
a
a
a
a
a
a
a
a
a
a
a
a
a
a
b
b
b
a
"}
(4,1,1) = {"
a
a
b
b
b
b
b
b
b
b
b
b
b
b
a
a
a
b
b
b
b
b
b
b
b
b
b
b
b
b
b
b
b
b
b
b
b
b
a
a
a
b
b
b
b
b
b
b
b
b
b
b
b
a
a
"}
(5,1,1) = {"
a
a
a
b
b
b
b
b
b
b
b
b
b
b
b
a
a
a
b
b
b
b
b
b
b
b
b
b
b
b
b
b
b
b
b
b
b
a
a
a
b
b
b
b
b
b
b
b
b
b
b
b
a
a
a
"}
(6,1,1) = {"
a
a
a
b
b
b
b
b
b
b
b
b
b
b
b
b
a
a
a
b
b
b
b
b
b
b
b
b
b
b
b
b
b
b
b
b
a
a
a
b
b
b
b
b
b
b
b
b
b
b
b
b
a
a
a
"}
(7,1,1) = {"
a
a
a
b
b
b
b
b
b
b
b
b
b
b
b
b
b
a
a
a
b
b
b
b
b
b
b
b
b
b
b
b
b
b
b
a
a
a
b
b
b
b
b
b
b
b
b
b
b
b
b
b
a
a
a
"}
(8,1,1) = {"
a
a
a
b
b
b
b
b
b
b
b
b
b
b
b
b
b
b
a
a
a
b
b
b
b
b
b
e
b
b
b
b
b
b
a
a
a
b
b
b
b
b
b
b
b
b
b
b
b
b
b
b
a
a
a
"}
(9,1,1) = {"
a
a
a
b
b
b
b
b
b
b
b
b
b
b
b
b
b
b
b
a
a
a
b
b
b
b
b
b
b
b
b
b
b
a
a
a
b
b
b
b
b
b
b
b
b
b
b
b
b
b
b
b
a
a
a
"}
(10,1,1) = {"
a
a
a
b
b
b
b
b
b
b
b
b
b
b
b
b
b
b
b
b
a
a
a
b
b
b
b
b
b
b
b
b
a
a
a
b
b
b
b
b
b
b
b
b
b
b
b
b
b
b
b
b
a
a
a
"}
(11,1,1) = {"
a
a
a
b
b
b
b
b
b
b
b
b
b
b
b
b
b
b
b
b
b
a
a
a
b
b
b
c
b
b
b
a
a
a
b
b
b
b
b
b
b
b
b
b
b
b
b
b
b
b
b
b
a
a
a
"}
(12,1,1) = {"
a
a
a
b
b
b
b
b
b
b
b
e
b
b
b
b
b
b
b
b
b
b
a
a
a
b
a
a
a
b
a
a
a
b
b
b
b
b
b
b
b
b
b
e
b
b
b
b
b
b
b
b
a
a
a
"}
(13,1,1) = {"
a
a
a
b
b
b
b
b
b
b
b
b
b
b
b
b
b
b
b
b
b
b
b
a
a
b
a
a
a
b
a
a
b
b
b
b
b
b
b
b
b
b
b
b
b
b
b
b
b
b
b
b
a
a
a
"}
(14,1,1) = {"
a
a
a
b
b
b
b
b
b
b
b
b
b
b
b
b
b
b
b
b
b
b
a
a
a
b
a
a
a
b
a
a
a
b
b
b
b
b
b
b
b
b
b
b
b
b
b
b
b
b
b
b
a
a
a
"}
(15,1,1) = {"
a
a
a
a
b
b
b
b
b
b
b
b
b
b
b
b
b
b
b
b
b
a
a
a
b
b
b
d
b
b
b
a
a
a
b
b
b
b
b
b
b
b
b
b
b
b
b
b
b
b
b
a
a
a
a
"}
(16,1,1) = {"
a
a
a
a
a
b
b
b
b
b
b
b
b
b
b
b
b
b
b
b
b
a
a
b
b
b
b
b
b
b
b
b
a
a
b
b
b
b
b
b
b
b
b
b
b
b
b
b
b
b
a
a
a
a
a
"}
(17,1,1) = {"
a
a
a
a
a
a
b
b
b
b
b
b
b
b
b
b
b
b
b
a
b
b
b
b
b
b
b
b
b
b
b
b
b
b
b
a
b
b
b
b
b
b
b
b
b
b
b
b
b
a
a
a
a
a
a
"}
(18,1,1) = {"
a
a
a
b
a
a
a
b
b
b
b
b
b
b
b
b
b
c
a
a
a
b
b
b
b
b
b
b
b
b
b
b
b
b
a
a
a
c
b
b
b
b
b
b
b
b
b
b
a
a
a
b
a
a
a
"}
(19,1,1) = {"
a
a
a
b
b
a
a
a
b
b
b
b
b
b
b
b
b
a
a
a
b
b
b
b
b
b
b
b
b
b
b
b
b
b
b
a
a
a
b
b
b
b
b
b
b
b
b
a
a
a
b
b
a
a
a
"}
(20,1,1) = {"
a
a
a
b
b
b
a
a
a
b
b
b
b
b
b
b
a
a
a
d
b
b
b
a
a
a
a
b
a
a
a
a
b
b
b
d
a
a
a
b
b
b
b
b
b
b
a
a
a
b
b
b
a
a
a
"}
(21,1,1) = {"
a
a
a
b
b
b
b
a
a
a
b
b
b
b
b
b
b
a
b
b
b
b
a
a
a
a
a
b
a
a
a
a
a
b
b
b
b
a
b
b
b
b
b
b
b
a
a
a
b
b
b
b
a
a
a
"}
(22,1,1) = {"
a
a
a
b
b
b
b
b
a
a
a
b
b
b
a
a
b
b
b
b
b
a
a
a
a
a
a
b
a
a
a
a
a
a
b
b
b
b
b
a
a
b
b
b
a
a
a
b
b
b
b
b
a
a
a
"}
(23,1,1) = {"
a
a
a
b
b
b
b
b
b
a
a
a
b
a
a
a
b
b
b
b
a
a
a
a
a
a
a
b
a
a
a
a
a
a
a
b
b
b
b
a
a
a
b
a
a
a
b
b
b
b
b
b
a
a
a
"}
(24,1,1) = {"
a
a
a
b
b
b
b
b
b
b
a
a
a
a
a
b
b
b
b
a
a
a
a
e
b
b
b
b
b
b
b
e
a
a
a
a
b
b
b
b
a
a
a
a
a
b
b
b
b
b
b
b
a
a
a
"}
(25,1,1) = {"
a
a
a
b
b
b
b
b
b
b
b
a
a
a
b
b
b
b
b
a
a
a
a
b
b
b
b
b
b
b
b
b
a
a
a
a
b
b
b
b
b
a
a
a
b
b
b
b
b
b
b
b
a
a
a
"}
(26,1,1) = {"
a
a
a
b
b
b
b
b
b
b
b
b
b
b
b
b
b
b
b
a
a
a
a
b
b
b
b
b
b
b
b
b
a
a
a
a
b
b
b
b
b
b
b
b
b
b
b
b
b
b
b
b
a
a
a
"}
(27,1,1) = {"
b
b
b
b
b
b
b
b
b
b
b
a
a
a
b
b
b
b
b
a
a
a
a
b
b
b
b
b
b
b
b
b
a
a
a
a
b
b
b
b
b
a
a
a
b
b
b
b
b
b
b
b
b
b
b
"}
(28,1,1) = {"
b
b
b
b
b
b
b
e
b
b
c
a
a
a
d
b
b
b
b
b
b
b
b
b
b
b
b
l
b
b
b
b
b
b
b
b
b
b
b
b
d
a
a
a
c
b
b
e
b
b
b
b
b
b
b
"}
(29,1,1) = {"
b
b
b
b
b
b
b
b
b
b
b
a
a
a
b
b
b
b
b
a
a
a
a
b
b
b
b
b
b
b
b
b
a
a
a
a
b
b
b
b
b
a
a
a
b
b
b
b
b
b
b
b
b
b
b
"}
(30,1,1) = {"
a
a
a
b
b
b
b
b
b
b
b
b
b
b
b
b
b
b
b
a
a
a
a
b
b
b
b
b
b
b
b
b
a
a
a
a
b
b
b
b
b
b
b
b
b
b
b
b
b
b
b
b
a
a
a
"}
(31,1,1) = {"
a
a
a
b
b
b
b
b
b
b
b
a
a
a
b
b
b
b
b
a
a
a
a
b
b
b
b
b
b
b
b
b
a
a
a
a
b
b
b
b
b
a
a
a
b
b
b
b
b
b
b
b
a
a
a
"}
(32,1,1) = {"
a
a
a
b
b
b
b
b
b
b
a
a
a
a
a
b
b
b
b
a
a
a
a
e
b
b
b
b
b
b
b
e
a
a
a
a
b
b
b
b
a
a
a
a
a
b
b
b
b
b
b
b
a
a
a
"}
(33,1,1) = {"
a
a
a
b
b
b
b
b
b
a
a
a
b
a
a
a
b
b
b
b
a
a
a
a
a
a
a
b
a
a
a
a
a
a
a
b
b
b
b
a
a
a
b
a
a
a
b
b
b
b
b
b
a
a
a
"}
(34,1,1) = {"
a
a
a
b
b
b
b
b
a
a
a
b
b
b
a
a
b
b
b
b
b
a
a
a
a
a
a
b
a
a
a
a
a
a
b
b
b
b
b
a
a
b
b
b
a
a
a
b
b
b
b
b
a
a
a
"}
(35,1,1) = {"
a
a
a
b
b
b
b
a
a
a
b
b
b
b
b
b
b
a
b
b
b
b
a
a
a
a
a
b
a
a
a
a
a
b
b
b
b
a
b
b
b
b
b
b
b
a
a
a
b
b
b
b
a
a
a
"}
(36,1,1) = {"
a
a
a
b
b
b
a
a
a
b
b
b
b
b
b
b
a
a
a
d
b
b
b
a
a
a
a
b
a
a
a
a
b
b
b
d
a
a
a
b
b
b
b
b
b
b
a
a
a
b
b
b
a
a
a
"}
(37,1,1) = {"
a
a
a
b
b
a
a
a
b
b
b
b
b
b
b
b
b
a
a
a
b
b
b
b
b
b
b
b
b
b
b
b
b
b
b
a
a
a
b
b
b
b
b
b
b
b
b
a
a
a
b
b
a
a
a
"}
(38,1,1) = {"
a
a
a
b
a
a
a
b
b
b
b
b
b
b
b
b
b
c
a
a
a
b
b
b
b
b
b
b
b
b
b
b
b
b
a
a
a
c
b
b
b
b
b
b
b
b
b
b
a
a
a
b
a
a
a
"}
(39,1,1) = {"
a
a
a
a
a
a
b
b
b
b
b
b
b
b
b
b
b
b
b
a
b
b
b
b
b
b
b
b
b
b
b
b
b
b
b
a
b
b
b
b
b
b
b
b
b
b
b
b
b
a
a
a
a
a
a
"}
(40,1,1) = {"
a
a
a
a
a
b
b
b
b
b
b
b
b
b
b
b
b
b
b
b
b
a
a
b
b
b
b
b
b
b
b
b
a
a
b
b
b
b
b
b
b
b
b
b
b
b
b
b
b
b
a
a
a
a
a
"}
(41,1,1) = {"
a
a
a
a
b
b
b
b
b
b
b
b
b
b
b
b
b
b
b
b
b
a
a
a
b
b
b
d
b
b
b
a
a
a
b
b
b
b
b
b
b
b
b
b
b
b
b
b
b
b
b
a
a
a
a
"}
(42,1,1) = {"
a
a
a
b
b
b
b
b
b
b
b
b
b
b
b
b
b
b
b
b
b
b
a
a
a
b
a
a
a
b
a
a
a
b
b
b
b
b
b
b
b
b
b
b
b
b
b
b
b
b
b
b
a
a
a
"}
(43,1,1) = {"
a
a
a
b
b
b
b
b
b
b
b
b
b
b
b
b
b
b
b
b
b
b
b
a
a
b
a
a
a
b
a
a
b
b
b
b
b
b
b
b
b
b
b
b
b
b
b
b
b
b
b
b
a
a
a
"}
(44,1,1) = {"
a
a
a
b
b
b
b
b
b
b
b
e
b
b
b
b
b
b
b
b
b
b
a
a
a
b
a
a
a
b
a
a
a
b
b
b
b
b
b
b
b
b
b
e
b
b
b
b
b
b
b
b
a
a
a
"}
(45,1,1) = {"
a
a
a
b
b
b
b
b
b
b
b
b
b
b
b
b
b
b
b
b
b
a
a
a
b
b
b
c
b
b
b
a
a
a
b
b
b
b
b
b
b
b
b
b
b
b
b
b
b
b
b
b
a
a
a
"}
(46,1,1) = {"
a
a
a
b
b
b
b
b
b
b
b
b
b
b
b
b
b
b
b
b
a
a
a
b
b
b
b
b
b
b
b
b
a
a
a
b
b
b
b
b
b
b
b
b
b
b
b
b
b
b
b
b
a
a
a
"}
(47,1,1) = {"
a
a
a
b
b
b
b
b
b
b
b
b
b
b
b
b
b
b
b
a
a
a
b
b
b
b
b
b
b
b
b
b
b
a
a
a
b
b
b
b
b
b
b
b
b
b
b
b
b
b
b
b
a
a
a
"}
(48,1,1) = {"
a
a
a
b
b
b
b
b
b
b
b
b
b
b
b
b
b
b
a
a
a
b
b
b
b
b
b
e
b
b
b
b
b
b
a
a
a
b
b
b
b
b
b
b
b
b
b
b
b
b
b
b
a
a
a
"}
(49,1,1) = {"
a
a
a
b
b
b
b
b
b
b
b
b
b
b
b
b
b
a
a
a
b
b
b
b
b
b
b
b
b
b
b
b
b
b
b
a
a
a
b
b
b
b
b
b
b
b
b
b
b
b
b
b
a
a
a
"}
(50,1,1) = {"
a
a
a
b
b
b
b
b
b
b
b
b
b
b
b
b
a
a
a
b
b
b
b
b
b
b
b
b
b
b
b
b
b
b
b
b
a
a
a
b
b
b
b
b
b
b
b
b
b
b
b
b
a
a
a
"}
(51,1,1) = {"
a
a
a
b
b
b
b
b
b
b
b
b
b
b
b
a
a
a
b
b
b
b
b
b
b
b
b
b
b
b
b
b
b
b
b
b
b
a
a
a
b
b
b
b
b
b
b
b
b
b
b
b
a
a
a
"}
(52,1,1) = {"
a
a
b
b
b
b
b
b
b
b
b
b
b
b
a
a
a
b
b
b
b
b
b
b
b
b
b
b
b
b
b
b
b
b
b
b
b
b
a
a
a
b
b
b
b
b
b
b
b
b
b
b
b
a
a
"}
(53,1,1) = {"
a
b
b
b
a
a
a
a
a
a
a
a
a
a
a
a
a
a
a
a
a
a
a
a
a
a
b
b
b
a
a
a
a
a
a
a
a
a
a
a
a
a
a
a
a
a
a
a
a
a
a
b
b
b
a
"}
(54,1,1) = {"
b
b
b
a
a
a
a
a
a
a
a
a
a
a
a
a
a
a
a
a
a
a
a
a
a
a
b
b
b
a
a
a
a
a
a
a
a
a
a
a
a
a
a
a
a
a
a
a
a
a
a
a
b
b
b
"}
(55,1,1) = {"
b
b
a
a
a
a
a
a
a
a
a
a
a
a
a
a
a
a
a
a
a
a
a
a
a
a
b
b
b
a
a
a
a
a
a
a
a
a
a
a
a
a
a
a
a
a
a
a
a
a
a
a
a
b
b
"}
