"a" = (/turf/simulated/floor/plating/asteroid/basalt/lava_land_surface,/area/lavaland/surface/outdoors)
"b" = (/turf/simulated/wall/r_wall,/area/ruin/powered)
"c" = (/turf/simulated/floor/plating{baseturf = /turf/simulated/floor/plating/lava/smooth},/area/ruin/powered)
"d" = (/obj/structure/grille,/obj/structure/window/fulltile,/obj/structure/window/fulltile,/turf/simulated/floor/plating{baseturf = /turf/simulated/floor/plating/lava/smooth},/area/ruin/powered)
"e" = (/obj/structure/grille,/obj/structure/window/fulltile,/turf/simulated/floor/plating{baseturf = /turf/simulated/floor/plating/lava/smooth},/area/ruin/powered)
"f" = (/turf/simulated/floor/plating/ice,/area/ruin/powered)
"g" = (/turf/simulated/floor/plating/asteroid/snow{baseturf = /turf/simulated/floor/plating/lava/smooth},/area/ruin/powered)
"h" = (/obj/structure/flora/rock/icy,/turf/simulated/floor/plating/asteroid/snow{baseturf = /turf/simulated/floor/plating/lava/smooth},/area/ruin/powered)
"i" = (/obj/structure/flora/bush,/turf/simulated/floor/plating/asteroid/snow{baseturf = /turf/simulated/floor/plating/lava/smooth},/area/ruin/powered)
"j" = (/turf/simulated/wall/mineral/wood,/area/ruin/powered)
"k" = (/obj/structure/dresser,/turf/simulated/floor/wood{baseturf = /turf/simulated/floor/plating/lava/smooth; name = "floor"},/area/ruin/powered)
"l" = (/obj/structure/bed,/turf/simulated/floor/wood{baseturf = /turf/simulated/floor/plating/lava/smooth; name = "floor"},/area/ruin/powered)
"m" = (/obj/structure/bookcase/random,/turf/simulated/floor/wood{baseturf = /turf/simulated/floor/plating/lava/smooth; name = "floor"},/area/ruin/powered)
"n" = (/obj/structure/flora/tree/pine,/turf/simulated/floor/plating/asteroid/snow{baseturf = /turf/simulated/floor/plating/lava/smooth},/area/ruin/powered)
"o" = (/obj/structure/flora/grass/both,/turf/simulated/floor/plating/asteroid/snow{baseturf = /turf/simulated/floor/plating/lava/smooth},/area/ruin/powered)
"p" = (/turf/simulated/floor/wood{baseturf = /turf/simulated/floor/plating/lava/smooth; name = "floor"},/area/ruin/powered)
"q" = (/obj/structure/flora/tree/dead,/turf/simulated/floor/plating/asteroid/snow{baseturf = /turf/simulated/floor/plating/lava/smooth},/area/ruin/powered)
"r" = (/obj/machinery/door/airlock/wood,/turf/simulated/floor/wood{baseturf = /turf/simulated/floor/plating/lava/smooth; name = "floor"},/area/ruin/powered)
"s" = (/obj/structure/chair/comfy/brown{tag = "icon-comfychair (EAST)"; icon_state = "comfychair"; dir = 4},/turf/simulated/floor/wood{baseturf = /turf/simulated/floor/plating/lava/smooth; name = "floor"},/area/ruin/powered)
"t" = (/obj/structure/table/wood,/turf/simulated/floor/wood{baseturf = /turf/simulated/floor/plating/lava/smooth; name = "floor"},/area/ruin/powered)
"u" = (/obj/structure/chair/comfy/brown{tag = "icon-comfychair (WEST)"; icon_state = "comfychair"; dir = 8},/turf/simulated/floor/wood{baseturf = /turf/simulated/floor/plating/lava/smooth; name = "floor"},/area/ruin/powered)
"v" = (/turf/simulated/wall/mineral/wood{baseturf = /turf/simulated/floor/plating/lava/smooth},/area/ruin/powered)
"w" = (/obj/structure/displaycase/captain,/turf/simulated/floor/wood{baseturf = /turf/simulated/floor/plating/lava/smooth; name = "floor"},/area/ruin/powered)
"x" = (/obj/structure/bed/dogbed,/turf/simulated/floor/wood{baseturf = /turf/simulated/floor/plating/lava/smooth; name = "floor"},/area/ruin/powered)
"y" = (/obj/structure/flora/tree/pine/xmas,/turf/simulated/floor/plating/asteroid/snow{baseturf = /turf/simulated/floor/plating/lava/smooth},/area/ruin/powered)
"z" = (/obj/machinery/door/airlock/hatch,/turf/simulated/floor/plating{baseturf = /turf/simulated/floor/plating/lava/smooth; blocks_air = 1},/area/ruin/powered)
"A" = (/obj/machinery/door/airlock/silver,/turf/indestructible/fakeglass{tag = "icon-fakewindows2 (SOUTHEAST)"; icon_state = "fakewindows2"; dir = 6},/area/ruin/powered)
"B" = (/obj/structure/flora/rock/pile/icy,/turf/simulated/floor/plating/asteroid/snow{baseturf = /turf/simulated/floor/plating/lava/smooth},/area/ruin/powered)
"C" = (/turf/simulated/floor/wood{baseturf = /turf/simulated/floor/plating/lava/smooth; name = "bridge"},/area/ruin/powered)
"D" = (/turf/simulated/wall/r_wall{baseturf = /turf/simulated/floor/plating/lava/smooth},/area/ruin/powered)

(1,1,1) = {"
aaaaaaaaaaaaaaaaaaaaaaaaaaaaaa
bbbbbbbbbbbbbbbbbbbbbbbbbbbbbb
bccccccccccccccccccccccccccccb
bcdeeeeeeeeeeeeeeeeeeeeeeeedcb
bceffghgggggggggijjjjjjjjjjecb
bcegffggggigggggijkljmmmmmjecb
bcegffffngggnggogjppjpppppjecb
bceqgfffggqggggggjrjjpstupjecb
bcegiffffgggiggggjppppstupjecb
bceigggffggginigovwppppppxjecb
bceggigfffgggggggjjjjrrjjjjecb
bcegggggffgggghggggggggggggecb
bcegngggfffnggggiggggggggygecb
bcegggggfffggqgogggggggggggecb
bceogggggffffgggggngggniiggecb
zcAgBgnggfffffggggggqggggggecb
bceggggggggffggngggiggohgggecb
bcegggqggigfffgggggggggggngecb
bcegnggggngffffggggnggqggggecb
bcegggghggCCCCCCgqggggggoggecb
bceggoiiggCCCCCCgggghgiggggecb
bcegggigggggfffggggggigggggecb
bceggggoqgigggfffgggggngBngecb
bceggggggggggiggffgnggiigggecb
bceigngggignggggffgggoiiggiecb
bcegggggggggiigigfffggggqggecb
bceiiggngggggqgggggffggggggecb
bcdeeeeeeeeeeeeeeeeeeeeeeeedcb
bccccccccccccccccccccccccccccb
bbbbbDbbbbbbbbbbbbbbbbbbbbbbbb
"}
