//MAP CONVERTED BY dmm2tgm.py THIS HEADER COMMENT PREVENTS RECONVERSION, DO NOT REMOVE
"as" = (
/turf/open/floor/grass/norandomicon{
	desc = "Focusing intently on individual blades of grass, it almost looks like they're moving."
	},
/area/centcom/heretic_backdoor)
"ay" = (
/obj/effect/turf_decal/siding/wood/corner{
	dir = 4
	},
/turf/open/floor/wood/large,
/area/centcom/heretic_backdoor)
"aD" = (
/obj/effect/step_trigger/teleporter/offset{
	teleport_y_offset = -30
	},
/turf/open/floor/grass/norandomicon{
	desc = "Focusing intently on individual blades of grass, it almost looks like they're moving."
	},
/area/centcom/heretic_backdoor)
"ei" = (
/obj/structure/dresser,
/turf/open/floor/wood/large,
/area/centcom/heretic_backdoor)
"eo" = (
/obj/effect/step_trigger/teleporter/offset{
	teleport_y_offset = -3;
	teleport_x_offset = 2
	},
/turf/open/floor/grass/norandomicon{
	desc = "Focusing intently on individual blades of grass, it almost looks like they're moving."
	},
/area/centcom/heretic_backdoor)
"fq" = (
/turf/open/mirage{
	dir = 4;
	target_turf_x = -31;
	range = 12
	},
/area/centcom/heretic_backdoor)
"fW" = (
/obj/effect/step_trigger/teleporter/offset{
	teleport_x_offset = -3;
	teleport_y_offset = 3
	},
/turf/open/floor/grass/norandomicon{
	desc = "Focusing intently on individual blades of grass, it almost looks like they're moving."
	},
/area/centcom/heretic_backdoor)
"gm" = (
/obj/structure/table/wood/shuttle_bar,
/obj/effect/turf_decal/siding/wood,
/obj/item/paper/crumpled{
	default_raw_text = "We know you're here."
	},
/obj/item/pen,
/turf/open/floor/wood/large,
/area/centcom/heretic_backdoor)
"iG" = (
/obj/structure/fireplace{
	desc = "It looks like it hasn't been lit in a long time."
	},
/obj/effect/decal/cleanable/ash{
	pixel_y = 0;
	pixel_x = 4
	},
/turf/open/floor/stone,
/area/centcom/heretic_backdoor)
"iL" = (
/obj/effect/step_trigger/teleporter/offset{
	teleport_y_offset = -3;
	teleport_x_offset = 1
	},
/turf/open/floor/grass/norandomicon{
	desc = "Focusing intently on individual blades of grass, it almost looks like they're moving."
	},
/area/centcom/heretic_backdoor)
"jq" = (
/obj/effect/turf_decal/siding/wood/corner{
	dir = 4
	},
/obj/structure/chair/sofa/corner/brown{
	dir = 1
	},
/obj/effect/turf_decal/siding/wood/corner{
	dir = 1
	},
/turf/open/floor/wood/large,
/area/centcom/heretic_backdoor)
"lL" = (
/obj/effect/step_trigger/teleporter/offset{
	teleport_y_offset = -1;
	teleport_x_offset = 3
	},
/turf/open/floor/grass/norandomicon{
	desc = "Focusing intently on individual blades of grass, it almost looks like they're moving."
	},
/area/centcom/heretic_backdoor)
"nc" = (
/obj/effect/step_trigger/teleporter/offset{
	teleport_x_offset = -2;
	teleport_y_offset = 3
	},
/turf/open/floor/grass/norandomicon{
	desc = "Focusing intently on individual blades of grass, it almost looks like they're moving."
	},
/area/centcom/heretic_backdoor)
"nf" = (
/turf/open/mirage{
	dir = 8;
	target_turf_x = 31;
	range = 12
	},
/area/centcom/heretic_backdoor)
"oy" = (
/obj/effect/spawner/structure/window,
/obj/structure/curtain/bounty,
/turf/open/indestructible/plating,
/area/centcom/heretic_backdoor)
"oz" = (
/obj/effect/step_trigger/teleporter/offset{
	teleport_y_offset = -3;
	teleport_x_offset = 3
	},
/turf/open/floor/grass/norandomicon{
	desc = "Focusing intently on individual blades of grass, it almost looks like they're moving."
	},
/area/centcom/heretic_backdoor)
"oH" = (
/obj/effect/step_trigger/teleporter/offset{
	teleport_x_offset = -3
	},
/turf/open/floor/grass/norandomicon{
	desc = "Focusing intently on individual blades of grass, it almost looks like they're moving."
	},
/area/centcom/heretic_backdoor)
"pE" = (
/obj/effect/step_trigger/teleporter/offset{
	teleport_x_offset = 1;
	teleport_y_offset = 3
	},
/turf/open/floor/grass/norandomicon{
	desc = "Focusing intently on individual blades of grass, it almost looks like they're moving."
	},
/area/centcom/heretic_backdoor)
"pS" = (
/obj/item/paper/crumpled{
	invisibility = 101;
	default_raw_text = "How do mirage work: TL;DR projects a number of turfs in front of the target turf (according to direction and offset) based on range."
	},
/turf/open/floor/grass/norandomicon{
	desc = "Focusing intently on individual blades of grass, it almost looks like they're moving."
	},
/area/centcom/heretic_backdoor)
"ql" = (
/turf/open/floor/wood/large,
/area/centcom/heretic_backdoor)
"qF" = (
/obj/effect/step_trigger/teleporter/offset{
	teleport_y_offset = -2;
	teleport_x_offset = -3
	},
/turf/open/floor/grass/norandomicon{
	desc = "Focusing intently on individual blades of grass, it almost looks like they're moving."
	},
/area/centcom/heretic_backdoor)
"rv" = (
/obj/effect/step_trigger/teleporter/offset{
	teleport_x_offset = -30
	},
/turf/open/floor/grass/norandomicon{
	desc = "Focusing intently on individual blades of grass, it almost looks like they're moving."
	},
/area/centcom/heretic_backdoor)
"tY" = (
/obj/effect/step_trigger/teleporter/offset{
	teleport_y_offset = -2;
	teleport_x_offset = 3
	},
/turf/open/floor/grass/norandomicon{
	desc = "Focusing intently on individual blades of grass, it almost looks like they're moving."
	},
/area/centcom/heretic_backdoor)
"va" = (
/obj/effect/spawner/structure/window,
/obj/structure/curtain/bounty/start_closed,
/turf/open/indestructible/plating,
/area/centcom/heretic_backdoor)
"vY" = (
/obj/effect/step_trigger/teleporter/offset{
	teleport_x_offset = 30
	},
/turf/open/floor/grass/norandomicon{
	desc = "Focusing intently on individual blades of grass, it almost looks like they're moving."
	},
/area/centcom/heretic_backdoor)
"xb" = (
/obj/effect/step_trigger/teleporter/offset{
	teleport_y_offset = -3;
	teleport_x_offset = -1
	},
/turf/open/floor/grass/norandomicon{
	desc = "Focusing intently on individual blades of grass, it almost looks like they're moving."
	},
/area/centcom/heretic_backdoor)
"xr" = (
/obj/effect/step_trigger/teleporter/offset{
	teleport_y_offset = 30
	},
/turf/open/floor/grass/norandomicon{
	desc = "Focusing intently on individual blades of grass, it almost looks like they're moving."
	},
/area/centcom/heretic_backdoor)
"xA" = (
/obj/structure/bed/double,
/obj/item/bedsheet/cosmos/double,
/obj/effect/turf_decal/siding/wood{
	dir = 4
	},
/turf/open/floor/wood/large,
/area/centcom/heretic_backdoor)
"xD" = (
/obj/structure/chair/wood{
	dir = 8
	},
/obj/effect/turf_decal/siding/wood,
/turf/open/floor/wood/large,
/area/centcom/heretic_backdoor)
"yL" = (
/obj/effect/step_trigger/teleporter/offset{
	teleport_x_offset = 2;
	teleport_y_offset = 3
	},
/turf/open/floor/grass/norandomicon{
	desc = "Focusing intently on individual blades of grass, it almost looks like they're moving."
	},
/area/centcom/heretic_backdoor)
"Ah" = (
/obj/effect/step_trigger/teleporter/offset{
	teleport_x_offset = -1;
	teleport_y_offset = 3
	},
/turf/open/floor/grass/norandomicon{
	desc = "Focusing intently on individual blades of grass, it almost looks like they're moving."
	},
/area/centcom/heretic_backdoor)
"Ak" = (
/obj/effect/turf_decal/siding/wood{
	dir = 1
	},
/turf/open/floor/wood/large,
/area/centcom/heretic_backdoor)
"Fx" = (
/obj/effect/step_trigger/teleporter/offset{
	teleport_y_offset = -1;
	teleport_x_offset = -3
	},
/turf/open/floor/grass/norandomicon{
	desc = "Focusing intently on individual blades of grass, it almost looks like they're moving."
	},
/area/centcom/heretic_backdoor)
"FH" = (
/obj/effect/turf_decal/siding/wood{
	dir = 4
	},
/obj/structure/closet/cabinet,
/turf/open/floor/wood/large,
/area/centcom/heretic_backdoor)
"Gp" = (
/obj/effect/step_trigger/teleporter/offset{
	teleport_y_offset = -3
	},
/turf/open/floor/grass/norandomicon{
	desc = "Focusing intently on individual blades of grass, it almost looks like they're moving."
	},
/area/centcom/heretic_backdoor)
"KE" = (
/obj/effect/turf_decal/siding/wood{
	dir = 1
	},
/obj/structure/chair/sofa/right/brown{
	dir = 1
	},
/turf/open/floor/wood/large,
/area/centcom/heretic_backdoor)
"Lu" = (
/obj/effect/step_trigger/teleporter/offset{
	teleport_y_offset = -3;
	teleport_x_offset = -2
	},
/turf/open/floor/grass/norandomicon{
	desc = "Focusing intently on individual blades of grass, it almost looks like they're moving."
	},
/area/centcom/heretic_backdoor)
"Ng" = (
/turf/open/mirage{
	target_turf_y = 31;
	range = 7
	},
/area/centcom/heretic_backdoor)
"Nx" = (
/turf/closed/indestructible/wood,
/area/centcom/heretic_backdoor)
"Ny" = (
/obj/effect/step_trigger/teleporter/offset{
	teleport_x_offset = 3;
	teleport_y_offset = 1
	},
/turf/open/floor/grass/norandomicon{
	desc = "Focusing intently on individual blades of grass, it almost looks like they're moving."
	},
/area/centcom/heretic_backdoor)
"OC" = (
/obj/structure/chair/wood{
	dir = 4
	},
/obj/effect/turf_decal/siding/wood,
/turf/open/floor/wood/large,
/area/centcom/heretic_backdoor)
"PM" = (
/obj/structure/table/wood/shuttle_bar,
/obj/effect/turf_decal/siding/wood/corner,
/turf/open/floor/wood/large,
/area/centcom/heretic_backdoor)
"PY" = (
/obj/effect/step_trigger/teleporter/offset{
	teleport_x_offset = 3
	},
/turf/open/floor/grass/norandomicon{
	desc = "Focusing intently on individual blades of grass, it almost looks like they're moving."
	},
/area/centcom/heretic_backdoor)
"Qh" = (
/turf/open/mirage{
	dir = 1;
	target_turf_y = -31;
	range = 7
	},
/area/centcom/heretic_backdoor)
"Qm" = (
/obj/effect/step_trigger/teleporter/offset{
	teleport_y_offset = -3;
	teleport_x_offset = -3
	},
/turf/open/floor/grass/norandomicon{
	desc = "Focusing intently on individual blades of grass, it almost looks like they're moving."
	},
/area/centcom/heretic_backdoor)
"QU" = (
/obj/effect/step_trigger/teleporter/offset{
	teleport_x_offset = -3;
	teleport_y_offset = 2
	},
/turf/open/floor/grass/norandomicon{
	desc = "Focusing intently on individual blades of grass, it almost looks like they're moving."
	},
/area/centcom/heretic_backdoor)
"Tn" = (
/obj/effect/step_trigger/teleporter/offset{
	teleport_y_offset = 3
	},
/turf/open/floor/grass/norandomicon{
	desc = "Focusing intently on individual blades of grass, it almost looks like they're moving."
	},
/area/centcom/heretic_backdoor)
"Uo" = (
/obj/effect/step_trigger/teleporter/offset{
	teleport_x_offset = 3;
	teleport_y_offset = 2
	},
/turf/open/floor/grass/norandomicon{
	desc = "Focusing intently on individual blades of grass, it almost looks like they're moving."
	},
/area/centcom/heretic_backdoor)
"UX" = (
/obj/structure/mineral_door/wood,
/obj/effect/turf_decal/siding/wood{
	dir = 8
	},
/obj/effect/turf_decal/siding/wood{
	dir = 4
	},
/turf/open/floor/stone,
/area/centcom/heretic_backdoor)
"WH" = (
/obj/effect/step_trigger/teleporter/offset{
	teleport_x_offset = 3;
	teleport_y_offset = 3
	},
/turf/open/floor/grass/norandomicon{
	desc = "Focusing intently on individual blades of grass, it almost looks like they're moving."
	},
/area/centcom/heretic_backdoor)
"XR" = (
/turf/open/floor/stone,
/area/centcom/heretic_backdoor)
"Yi" = (
/obj/effect/step_trigger/teleporter/offset{
	teleport_x_offset = -3;
	teleport_y_offset = 1
	},
/turf/open/floor/grass/norandomicon{
	desc = "Focusing intently on individual blades of grass, it almost looks like they're moving."
	},
/area/centcom/heretic_backdoor)
"YR" = (
/obj/effect/turf_decal/siding/wood{
	dir = 4
	},
/obj/structure/chair/sofa/left/brown{
	dir = 4
	},
/obj/effect/turf_decal/siding/wood{
	dir = 8
	},
/turf/open/floor/wood/large,
/area/centcom/heretic_backdoor)

(1,1,1) = {"
as
as
as
as
as
as
as
as
as
as
as
as
as
as
as
as
as
as
as
as
as
as
as
as
as
as
as
as
as
as
as
as
as
as
as
as
as
as
as
as
as
as
as
as
as
as
as
as
as
as
as
"}
(2,1,1) = {"
as
as
as
as
as
as
as
as
as
as
as
as
as
as
as
as
as
as
as
as
as
as
as
as
as
as
as
as
as
as
as
as
as
as
as
as
as
as
as
as
as
as
as
as
as
as
as
as
as
pS
as
"}
(3,1,1) = {"
as
as
as
as
as
as
as
as
as
as
as
as
as
as
as
as
as
as
as
as
as
as
as
as
as
as
as
as
as
as
as
as
as
as
as
as
as
as
as
as
as
as
as
as
as
as
as
as
as
as
as
"}
(4,1,1) = {"
as
as
as
as
as
as
as
as
as
as
as
as
as
as
as
as
as
as
as
as
as
as
as
as
as
as
as
as
as
as
as
as
as
as
as
as
as
as
as
as
as
as
as
as
as
as
as
as
as
as
as
"}
(5,1,1) = {"
as
as
as
as
as
as
as
as
as
as
as
as
as
as
as
as
as
as
as
as
as
as
as
as
as
as
as
as
as
as
as
as
as
as
as
as
as
as
as
as
as
as
as
as
as
as
as
as
as
as
as
"}
(6,1,1) = {"
as
as
as
as
as
as
as
as
as
as
as
as
as
as
as
as
as
as
as
as
as
as
as
as
as
as
as
as
as
as
as
as
as
as
as
as
as
as
as
as
as
as
as
as
as
as
as
as
as
as
as
"}
(7,1,1) = {"
as
as
as
as
as
as
as
as
as
as
as
as
as
as
as
as
as
as
as
as
as
as
as
as
as
as
as
as
as
as
as
as
as
as
as
as
as
as
as
as
as
as
as
as
as
as
as
as
as
as
as
"}
(8,1,1) = {"
as
as
as
as
as
as
as
as
as
as
as
as
as
as
as
as
as
as
as
as
as
as
as
as
as
as
as
as
as
as
as
as
as
as
as
as
as
as
as
as
as
as
as
as
as
as
as
as
as
as
as
"}
(9,1,1) = {"
as
as
as
as
as
as
as
as
as
as
as
as
as
as
as
as
as
as
as
as
as
as
as
as
as
as
as
as
as
as
as
as
as
as
as
as
as
as
as
as
as
as
as
as
as
as
as
as
as
as
as
"}
(10,1,1) = {"
as
as
as
as
as
as
as
as
as
as
as
as
as
as
as
as
as
as
as
as
as
as
as
as
as
as
as
as
as
as
as
as
as
as
as
as
as
as
as
as
as
as
as
as
as
as
as
as
as
as
as
"}
(11,1,1) = {"
as
as
as
as
as
as
as
as
as
as
as
as
as
as
as
as
as
as
as
as
as
as
as
as
as
as
as
as
as
as
as
as
as
as
as
as
as
as
as
as
as
as
as
as
as
as
as
as
as
as
as
"}
(12,1,1) = {"
as
as
as
as
as
as
as
as
as
as
as
as
as
as
as
as
as
as
as
as
as
as
as
as
as
as
as
as
as
as
as
as
as
as
as
as
as
as
as
as
as
as
as
as
as
as
as
as
as
as
as
"}
(13,1,1) = {"
as
as
as
as
as
as
as
as
oz
tY
lL
PY
PY
PY
PY
PY
PY
PY
PY
PY
PY
PY
PY
PY
PY
PY
PY
PY
PY
PY
PY
PY
PY
PY
PY
PY
PY
PY
PY
PY
Ny
Uo
WH
as
as
as
as
as
as
as
as
"}
(14,1,1) = {"
as
as
as
as
as
as
as
as
eo
as
nf
nf
nf
nf
nf
nf
nf
nf
nf
nf
nf
nf
nf
nf
nf
nf
nf
nf
nf
nf
nf
nf
nf
nf
nf
nf
nf
nf
nf
nf
nf
as
yL
as
as
as
as
as
as
as
as
"}
(15,1,1) = {"
as
as
as
as
as
as
as
as
iL
Qh
as
vY
vY
vY
vY
vY
vY
vY
vY
vY
vY
vY
vY
vY
vY
vY
vY
vY
vY
vY
vY
vY
vY
vY
vY
vY
vY
vY
vY
vY
as
Ng
pE
as
as
as
as
as
as
as
as
"}
(16,1,1) = {"
as
as
as
as
as
as
as
as
Gp
Qh
aD
as
as
as
as
as
as
as
as
as
as
as
as
as
as
as
as
as
as
as
as
as
as
as
as
as
as
as
as
as
xr
Ng
Tn
as
as
as
as
as
as
as
as
"}
(17,1,1) = {"
as
as
as
as
as
as
as
as
Gp
Qh
aD
as
as
as
as
as
as
as
as
as
as
as
as
as
as
as
as
as
as
as
as
as
as
as
as
as
as
as
as
as
xr
Ng
Tn
as
as
as
as
as
as
as
as
"}
(18,1,1) = {"
as
as
as
as
as
as
as
as
Gp
Qh
aD
as
as
as
as
as
as
as
as
as
as
as
as
as
as
as
as
as
as
as
as
as
as
as
as
as
as
as
as
as
xr
Ng
Tn
as
as
as
as
as
as
as
as
"}
(19,1,1) = {"
as
as
as
as
as
as
as
as
Gp
Qh
aD
as
as
as
as
as
as
as
as
as
as
as
as
as
as
as
as
as
as
as
as
as
as
as
as
as
as
as
as
as
xr
Ng
Tn
as
as
as
as
as
as
as
as
"}
(20,1,1) = {"
as
as
as
as
as
as
as
as
Gp
Qh
aD
as
as
as
as
as
as
as
as
as
as
as
as
as
as
as
as
as
as
as
as
as
as
as
as
as
as
as
as
as
xr
Ng
Tn
as
as
as
as
as
as
as
as
"}
(21,1,1) = {"
as
as
as
as
as
as
as
as
Gp
Qh
aD
as
as
as
as
as
as
as
as
as
as
as
as
as
as
as
as
as
as
as
as
as
as
as
as
as
as
as
as
as
xr
Ng
Tn
as
as
as
as
as
as
as
as
"}
(22,1,1) = {"
as
as
as
as
as
as
as
as
Gp
Qh
aD
as
as
as
as
as
as
as
as
as
as
as
as
as
as
as
as
as
as
as
as
as
as
as
as
as
as
as
as
as
xr
Ng
Tn
as
as
as
as
as
as
as
as
"}
(23,1,1) = {"
as
as
as
as
as
as
as
as
Gp
Qh
aD
as
as
as
as
as
as
as
as
as
as
as
as
as
as
as
as
as
as
as
as
as
as
as
as
as
as
as
as
as
xr
Ng
Tn
as
as
as
as
as
as
as
as
"}
(24,1,1) = {"
as
as
as
as
as
as
as
as
Gp
Qh
aD
as
as
as
as
as
as
as
as
as
as
as
as
as
as
as
as
as
as
as
as
as
as
as
as
as
as
as
as
as
xr
Ng
Tn
as
as
as
as
as
as
as
as
"}
(25,1,1) = {"
as
as
as
as
as
as
as
as
Gp
Qh
aD
as
as
as
as
as
as
as
as
as
as
as
as
as
as
as
as
as
as
as
as
as
as
as
as
as
as
as
as
as
xr
Ng
Tn
as
as
as
as
as
as
as
as
"}
(26,1,1) = {"
as
as
as
as
as
as
as
as
Gp
Qh
aD
as
as
as
as
as
as
as
as
as
as
as
as
as
as
as
as
as
as
as
as
as
as
as
as
as
as
as
as
as
xr
Ng
Tn
as
as
as
as
as
as
as
as
"}
(27,1,1) = {"
as
as
as
as
as
as
as
as
Gp
Qh
aD
as
as
as
as
as
as
as
as
as
as
as
Nx
va
Nx
UX
Nx
Nx
as
as
as
as
as
as
as
as
as
as
as
as
xr
Ng
Tn
as
as
as
as
as
as
as
as
"}
(28,1,1) = {"
as
as
as
as
as
as
as
as
Gp
Qh
aD
as
as
as
as
as
as
as
as
as
as
as
Nx
YR
jq
ql
ql
Nx
Nx
as
as
as
as
as
as
as
as
as
as
as
xr
Ng
Tn
as
as
as
as
as
as
as
as
"}
(29,1,1) = {"
as
as
as
as
as
as
as
as
Gp
Qh
aD
as
as
as
as
as
as
as
as
as
as
as
Nx
XR
KE
ql
ql
OC
oy
as
as
as
as
as
as
as
as
as
as
as
xr
Ng
Tn
as
as
as
as
as
as
as
as
"}
(30,1,1) = {"
as
as
as
as
as
as
as
as
Gp
Qh
aD
as
as
as
as
as
as
as
as
as
as
as
Nx
iG
Ak
ql
ql
gm
oy
as
as
as
as
as
as
as
as
as
as
as
xr
Ng
Tn
as
as
as
as
as
as
as
as
"}
(31,1,1) = {"
as
as
as
as
as
as
as
as
Gp
Qh
aD
as
as
as
as
as
as
as
as
as
as
as
Nx
XR
Ak
ql
ql
xD
oy
as
as
as
as
as
as
as
as
as
as
as
xr
Ng
Tn
as
as
as
as
as
as
as
as
"}
(32,1,1) = {"
as
as
as
as
as
as
as
as
Gp
Qh
aD
as
as
as
as
as
as
as
as
as
as
Nx
Nx
Nx
UX
Nx
FH
Nx
Nx
as
as
as
as
as
as
as
as
as
as
as
xr
Ng
Tn
as
as
as
as
as
as
as
as
"}
(33,1,1) = {"
as
as
as
as
as
as
as
as
Gp
Qh
aD
as
as
as
as
as
as
as
as
as
as
Nx
ei
ql
ql
Nx
va
Nx
as
as
as
as
as
as
as
as
as
as
as
as
xr
Ng
Tn
as
as
as
as
as
as
as
as
"}
(34,1,1) = {"
as
as
as
as
as
as
as
as
Gp
Qh
aD
as
as
as
as
as
as
as
as
as
as
Nx
PM
xA
ay
Nx
as
as
as
as
as
as
as
as
as
as
as
as
as
as
xr
Ng
Tn
as
as
as
as
as
as
as
as
"}
(35,1,1) = {"
as
as
as
as
as
as
as
as
Gp
Qh
aD
as
as
as
as
as
as
as
as
as
as
Nx
Nx
va
Nx
Nx
as
as
as
as
as
as
as
as
as
as
as
as
as
as
xr
Ng
Tn
as
as
as
as
as
as
as
as
"}
(36,1,1) = {"
as
as
as
as
as
as
as
as
Gp
Qh
aD
as
as
as
as
as
as
as
as
as
as
as
as
as
as
as
as
as
as
as
as
as
as
as
as
as
as
as
as
as
xr
Ng
Tn
as
as
as
as
as
as
as
as
"}
(37,1,1) = {"
as
as
as
as
as
as
as
as
Gp
Qh
aD
as
as
as
as
as
as
as
as
as
as
as
as
as
as
as
as
as
as
as
as
as
as
as
as
as
as
as
as
as
xr
Ng
Tn
as
as
as
as
as
as
as
as
"}
(38,1,1) = {"
as
as
as
as
as
as
as
as
Gp
Qh
aD
as
as
as
as
as
as
as
as
as
as
as
as
as
as
as
as
as
as
as
as
as
as
as
as
as
as
as
as
as
xr
Ng
Tn
as
as
as
as
as
as
as
as
"}
(39,1,1) = {"
as
as
as
as
as
as
as
as
Gp
Qh
aD
as
as
as
as
as
as
as
as
as
as
as
as
as
as
as
as
as
as
as
as
as
as
as
as
as
as
as
as
as
xr
Ng
Tn
as
as
as
as
as
as
as
as
"}
(40,1,1) = {"
as
as
as
as
as
as
as
as
Gp
Qh
aD
as
as
as
as
as
as
as
as
as
as
as
as
as
as
as
as
as
as
as
as
as
as
as
as
as
as
as
as
as
xr
Ng
Tn
as
as
as
as
as
as
as
as
"}
(41,1,1) = {"
as
as
as
as
as
as
as
as
Gp
Qh
aD
as
as
as
as
as
as
as
as
as
as
as
as
as
as
as
as
as
as
as
as
as
as
as
as
as
as
as
as
as
xr
Ng
Tn
as
as
as
as
as
as
as
as
"}
(42,1,1) = {"
as
as
as
as
as
as
as
as
Gp
Qh
aD
as
as
as
as
as
as
as
as
as
as
as
as
as
as
as
as
as
as
as
as
as
as
as
as
as
as
as
as
as
xr
Ng
Tn
as
as
as
as
as
as
as
as
"}
(43,1,1) = {"
as
as
as
as
as
as
as
as
Gp
Qh
aD
as
as
as
as
as
as
as
as
as
as
as
as
as
as
as
as
as
as
as
as
as
as
as
as
as
as
as
as
as
xr
Ng
Tn
as
as
as
as
as
as
as
as
"}
(44,1,1) = {"
as
as
as
as
as
as
as
as
Gp
Qh
aD
as
as
as
as
as
as
as
as
as
as
as
as
as
as
as
as
as
as
as
as
as
as
as
as
as
as
as
as
as
xr
Ng
Tn
as
as
as
as
as
as
as
as
"}
(45,1,1) = {"
as
as
as
as
as
as
as
as
xb
Qh
as
rv
rv
rv
rv
rv
rv
rv
rv
rv
rv
rv
rv
rv
rv
rv
rv
rv
rv
rv
rv
rv
rv
rv
rv
rv
rv
rv
rv
rv
as
Ng
Ah
as
as
as
as
as
as
as
as
"}
(46,1,1) = {"
as
as
as
as
as
as
as
as
Lu
as
fq
fq
fq
fq
fq
fq
fq
fq
fq
fq
fq
fq
fq
fq
fq
fq
fq
fq
fq
fq
fq
fq
fq
fq
fq
fq
fq
fq
fq
fq
fq
as
nc
as
as
as
as
as
as
as
as
"}
(47,1,1) = {"
as
as
as
as
as
as
as
as
Qm
qF
Fx
oH
oH
oH
oH
oH
oH
oH
oH
oH
oH
oH
oH
oH
oH
oH
oH
oH
oH
oH
oH
oH
oH
oH
oH
oH
oH
oH
oH
oH
Yi
QU
fW
as
as
as
as
as
as
as
as
"}
(48,1,1) = {"
as
as
as
as
as
as
as
as
as
as
as
as
as
as
as
as
as
as
as
as
as
as
as
as
as
as
as
as
as
as
as
as
as
as
as
as
as
as
as
as
as
as
as
as
as
as
as
as
as
as
as
"}
(49,1,1) = {"
as
as
as
as
as
as
as
as
as
as
as
as
as
as
as
as
as
as
as
as
as
as
as
as
as
as
as
as
as
as
as
as
as
as
as
as
as
as
as
as
as
as
as
as
as
as
as
as
as
as
as
"}
(50,1,1) = {"
as
as
as
as
as
as
as
as
as
as
as
as
as
as
as
as
as
as
as
as
as
as
as
as
as
as
as
as
as
as
as
as
as
as
as
as
as
as
as
as
as
as
as
as
as
as
as
as
as
as
as
"}
(51,1,1) = {"
as
as
as
as
as
as
as
as
as
as
as
as
as
as
as
as
as
as
as
as
as
as
as
as
as
as
as
as
as
as
as
as
as
as
as
as
as
as
as
as
as
as
as
as
as
as
as
as
as
as
as
"}
(52,1,1) = {"
as
as
as
as
as
as
as
as
as
as
as
as
as
as
as
as
as
as
as
as
as
as
as
as
as
as
as
as
as
as
as
as
as
as
as
as
as
as
as
as
as
as
as
as
as
as
as
as
as
as
as
"}
(53,1,1) = {"
as
as
as
as
as
as
as
as
as
as
as
as
as
as
as
as
as
as
as
as
as
as
as
as
as
as
as
as
as
as
as
as
as
as
as
as
as
as
as
as
as
as
as
as
as
as
as
as
as
as
as
"}
(54,1,1) = {"
as
as
as
as
as
as
as
as
as
as
as
as
as
as
as
as
as
as
as
as
as
as
as
as
as
as
as
as
as
as
as
as
as
as
as
as
as
as
as
as
as
as
as
as
as
as
as
as
as
as
as
"}
(55,1,1) = {"
as
as
as
as
as
as
as
as
as
as
as
as
as
as
as
as
as
as
as
as
as
as
as
as
as
as
as
as
as
as
as
as
as
as
as
as
as
as
as
as
as
as
as
as
as
as
as
as
as
as
as
"}
(56,1,1) = {"
as
as
as
as
as
as
as
as
as
as
as
as
as
as
as
as
as
as
as
as
as
as
as
as
as
as
as
as
as
as
as
as
as
as
as
as
as
as
as
as
as
as
as
as
as
as
as
as
as
as
as
"}
(57,1,1) = {"
as
as
as
as
as
as
as
as
as
as
as
as
as
as
as
as
as
as
as
as
as
as
as
as
as
as
as
as
as
as
as
as
as
as
as
as
as
as
as
as
as
as
as
as
as
as
as
as
as
as
as
"}
(58,1,1) = {"
as
as
as
as
as
as
as
as
as
as
as
as
as
as
as
as
as
as
as
as
as
as
as
as
as
as
as
as
as
as
as
as
as
as
as
as
as
as
as
as
as
as
as
as
as
as
as
as
as
as
as
"}
(59,1,1) = {"
as
as
as
as
as
as
as
as
as
as
as
as
as
as
as
as
as
as
as
as
as
as
as
as
as
as
as
as
as
as
as
as
as
as
as
as
as
as
as
as
as
as
as
as
as
as
as
as
as
as
as
"}
