//MAP CONVERTED BY dmm2tgm.py THIS HEADER COMMENT PREVENTS RECONVERSION, DO NOT REMOVE
"a" = (
/turf/closed/wall/mineral/titanium/survival/pod,
/area/survivalpod)
"b" = (
/obj/basic/effect/turf_decal/mining/survival{
	dir = 1
	},
/turf/closed/wall/mineral/titanium/survival/pod,
/area/survivalpod)
"c" = (
/obj/basic/machinery/shower,
/obj/basic/item/soap/deluxe,
/obj/basic/structure/curtain{
	alpha = 240;
	color = "#454545";
	icon_state = "bathroom-closed";
	open = 0
	},
/turf/open/floor/pod,
/area/survivalpod)
"d" = (
/obj/basic/effect/turf_decal/mining/survival{
	dir = 8
	},
/turf/closed/wall/mineral/titanium/survival/pod,
/area/survivalpod)
"e" = (
/obj/basic/structure/fans,
/turf/open/floor/pod,
/area/survivalpod)
"f" = (
/obj/basic/machinery/smartfridge/survival_pod/preloaded,
/turf/open/floor/pod,
/area/survivalpod)
"g" = (
/obj/basic/item/gps/computer,
/turf/open/floor/pod,
/area/survivalpod)
"i" = (
/obj/basic/structure/toilet/secret{
	secret_type = /obj/basic/item/kitchen/knife/combat/survival
	},
/turf/open/floor/pod,
/area/survivalpod)
"j" = (
/obj/basic/effect/turf_decal/mining/survival{
	dir = 4
	},
/turf/closed/wall/mineral/titanium/survival/pod,
/area/survivalpod)
"k" = (
/obj/basic/machinery/stasis/survival_pod,
/turf/open/floor/pod,
/area/survivalpod)
"l" = (
/turf/open/floor/pod,
/area/survivalpod)
"m" = (
/obj/basic/structure/bed/pod,
/obj/basic/item/bedsheet/black,
/turf/open/floor/pod,
/area/survivalpod)
"n" = (
/obj/basic/structure/window/reinforced/survival_pod{
	dir = 8;
	layer = 3
	},
/obj/basic/machinery/door/window/survival_pod{
	dir = 1
	},
/turf/open/floor/carpet/black,
/area/survivalpod)
"o" = (
/obj/basic/structure/chair/comfy/black,
/obj/basic/item/cardboard_cutout{
	desc = "A cardboard cutout of a xenomorph maid.";
	icon_state = "cutout_lusty";
	name = "lusty xenomorph maid"
	},
/obj/basic/structure/window/reinforced/survival_pod{
	dir = 1
	},
/turf/open/floor/carpet/black,
/area/survivalpod)
"p" = (
/obj/basic/structure/table/survival_pod,
/obj/basic/item/storage/firstaid/regular,
/obj/basic/item/storage/firstaid/brute{
	pixel_x = 5
	},
/turf/open/floor/pod,
/area/survivalpod)
"q" = (
/obj/basic/structure/tubes,
/obj/basic/item/kirbyplants/random,
/turf/open/floor/pod,
/area/survivalpod)
"r" = (
/obj/basic/structure/window/reinforced/survival_pod{
	dir = 8
	},
/turf/open/floor/carpet/black,
/area/survivalpod)
"s" = (
/obj/basic/machinery/light/directional/east,
/obj/basic/structure/table/wood/fancy/black,
/obj/basic/item/reagent_containers/food/drinks/drinkingglass{
	pixel_x = 7;
	pixel_y = 2
	},
/obj/basic/item/reagent_containers/food/drinks/bottle/wine{
	pixel_x = -6;
	pixel_y = 10
	},
/turf/open/floor/carpet/black,
/area/survivalpod)
"t" = (
/obj/basic/machinery/microwave{
	pixel_y = -2
	},
/obj/basic/structure/window/reinforced/survival_pod{
	dir = 1
	},
/obj/basic/structure/table/wood/fancy/black{
	pixel_y = -9
	},
/turf/open/floor/carpet/black,
/area/survivalpod)
"u" = (
/obj/basic/machinery/door/window/survival_pod{
	dir = 1
	},
/turf/open/floor/carpet/black,
/area/survivalpod)
"v" = (
/obj/basic/structure/window/reinforced/survival_pod{
	dir = 1
	},
/obj/basic/structure/displaycase{
	alert = 0;
	desc = "A display case containing an expensive forgery, probably.";
	pixel_y = -4;
	req_access_txt = "48";
	start_showpiece_type = /obj/basic/item/fakeartefact
	},
/turf/open/floor/carpet/black,
/area/survivalpod)
"w" = (
/obj/basic/structure/window/reinforced/survival_pod{
	density = 0;
	dir = 9
	},
/turf/open/floor/carpet/black,
/area/survivalpod)
"x" = (
/obj/basic/structure/table/wood/fancy/black,
/obj/basic/item/reagent_containers/food/drinks/drinkingglass{
	pixel_x = 7;
	pixel_y = 2
	},
/obj/basic/effect/spawner/lootdrop/three_course_meal,
/turf/open/floor/carpet/black,
/area/survivalpod)
"y" = (
/obj/basic/structure/sink/kitchen{
	dir = 4;
	pixel_x = -13
	},
/turf/open/floor/carpet/black,
/area/survivalpod)
"z" = (
/obj/basic/machinery/light/directional/south,
/turf/open/floor/carpet/black,
/area/survivalpod)
"A" = (
/turf/open/floor/carpet/black,
/area/survivalpod)
"B" = (
/obj/basic/structure/chair/comfy/black{
	dir = 1
	},
/turf/open/floor/carpet/black,
/area/survivalpod)
"C" = (
/obj/basic/effect/turf_decal/mining/survival,
/turf/closed/wall/mineral/titanium/survival/pod,
/area/survivalpod)
"D" = (
/obj/basic/structure/fans/tiny,
/obj/basic/machinery/door/airlock/survival_pod/glass,
/turf/open/floor/pod,
/area/survivalpod)
"E" = (
/obj/basic/effect/turf_decal/mining,
/turf/closed/wall/mineral/titanium/survival/pod,
/area/survivalpod)

(1,1,1) = {"
a
d
a
d
a
d
a
"}
(2,1,1) = {"
b
e
k
p
t
y
C
"}
(3,1,1) = {"
a
f
l
l
u
z
a
"}
(4,1,1) = {"
b
g
m
q
v
A
D
"}
(5,1,1) = {"
a
c
n
r
w
A
a
"}
(6,1,1) = {"
b
i
o
s
x
B
E
"}
(7,1,1) = {"
a
j
a
j
a
j
a
"}
