//MAP CONVERTED BY dmm2tgm.py THIS HEADER COMMENT PREVENTS RECONVERSION, DO NOT REMOVE
"a" = (
/turf/closed/wall/mineral/titanium/survival/pod,
/area/misc/survivalpod)
"c" = (
/obj/machinery/shower/directional/south,
/obj/item/soap/deluxe,
/obj/structure/curtain{
	alpha = 240;
	color = "#454545";
	icon_state = "bathroom-closed";
	open = 0
	},
/turf/open/floor/pod,
/area/misc/survivalpod)
"d" = (
/obj/effect/turf_decal/mining/survival,
/turf/closed/wall/mineral/titanium/survival/pod,
/area/misc/survivalpod)
"e" = (
/obj/structure/fans,
/turf/open/floor/pod,
/area/misc/survivalpod)
"f" = (
/obj/machinery/smartfridge/survival_pod/preloaded,
/turf/open/floor/pod,
/area/misc/survivalpod)
"g" = (
/obj/item/gps/computer,
/turf/open/floor/pod,
/area/misc/survivalpod)
"i" = (
/obj/structure/toilet/secret{
	secret_type = /obj/item/knife/combat/survival
	},
/turf/open/floor/pod,
/area/misc/survivalpod)
"k" = (
/obj/machinery/stasis/survival_pod,
/turf/open/floor/pod,
/area/misc/survivalpod)
"l" = (
/turf/open/floor/pod,
/area/misc/survivalpod)
"m" = (
/obj/structure/bed/pod,
/obj/item/bedsheet/black,
/turf/open/floor/pod,
/area/misc/survivalpod)
"n" = (
/obj/structure/window/reinforced/survival_pod/spawner/directional/west,
/obj/machinery/door/window/survival_pod/left/directional/north,
/turf/open/floor/carpet/black,
/area/misc/survivalpod)
"o" = (
/obj/structure/chair/comfy/black,
/obj/item/cardboard_cutout{
	starting_cutout = "Xenomorph Maid"
	},
/obj/structure/window/reinforced/survival_pod/spawner/directional/north,
/turf/open/floor/carpet/black,
/area/misc/survivalpod)
"p" = (
/obj/structure/table/survival_pod,
/obj/item/storage/medkit/regular,
/obj/item/storage/medkit/brute{
	pixel_x = 5
	},
/turf/open/floor/pod,
/area/misc/survivalpod)
"q" = (
/obj/structure/tubes,
/obj/item/kirbyplants/random,
/turf/open/floor/pod,
/area/misc/survivalpod)
"r" = (
/obj/structure/window/reinforced/survival_pod/spawner/directional/west,
/turf/open/floor/carpet/black,
/area/misc/survivalpod)
"s" = (
/obj/machinery/light/directional/east,
/obj/structure/table/wood/fancy/black,
/obj/item/reagent_containers/cup/glass/drinkingglass{
	pixel_x = 7;
	pixel_y = 2
	},
/obj/item/reagent_containers/cup/glass/bottle/wine{
	pixel_x = -6;
	pixel_y = 10
	},
/turf/open/floor/carpet/black,
/area/misc/survivalpod)
"t" = (
/obj/machinery/microwave{
	pixel_y = -2
	},
/obj/structure/window/reinforced/survival_pod/spawner/directional/north,
/obj/structure/table/wood/fancy/black{
	pixel_y = -9
	},
/turf/open/floor/carpet/black,
/area/misc/survivalpod)
"u" = (
/obj/machinery/door/window/survival_pod/left/directional/north,
/turf/open/floor/carpet/black,
/area/misc/survivalpod)
"v" = (
/obj/structure/window/reinforced/survival_pod/spawner/directional/north,
/obj/structure/displaycase{
	alert = 0;
	desc = "A display case containing an expensive forgery, probably.";
	pixel_y = -4;
	req_access = list("mining");
	start_showpiece_type = /obj/item/fakeartefact
	},
/turf/open/floor/carpet/black,
/area/misc/survivalpod)
"x" = (
/obj/structure/table/wood/fancy/black,
/obj/item/reagent_containers/cup/glass/drinkingglass{
	pixel_x = 7;
	pixel_y = 2
	},
/obj/effect/spawner/random/food_or_drink/three_course_meal,
/turf/open/floor/carpet/black,
/area/misc/survivalpod)
"y" = (
/obj/structure/sink/kitchen/directional/east,
/turf/open/floor/carpet/black,
/area/misc/survivalpod)
"z" = (
/obj/machinery/light/directional/south,
/turf/open/floor/carpet/black,
/area/misc/survivalpod)
"A" = (
/turf/open/floor/carpet/black,
/area/misc/survivalpod)
"B" = (
/obj/structure/chair/comfy/black{
	dir = 1
	},
/turf/open/floor/carpet/black,
/area/misc/survivalpod)
"D" = (
/obj/structure/fans/tiny,
/obj/machinery/door/airlock/survival_pod/glass,
/turf/open/floor/pod,
/area/misc/survivalpod)
"H" = (
/obj/effect/turf_decal/mining/survival{
	dir = 1
	},
/turf/closed/wall/mineral/titanium/survival/pod,
/area/misc/survivalpod)
"I" = (
/obj/structure/window/reinforced/survival_pod{
	density = 0;
	dir = 9
	},
/turf/open/floor/carpet/black,
/area/misc/survivalpod)
"K" = (
/obj/effect/turf_decal/mining/survival{
	dir = 8
	},
/turf/closed/wall/mineral/titanium/survival/pod,
/area/misc/survivalpod)
"R" = (
/obj/effect/turf_decal/mining/survival{
	dir = 4
	},
/turf/closed/wall/mineral/titanium/survival/pod,
/area/misc/survivalpod)
"W" = (
/obj/effect/turf_decal/mining,
/turf/closed/wall/mineral/titanium/survival/pod,
/area/misc/survivalpod)

(1,1,1) = {"
a
K
a
K
a
K
a
"}
(2,1,1) = {"
H
e
k
p
t
y
d
"}
(3,1,1) = {"
a
f
l
l
u
z
a
"}
(4,1,1) = {"
H
g
m
q
v
A
D
"}
(5,1,1) = {"
a
c
n
r
I
A
a
"}
(6,1,1) = {"
H
i
o
s
x
B
W
"}
(7,1,1) = {"
a
R
a
R
a
R
a
"}
