"a" = (/turf/closed/wall/mineral/titanium/survival/pod,/area/survivalpod)
"b" = (/obj/structure/sign/mining/survival{tag = "icon-survival (NORTH)"; icon_state = "survival"; dir = 1},/turf/closed/wall/mineral/titanium/survival/pod,/area/survivalpod)
"c" = (/turf/closed/wall/mineral/titanium/survival,/area/survivalpod)
"d" = (/obj/structure/sign/mining/survival{dir = 8},/turf/closed/wall/mineral/titanium/survival/pod,/area/survivalpod)
"e" = (/obj/structure/fans,/turf/open/floor/pod,/area/survivalpod)
"f" = (/obj/machinery/smartfridge/survival_pod,/turf/open/floor/pod,/area/survivalpod)
"g" = (/obj/item/device/gps/computer,/turf/open/floor/pod,/area/survivalpod)
"h" = (/obj/machinery/shower,/obj/structure/curtain,/obj/machinery/door/window/southright,/obj/item/weapon/soap/deluxe,/turf/open/floor/pod,/area/survivalpod)
"i" = (/obj/structure/window/reinforced/tinted/frosted,/obj/structure/toilet{icon_state = "toilet00"},/obj/machinery/light/small{tag = "icon-bulb1 (EAST)"; icon_state = "bulb1"; dir = 4; pixel_y = 10},/turf/open/floor/pod,/area/survivalpod)
"j" = (/obj/structure/sign/mining/survival{tag = "icon-survival (EAST)"; icon_state = "survival"; dir = 4},/turf/closed/wall/mineral/titanium/survival/pod,/area/survivalpod)
"k" = (/obj/machinery/sleeper/survival_pod,/turf/open/floor/pod,/area/survivalpod)
"l" = (/turf/open/floor/pod,/area/survivalpod)
"m" = (/obj/structure/window/reinforced{tag = "icon-rwindow (EAST)"; icon_state = "rwindow"; dir = 4},/turf/open/floor/pod,/area/survivalpod)
"n" = (/turf/open/floor/carpet,/area/survivalpod)
"o" = (/obj/structure/sink{tag = "icon-sink (EAST)"; icon_state = "sink"; dir = 4; pixel_x = 12},/turf/open/floor/carpet,/area/survivalpod)
"p" = (/obj/structure/table/survival_pod,/obj/structure/window/reinforced,/obj/item/weapon/storage/firstaid/regular,/obj/item/weapon/storage/firstaid/brute{pixel_x = 5},/turf/open/floor/pod,/area/survivalpod)
"q" = (/obj/machinery/door/window,/turf/open/floor/pod,/area/survivalpod)
"r" = (/obj/structure/window/reinforced{dir = 4},/obj/structure/window/reinforced,/turf/open/floor/pod,/area/survivalpod)
"s" = (/obj/structure/chair/wood/wings{tag = "icon-wooden_chair_wings (EAST)"; icon_state = "wooden_chair_wings"; dir = 4},/turf/open/floor/carpet,/area/survivalpod)
"t" = (/obj/structure/table/wood/fancy,/obj/effect/spawner/lootdrop/three_course_meal,/obj/machinery/light{dir = 4},/turf/open/floor/carpet,/area/survivalpod)
"u" = (/obj/structure/table/wood,/obj/machinery/microwave{pixel_x = -1; pixel_y = 3},/turf/open/floor/carpet,/area/survivalpod)
"v" = (/obj/item/cardboard_cutout{desc = "A cardboard cutout of a xenomorph maid."; icon_state = "cutout_lusty"; name = "lusty xenomorph maid"},/turf/open/floor/carpet,/area/survivalpod)
"w" = (/obj/structure/table/wood/fancy,/obj/item/candle{pixel_x = 9; pixel_y = 5},/obj/item/weapon/reagent_containers/food/drinks/bottle/absinthe/premium{pixel_x = -6; pixel_y = 7},/obj/item/weapon/reagent_containers/food/drinks/drinkingglass{pixel_x = 3; pixel_y = 3},/turf/open/floor/carpet,/area/survivalpod)
"x" = (/obj/structure/table/wood,/obj/structure/reagent_dispensers/beerkeg{anchored = 1},/obj/machinery/light{icon_state = "tube1"; dir = 8},/turf/open/floor/carpet,/area/survivalpod)
"y" = (/obj/item/weapon/twohanded/required/kirbyplants/random,/turf/open/floor/carpet,/area/survivalpod)
"z" = (/obj/structure/bed/pod,/obj/item/weapon/bedsheet/black,/turf/open/floor/carpet,/area/survivalpod)
"A" = (/obj/structure/sign/mining/survival,/turf/closed/wall/mineral/titanium/survival/pod,/area/survivalpod)
"B" = (/obj/structure/fans/tiny,/obj/machinery/door/airlock/survival_pod,/turf/open/floor/pod,/area/survivalpod)
"C" = (/obj/structure/sign/mining,/turf/closed/wall/mineral/titanium/survival/pod,/area/survivalpod)

(1,1,1) = {"
abcbcba
defghij
cklmnoc
dpqrstj
cunvnwc
dxynnzj
aAcBcCa
"}
