//MAP CONVERTED BY dmm2tgm.py THIS HEADER COMMENT PREVENTS RECONVERSION, DO NOT REMOVE
"a" = (
/turf/template_noop,
/area/template_noop)
"f" = (
/obj/structure/transit_tube/curved,
/turf/open/floor/plating,
/area/station/maintenance/department/science/xenobiology)
"h" = (
/turf/open/misc/asteroid/airless,
/area/station/asteroid)
"l" = (
/obj/structure/transit_tube/diagonal/crossing,
/turf/open/floor/plating,
/area/station/maintenance/department/science/xenobiology)
"m" = (
/obj/effect/spawner/structure/window/reinforced/tinted,
/obj/structure/transit_tube/curved{
	dir = 1
	},
/obj/effect/mapping_error,
/turf/open/floor/plating,
/area/station/maintenance/department/science/xenobiology)
"n" = (
/obj/effect/turf_decal/sand/plating,
/turf/open/floor/plating/airless,
/area/station/asteroid)
"q" = (
/obj/modular_map_connector,
/turf/open/floor/plating,
/area/station/maintenance/department/science/xenobiology)
"t" = (
/obj/machinery/atmospherics/pipe/smart/manifold4w/scrubbers/hidden/layer2,
/turf/open/floor/plating,
/area/station/maintenance/department/science/xenobiology)
"u" = (
/turf/open/floor/plating,
/area/station/maintenance/department/science/xenobiology)
"A" = (
/obj/machinery/door/airlock/maintenance,
/obj/effect/mapping_helpers/airlock/access/any/science/maintenance,
/obj/effect/mapping_error,
/turf/open/floor/plating,
/area/station/maintenance/department/science/xenobiology)
"B" = (
/obj/structure/window/reinforced/tinted/fulltile,
/obj/structure/transit_tube,
/obj/effect/mapping_error,
/turf/open/floor/plating,
/area/station/science/lobby)
"K" = (
/turf/closed/mineral/random/stationside/asteroid/porus,
/area/station/asteroid)
"M" = (
/obj/effect/mapping_helpers/airlock/access/any/science/maintenance,
/obj/machinery/door/airlock/maintenance_hatch,
/obj/machinery/atmospherics/pipe/smart/manifold4w/scrubbers/hidden/layer2,
/obj/effect/mapping_error,
/obj/structure/cable,
/obj/machinery/atmospherics/pipe/smart/manifold4w/supply/hidden/layer4,
/turf/open/floor/plating,
/area/station/science/research)
"P" = (
/obj/structure/transit_tube,
/turf/open/floor/plating,
/area/station/maintenance/department/science/xenobiology)
"V" = (
/obj/machinery/door/airlock/maintenance,
/obj/machinery/atmospherics/pipe/smart/manifold4w/scrubbers/hidden/layer2,
/obj/effect/mapping_helpers/airlock/access/all/science/genetics,
/obj/effect/mapping_error,
/turf/open/floor/plating,
/area/station/science/genetics)
"W" = (
/turf/closed/wall,
/area/station/maintenance/department/science/xenobiology)

(1,1,1) = {"
a
a
a
a
a
a
a
a
a
a
a
a
a
a
a
K
a
a
a
a
a
a
a
a
a
"}
(2,1,1) = {"
a
a
a
a
a
a
a
a
a
a
a
a
a
a
K
K
a
a
a
a
a
a
a
a
a
"}
(3,1,1) = {"
a
a
a
a
a
a
a
a
a
a
a
a
a
h
K
K
W
u
a
a
a
a
a
a
a
"}
(4,1,1) = {"
a
a
a
a
a
a
a
a
a
a
a
a
h
h
K
W
W
u
u
a
a
a
a
A
a
"}
(5,1,1) = {"
a
a
a
a
a
a
a
a
a
a
a
h
h
K
W
W
u
u
u
u
u
u
u
q
a
"}
(6,1,1) = {"
a
a
a
a
a
a
a
a
a
a
a
h
K
K
W
u
u
f
P
P
P
P
P
P
B
"}
(7,1,1) = {"
a
a
a
a
a
a
a
a
a
a
h
h
K
W
W
u
l
a
a
a
a
a
a
a
a
"}
(8,1,1) = {"
a
a
a
a
a
a
a
a
a
a
n
K
K
W
u
l
u
a
a
a
a
a
a
a
a
"}
(9,1,1) = {"
a
a
a
a
a
a
a
a
a
a
n
n
K
W
l
u
u
a
a
a
a
a
a
a
a
"}
(10,1,1) = {"
a
a
a
a
a
a
a
a
a
a
a
a
a
m
u
u
u
a
a
a
a
a
a
a
a
"}
(11,1,1) = {"
a
a
a
a
a
a
a
a
a
n
n
n
K
W
u
u
u
a
a
a
a
a
a
a
a
"}
(12,1,1) = {"
a
a
a
a
a
a
a
a
a
n
K
K
W
W
u
u
u
a
a
a
a
a
a
a
a
"}
(13,1,1) = {"
a
a
a
a
a
a
a
a
a
h
K
K
W
u
u
u
u
a
a
a
a
a
a
a
a
"}
(14,1,1) = {"
a
a
a
a
a
a
a
a
a
h
h
K
W
u
u
u
u
a
a
a
a
a
a
a
a
"}
(15,1,1) = {"
a
a
a
a
a
a
a
a
a
h
h
K
W
u
u
u
u
a
a
a
a
a
a
a
a
"}
(16,1,1) = {"
a
a
a
a
a
a
a
a
a
h
h
K
W
u
u
u
u
a
a
a
a
a
a
a
a
"}
(17,1,1) = {"
a
a
a
a
a
a
a
a
a
h
h
K
W
u
u
u
u
a
a
a
a
a
a
a
a
"}
(18,1,1) = {"
a
a
a
a
a
a
a
a
a
h
h
K
W
u
u
u
u
a
a
a
a
a
a
a
a
"}
(19,1,1) = {"
a
a
a
a
a
a
a
a
a
h
h
K
W
u
u
u
u
a
a
a
a
a
a
a
a
"}
(20,1,1) = {"
a
a
a
a
a
a
a
a
a
h
h
K
W
u
u
u
t
V
a
a
a
a
a
a
a
"}
(21,1,1) = {"
a
a
a
a
a
a
a
a
a
h
h
K
W
u
u
u
t
a
a
a
a
a
a
a
a
"}
(22,1,1) = {"
a
a
a
a
a
a
a
a
a
h
K
K
W
W
u
u
t
a
a
a
a
a
a
a
a
"}
(23,1,1) = {"
a
a
a
a
a
a
a
a
a
h
K
K
K
W
u
u
t
a
a
a
a
a
a
a
a
"}
(24,1,1) = {"
a
a
a
a
a
a
a
a
a
h
K
K
K
W
u
u
t
a
a
a
a
a
a
a
a
"}
(25,1,1) = {"
a
a
a
a
a
a
a
a
a
h
K
K
K
W
u
u
t
a
a
a
a
a
a
a
a
"}
(26,1,1) = {"
a
a
a
a
a
a
a
a
h
K
K
K
K
W
u
u
t
a
a
a
a
a
a
a
a
"}
(27,1,1) = {"
a
a
a
a
a
a
a
a
h
K
K
K
K
W
u
u
t
a
a
a
a
a
a
a
a
"}
(28,1,1) = {"
a
a
a
a
a
a
a
a
h
K
K
K
W
W
u
u
t
a
a
a
a
a
a
a
a
"}
(29,1,1) = {"
a
a
a
a
a
a
a
h
h
K
K
K
W
u
u
u
t
u
u
a
a
a
a
a
a
"}
(30,1,1) = {"
a
a
a
a
a
a
a
h
h
K
K
W
W
u
u
u
t
t
t
M
a
a
a
a
a
"}
(31,1,1) = {"
a
a
a
a
a
a
a
h
K
K
W
W
u
u
u
u
u
u
u
a
a
a
a
a
a
"}
(32,1,1) = {"
a
a
a
a
a
a
h
K
K
W
W
u
u
u
u
u
u
u
u
a
a
a
a
a
a
"}
(33,1,1) = {"
a
a
a
a
a
a
h
K
K
W
u
u
u
u
u
u
u
u
u
a
a
a
a
a
a
"}
(34,1,1) = {"
a
a
a
a
a
a
K
K
W
W
u
u
u
u
u
u
u
u
u
a
a
a
a
a
a
"}
(35,1,1) = {"
a
a
a
a
a
a
K
W
W
u
u
u
u
u
u
u
u
u
u
a
a
a
a
a
a
"}
(36,1,1) = {"
a
a
a
a
a
h
K
W
u
u
u
u
u
u
u
u
u
u
a
a
a
a
a
a
a
"}
(37,1,1) = {"
a
a
a
a
a
h
K
W
u
u
a
a
a
a
a
a
a
a
a
a
a
a
a
a
a
"}
(38,1,1) = {"
a
a
a
a
a
h
K
W
u
u
a
a
a
a
a
a
a
a
a
a
a
a
a
a
a
"}
(39,1,1) = {"
a
a
a
a
a
h
K
W
u
u
a
a
a
a
a
a
a
a
a
a
a
a
a
a
a
"}
(40,1,1) = {"
a
a
a
a
a
h
K
W
u
u
a
a
a
a
a
a
a
a
a
a
a
a
a
a
a
"}
(41,1,1) = {"
a
a
a
a
a
h
K
W
u
u
a
a
a
a
a
a
a
a
a
a
a
a
a
a
a
"}
(42,1,1) = {"
a
a
a
a
a
h
K
W
u
u
a
a
a
a
a
a
a
a
a
a
a
a
a
a
a
"}
(43,1,1) = {"
a
a
a
a
a
h
K
W
u
u
a
a
a
a
a
a
a
a
a
a
a
a
a
a
a
"}
(44,1,1) = {"
a
a
a
a
a
K
K
W
u
u
u
u
a
a
a
a
a
a
a
a
a
a
a
a
a
"}
(45,1,1) = {"
a
a
a
a
a
K
K
W
u
u
u
u
a
a
a
a
a
a
a
a
a
a
a
a
a
"}
(46,1,1) = {"
a
a
a
a
a
K
W
W
u
u
u
u
a
a
a
a
a
a
a
a
a
a
a
a
a
"}
(47,1,1) = {"
a
a
a
a
h
K
W
u
u
u
u
u
a
a
a
a
a
a
a
a
a
a
a
a
a
"}
(48,1,1) = {"
a
a
a
a
h
K
W
u
u
u
u
u
a
a
a
a
a
a
a
a
a
a
a
a
a
"}
(49,1,1) = {"
a
a
a
h
K
K
W
u
u
u
u
u
a
a
a
a
a
a
a
a
a
a
a
a
a
"}
(50,1,1) = {"
a
a
a
h
K
K
W
u
u
u
u
u
a
a
a
a
a
a
a
a
a
a
a
a
a
"}
(51,1,1) = {"
a
a
h
h
K
K
W
u
u
u
u
u
a
a
a
a
a
a
a
a
a
a
a
a
a
"}
(52,1,1) = {"
a
h
h
K
K
K
W
u
u
u
u
u
a
a
a
a
a
a
a
a
a
a
a
a
a
"}
(53,1,1) = {"
h
h
K
K
K
K
W
u
u
u
u
u
a
a
a
a
a
a
a
a
a
a
a
a
a
"}
(54,1,1) = {"
h
K
K
K
K
K
W
u
u
u
u
u
a
a
a
a
a
a
a
a
a
a
a
a
a
"}
(55,1,1) = {"
a
h
h
K
K
K
W
u
u
u
u
u
a
a
a
a
a
a
a
a
a
a
a
a
a
"}
(56,1,1) = {"
a
h
h
K
K
K
W
u
u
u
u
u
a
a
a
a
a
a
a
a
a
a
a
a
a
"}
(57,1,1) = {"
a
h
h
K
K
K
W
u
u
u
u
u
a
a
a
a
a
a
a
a
a
a
a
a
a
"}
(58,1,1) = {"
a
a
h
h
K
K
W
u
u
u
u
u
a
a
a
a
a
a
a
a
a
a
a
a
a
"}
(59,1,1) = {"
a
a
a
a
h
K
W
u
u
u
u
u
a
a
a
a
a
a
a
a
a
a
a
a
a
"}
(60,1,1) = {"
a
a
a
a
a
K
W
u
u
u
u
u
u
a
a
a
a
a
a
a
a
a
a
a
a
"}
(61,1,1) = {"
a
a
a
a
a
K
W
u
u
u
u
u
u
a
a
a
a
a
a
a
a
a
a
a
a
"}
(62,1,1) = {"
a
a
a
a
a
K
W
W
u
u
u
u
u
a
a
a
a
a
a
a
a
a
a
a
a
"}
(63,1,1) = {"
a
a
a
a
a
K
K
W
u
u
u
u
u
a
a
a
a
a
a
a
a
a
a
a
a
"}
(64,1,1) = {"
a
a
a
a
a
a
K
W
u
u
u
u
u
u
u
u
u
a
a
a
a
a
a
a
a
"}
(65,1,1) = {"
a
a
a
a
a
K
K
W
u
u
u
u
u
u
u
a
a
a
a
a
a
a
a
a
a
"}
(66,1,1) = {"
a
a
a
a
h
K
K
W
W
u
u
u
u
u
u
a
a
a
a
a
a
a
a
a
a
"}
(67,1,1) = {"
a
a
a
h
K
K
K
K
W
W
W
u
u
u
u
a
a
a
a
a
a
a
a
a
a
"}
(68,1,1) = {"
a
a
h
h
K
K
K
K
K
K
W
W
u
u
u
a
a
a
a
a
a
a
a
a
a
"}
(69,1,1) = {"
h
h
h
K
K
K
K
K
K
K
K
W
W
W
W
a
a
a
a
a
a
a
a
a
a
"}
(70,1,1) = {"
h
h
h
h
h
K
K
K
K
K
K
K
K
K
K
K
K
K
a
a
a
a
a
a
a
"}
(71,1,1) = {"
a
h
h
a
a
a
h
K
K
K
K
K
h
h
h
K
K
K
a
a
a
a
a
a
a
"}
(72,1,1) = {"
a
a
a
a
a
a
a
a
h
h
h
a
a
a
a
h
h
K
a
a
a
a
a
a
a
"}
(73,1,1) = {"
a
a
a
a
a
a
a
a
a
a
a
a
a
a
a
a
a
h
a
a
a
a
a
a
a
"}
