//MAP CONVERTED BY dmm2tgm.py THIS HEADER COMMENT PREVENTS RECONVERSION, DO NOT REMOVE
"a" = (
/turf/template_noop,
/area/template_noop)
"c" = (
/obj/machinery/atmospherics/pipe/smart/manifold4w/scrubbers/hidden/layer2,
/obj/machinery/atmospherics/pipe/smart/manifold4w/supply/hidden/layer4,
/obj/structure/cable,
/obj/modular_map_connector,
/turf/open/floor/plating,
/area/station/maintenance/department/science/central)
"d" = (
/obj/machinery/door/poddoor/preopen{
	id = "testlab";
	name = "Test Chamber Blast Door"
	},
/obj/effect/spawner/structure/window/reinforced,
/obj/structure/disposalpipe/segment{
	dir = 4
	},
/obj/effect/mapping_error,
/turf/open/floor/plating,
/area/station/maintenance/department/science/central)
"g" = (
/turf/open/floor/plating,
/area/station/maintenance/department/science/central)
"n" = (
/obj/structure/disposalpipe/junction{
	dir = 4
	},
/turf/open/floor/plating,
/area/station/maintenance/department/science/central)
"t" = (
/turf/closed/wall/r_wall,
/area/station/science/xenobiology)
"u" = (
/obj/machinery/atmospherics/pipe/smart/manifold4w/scrubbers/hidden/layer2,
/obj/machinery/atmospherics/pipe/smart/manifold4w/supply/hidden/layer4,
/obj/structure/cable,
/turf/open/floor/plating,
/area/station/maintenance/department/science/central)
"y" = (
/turf/open/misc/asteroid/airless,
/area/station/asteroid)
"B" = (
/obj/machinery/atmospherics/pipe/smart/manifold4w/scrubbers/hidden/layer2,
/obj/machinery/atmospherics/pipe/smart/manifold4w/supply/hidden/layer4,
/obj/structure/cable,
/obj/machinery/door/airlock/maintenance_hatch,
/obj/effect/mapping_helpers/airlock/access/any/science/maintenance,
/obj/effect/mapping_error,
/turf/open/floor/plating,
/area/station/science/research)
"C" = (
/obj/structure/disposalpipe/segment{
	dir = 5
	},
/turf/open/floor/plating,
/area/station/maintenance/department/science/central)
"D" = (
/obj/structure/disposalpipe/segment{
	dir = 4
	},
/turf/closed/wall/r_wall,
/area/station/science/explab)
"L" = (
/obj/structure/disposalpipe/segment,
/turf/closed/wall/r_wall,
/area/station/science/xenobiology)
"O" = (
/turf/template_noop,
/area/station/maintenance/department/science/central)
"P" = (
/obj/effect/mapping_helpers/airlock/access/all/science/ordnance_storage,
/obj/machinery/door/airlock/research,
/obj/effect/mapping_error,
/turf/open/floor/plating,
/area/station/maintenance/department/science/central)
"Q" = (
/obj/structure/disposalpipe/segment{
	dir = 4
	},
/turf/open/floor/plating,
/area/station/maintenance/department/science/central)
"R" = (
/turf/closed/wall/r_wall,
/area/station/maintenance/department/science/central)
"T" = (
/obj/effect/turf_decal/sand/plating,
/turf/open/floor/plating/airless,
/area/station/asteroid)
"U" = (
/turf/closed/mineral/random/stationside/asteroid/porus,
/area/station/asteroid)
"W" = (
/obj/structure/disposalpipe/segment,
/turf/open/floor/plating,
/area/station/maintenance/department/science/central)
"Y" = (
/obj/structure/disposalpipe/segment{
	dir = 9
	},
/turf/open/floor/plating,
/area/station/maintenance/department/science/central)

(1,1,1) = {"
a
a
a
a
a
a
a
a
a
a
a
a
a
a
a
a
a
a
a
a
a
a
a
a
"}
(2,1,1) = {"
a
a
a
a
a
g
g
g
g
O
a
a
a
a
a
a
a
a
a
a
a
a
a
a
"}
(3,1,1) = {"
B
c
u
u
u
u
u
u
u
u
u
u
u
u
B
a
a
a
a
a
a
a
a
a
"}
(4,1,1) = {"
a
g
g
g
g
g
g
g
g
g
g
g
g
g
a
a
a
a
a
a
a
a
a
a
"}
(5,1,1) = {"
a
g
g
g
g
a
a
a
a
a
a
a
a
a
a
a
a
a
a
a
a
a
a
a
"}
(6,1,1) = {"
a
g
g
g
g
a
a
a
a
a
a
a
a
a
a
a
a
a
a
a
a
a
a
a
"}
(7,1,1) = {"
a
g
g
g
g
a
a
a
a
a
a
a
a
a
a
a
a
a
a
a
a
a
a
a
"}
(8,1,1) = {"
a
g
g
g
g
a
a
a
a
a
a
a
a
a
a
a
a
a
a
a
a
a
a
a
"}
(9,1,1) = {"
a
a
g
g
g
a
a
a
a
a
a
a
a
a
a
a
a
a
a
a
a
a
a
a
"}
(10,1,1) = {"
a
a
a
g
g
a
a
a
a
a
a
a
a
a
a
a
a
a
a
a
a
a
a
a
"}
(11,1,1) = {"
a
a
a
g
g
a
a
a
a
a
a
a
a
a
a
a
a
a
a
a
a
a
a
a
"}
(12,1,1) = {"
a
a
a
g
g
a
a
a
a
a
a
a
a
a
a
a
a
a
a
a
a
a
a
a
"}
(13,1,1) = {"
a
a
a
g
g
a
a
a
a
a
a
a
a
a
a
a
a
a
a
a
a
a
a
a
"}
(14,1,1) = {"
a
a
L
W
W
W
W
W
W
W
C
a
a
a
a
a
a
a
a
a
a
a
a
a
"}
(15,1,1) = {"
a
a
a
a
g
g
g
g
g
g
Q
a
a
a
a
a
a
a
a
a
a
a
a
a
"}
(16,1,1) = {"
a
a
a
a
a
a
a
a
g
g
Q
a
a
a
a
a
a
a
a
a
a
a
a
a
"}
(17,1,1) = {"
a
a
a
a
a
a
a
a
g
g
Q
a
a
a
a
a
a
a
a
a
a
a
a
a
"}
(18,1,1) = {"
a
a
a
a
a
a
a
a
g
g
Q
a
a
a
a
a
a
a
a
a
a
a
a
a
"}
(19,1,1) = {"
a
a
a
a
a
a
a
a
g
g
Q
a
a
D
a
a
a
a
a
a
a
a
a
a
"}
(20,1,1) = {"
a
a
a
a
a
a
a
a
g
g
n
W
W
Y
g
a
a
a
a
a
a
a
a
a
"}
(21,1,1) = {"
a
a
a
a
a
a
a
a
g
g
Q
g
g
g
g
P
a
a
a
a
a
a
a
a
"}
(22,1,1) = {"
a
a
a
a
a
a
a
a
g
g
Q
g
g
g
g
a
a
a
a
a
a
a
a
a
"}
(23,1,1) = {"
a
a
a
a
a
a
a
a
g
g
Q
g
g
g
g
g
a
a
a
a
a
a
a
a
"}
(24,1,1) = {"
a
a
a
a
a
a
a
a
g
g
Q
g
g
a
a
a
a
a
a
a
a
a
a
a
"}
(25,1,1) = {"
a
a
a
a
a
a
a
a
g
g
Q
g
g
a
a
a
a
a
a
a
a
a
a
a
"}
(26,1,1) = {"
a
a
a
a
a
a
a
a
g
g
Q
g
g
a
a
a
a
a
a
a
a
a
a
a
"}
(27,1,1) = {"
a
a
a
a
a
a
a
a
g
g
Q
g
g
a
a
a
a
a
a
a
a
a
a
a
"}
(28,1,1) = {"
a
a
a
a
a
a
a
a
g
g
Q
g
g
a
a
a
a
a
a
a
a
a
a
a
"}
(29,1,1) = {"
a
a
a
a
a
a
a
a
g
g
Q
g
g
a
a
a
a
a
a
a
a
a
a
a
"}
(30,1,1) = {"
a
a
a
a
a
a
a
a
g
g
Q
g
g
a
a
a
a
a
a
a
a
a
a
a
"}
(31,1,1) = {"
a
a
a
a
a
a
a
a
g
g
Q
g
g
a
a
a
a
a
a
a
a
a
a
a
"}
(32,1,1) = {"
a
a
a
a
a
a
a
a
g
g
Q
g
g
a
a
a
a
a
a
a
a
a
a
a
"}
(33,1,1) = {"
a
a
a
a
a
a
a
g
g
g
Q
g
g
a
a
a
a
a
a
a
a
a
a
a
"}
(34,1,1) = {"
a
a
a
a
a
a
a
g
g
g
Q
g
g
a
a
a
a
a
a
a
a
a
a
a
"}
(35,1,1) = {"
a
a
a
a
a
a
a
R
R
R
d
R
R
a
a
a
a
a
a
a
a
a
a
a
"}
(36,1,1) = {"
a
a
a
a
a
a
a
R
U
T
a
T
U
a
a
a
a
a
a
a
a
a
a
a
"}
(37,1,1) = {"
a
a
a
U
U
U
t
U
y
T
a
T
y
U
U
U
U
U
a
a
a
a
a
a
"}
(38,1,1) = {"
a
a
a
a
a
t
U
y
y
a
a
a
y
y
U
U
U
U
a
a
a
a
a
a
"}
(39,1,1) = {"
a
a
a
a
a
U
U
y
a
a
a
a
a
y
y
U
U
U
a
a
a
a
a
a
"}
(40,1,1) = {"
a
a
a
a
a
U
U
y
a
a
a
a
a
a
y
y
U
U
a
a
a
a
a
a
"}
(41,1,1) = {"
a
a
a
a
a
U
U
y
a
a
a
a
a
a
y
y
U
U
U
U
U
U
U
U
"}
(42,1,1) = {"
a
a
a
a
a
U
U
y
a
a
a
a
a
a
a
y
y
U
U
U
U
U
y
y
"}
(43,1,1) = {"
a
a
U
U
U
U
y
y
a
a
a
a
a
a
a
y
y
y
y
U
y
y
y
a
"}
(44,1,1) = {"
a
a
U
U
y
y
y
a
a
a
a
a
a
a
a
a
a
y
y
y
y
y
a
a
"}
(45,1,1) = {"
a
a
U
y
a
a
a
a
a
a
a
a
a
a
a
a
a
a
a
a
a
a
a
a
"}
(46,1,1) = {"
a
a
U
a
a
a
a
a
a
a
a
a
a
a
a
a
a
a
a
a
a
a
a
a
"}
