//MAP CONVERTED BY dmm2tgm.py THIS HEADER COMMENT PREVENTS RECONVERSION, DO NOT REMOVE
"a" = (
/turf/closed/mineral/random/stationside/asteroid/porus,
/area/station/asteroid)
"b" = (
/obj/machinery/atmospherics/pipe/smart/manifold4w/scrubbers/hidden/layer2,
/obj/machinery/atmospherics/pipe/smart/manifold4w/supply/hidden/layer4,
/obj/structure/cable,
/obj/structure/disposalpipe/segment{
	dir = 4
	},
/turf/open/floor/plating,
/area/station/maintenance/department/science/west)
"c" = (
/obj/machinery/atmospherics/pipe/smart/manifold4w/scrubbers/hidden/layer2,
/obj/machinery/atmospherics/pipe/smart/manifold4w/supply/hidden/layer4,
/obj/structure/cable,
/obj/machinery/door/airlock/maintenance,
/obj/effect/mapping_helpers/airlock/access/any/science/maintenance,
/obj/structure/disposalpipe/segment{
	dir = 4
	},
/obj/effect/mapping_error,
/turf/open/floor/plating,
/area/station/science/research)
"d" = (
/turf/open/misc/asteroid/airless,
/area/station/asteroid)
"e" = (
/obj/structure/window/reinforced/tinted/fulltile,
/obj/structure/transit_tube/horizontal,
/obj/effect/mapping_error,
/turf/open/floor/plating,
/area/station/maintenance/department/science/west)
"f" = (
/obj/effect/turf_decal/sand/plating,
/turf/open/floor/plating/airless,
/area/station/asteroid)
"g" = (
/obj/structure/disposalpipe/segment{
	dir = 6
	},
/obj/structure/cable,
/obj/machinery/atmospherics/pipe/smart/manifold4w/supply/hidden/layer4,
/obj/machinery/atmospherics/pipe/smart/manifold4w/scrubbers/hidden/layer2,
/turf/open/floor/plating,
/area/station/maintenance/department/science/west)
"h" = (
/obj/effect/mapping_helpers/airlock/access/any/science/maintenance,
/obj/machinery/door/airlock/maintenance,
/obj/effect/mapping_error,
/turf/open/floor/plating,
/area/station/science/research)
"j" = (
/obj/structure/disposalpipe/segment{
	dir = 10
	},
/obj/structure/cable,
/obj/machinery/atmospherics/pipe/smart/manifold4w/supply/hidden/layer4,
/obj/machinery/atmospherics/pipe/smart/manifold4w/scrubbers/hidden/layer2,
/turf/open/floor/plating,
/area/station/maintenance/department/science/west)
"k" = (
/obj/structure/disposalpipe/segment{
	dir = 4
	},
/obj/structure/transit_tube/diagonal/crossing,
/obj/structure/cable,
/obj/machinery/atmospherics/pipe/smart/manifold4w/supply/hidden/layer4,
/obj/machinery/atmospherics/pipe/smart/manifold4w/scrubbers/hidden/layer2,
/turf/open/floor/plating,
/area/station/maintenance/department/science/west)
"l" = (
/obj/machinery/atmospherics/pipe/smart/manifold4w/scrubbers/hidden/layer2,
/obj/machinery/atmospherics/pipe/smart/manifold4w/supply/hidden/layer4,
/obj/structure/cable,
/obj/structure/disposalpipe/segment{
	dir = 10
	},
/turf/open/floor/plating,
/area/station/maintenance/department/science/west)
"m" = (
/obj/machinery/atmospherics/pipe/smart/manifold4w/scrubbers/hidden/layer2,
/obj/machinery/atmospherics/pipe/smart/manifold4w/supply/hidden/layer4,
/obj/structure/cable,
/obj/machinery/door/airlock/maintenance_hatch,
/obj/effect/mapping_helpers/airlock/access/any/science/maintenance,
/obj/effect/mapping_error,
/turf/open/floor/plating,
/area/station/science/research)
"n" = (
/obj/effect/spawner/structure/window/reinforced/tinted,
/obj/structure/transit_tube/horizontal,
/obj/effect/mapping_error,
/turf/open/floor/plating,
/area/station/maintenance/department/science/west)
"p" = (
/obj/structure/disposalpipe/segment{
	dir = 5
	},
/turf/open/floor/plating,
/area/station/maintenance/department/science/west)
"q" = (
/obj/structure/cable,
/obj/machinery/atmospherics/pipe/smart/manifold4w/supply/hidden/layer4,
/obj/machinery/atmospherics/pipe/smart/manifold4w/scrubbers/hidden/layer2,
/obj/structure/disposalpipe/segment{
	dir = 4
	},
/turf/open/floor/plating,
/area/station/maintenance/department/science/west)
"r" = (
/obj/structure/transit_tube/crossing/horizontal,
/obj/machinery/atmospherics/pipe/smart/manifold4w/scrubbers/hidden/layer2,
/obj/structure/cable,
/obj/machinery/atmospherics/pipe/smart/manifold4w/supply/hidden/layer4,
/obj/structure/disposalpipe/segment,
/turf/open/floor/plating,
/area/station/maintenance/department/science/west)
"s" = (
/obj/structure/disposalpipe/segment,
/turf/open/floor/plating,
/area/station/maintenance/department/science/west)
"v" = (
/turf/closed/wall,
/area/station/maintenance/department/science/west)
"z" = (
/obj/machinery/door/airlock/maintenance,
/obj/effect/mapping_helpers/airlock/access/any/science/maintenance,
/obj/structure/disposalpipe/segment{
	dir = 8
	},
/obj/structure/cable,
/obj/machinery/atmospherics/pipe/smart/manifold4w/supply/hidden/layer4,
/obj/machinery/atmospherics/pipe/smart/manifold4w/scrubbers/hidden/layer2,
/obj/effect/mapping_error,
/turf/open/floor/plating,
/area/station/maintenance/department/science/west)
"A" = (
/obj/structure/disposalpipe/segment{
	dir = 10
	},
/obj/machinery/atmospherics/pipe/smart/manifold4w/scrubbers/hidden/layer2,
/obj/structure/cable,
/obj/machinery/atmospherics/pipe/smart/manifold4w/supply/hidden/layer4,
/turf/open/floor/plating,
/area/station/maintenance/department/science/west)
"B" = (
/obj/machinery/atmospherics/pipe/smart/manifold4w/scrubbers/hidden/layer2,
/obj/machinery/atmospherics/pipe/smart/manifold4w/supply/hidden/layer4,
/obj/structure/cable,
/obj/structure/disposalpipe/segment{
	dir = 9
	},
/turf/open/floor/plating,
/area/station/maintenance/department/science/west)
"C" = (
/obj/structure/transit_tube/diagonal/crossing,
/turf/open/floor/plating,
/area/station/maintenance/department/science/west)
"D" = (
/turf/template_noop,
/area/template_noop)
"G" = (
/obj/structure/window/reinforced/tinted/fulltile,
/obj/structure/transit_tube/curved{
	dir = 1
	},
/obj/effect/mapping_error,
/turf/open/floor/plating,
/area/station/maintenance/department/science/west)
"J" = (
/obj/machinery/atmospherics/pipe/smart/manifold4w/scrubbers/hidden/layer2,
/obj/machinery/atmospherics/pipe/smart/manifold4w/supply/hidden/layer4,
/obj/structure/cable,
/obj/structure/disposalpipe/segment{
	dir = 5
	},
/turf/open/floor/plating,
/area/station/maintenance/department/science/west)
"K" = (
/obj/machinery/atmospherics/pipe/smart/manifold4w/scrubbers/hidden/layer2,
/obj/machinery/atmospherics/pipe/smart/manifold4w/supply/hidden/layer4,
/obj/structure/cable,
/turf/open/floor/plating,
/area/station/maintenance/department/science/west)
"L" = (
/obj/structure/disposalpipe/segment,
/obj/structure/cable,
/obj/machinery/atmospherics/pipe/smart/manifold4w/supply/hidden/layer4,
/obj/machinery/atmospherics/pipe/smart/manifold4w/scrubbers/hidden/layer2,
/turf/open/floor/plating,
/area/station/maintenance/department/science/west)
"M" = (
/obj/machinery/atmospherics/pipe/smart/manifold4w/scrubbers/hidden/layer2,
/obj/machinery/atmospherics/pipe/smart/manifold4w/supply/hidden/layer4,
/obj/structure/cable,
/obj/structure/disposalpipe/segment,
/turf/open/floor/plating,
/area/station/maintenance/department/science/west)
"N" = (
/obj/effect/spawner/structure/window/reinforced/tinted,
/obj/structure/transit_tube/diagonal,
/obj/effect/mapping_error,
/turf/open/floor/plating,
/area/station/maintenance/department/science/west)
"O" = (
/obj/structure/disposalpipe/segment{
	dir = 4
	},
/obj/structure/cable,
/obj/machinery/atmospherics/pipe/smart/manifold4w/supply/hidden/layer4,
/obj/machinery/atmospherics/pipe/smart/manifold4w/scrubbers/hidden/layer2,
/turf/open/floor/plating,
/area/station/maintenance/department/science/west)
"Q" = (
/obj/structure/transit_tube/crossing/horizontal,
/turf/open/floor/plating,
/area/station/maintenance/department/science/west)
"S" = (
/obj/modular_map_connector,
/obj/structure/disposalpipe/segment{
	dir = 4
	},
/obj/machinery/atmospherics/pipe/smart/manifold4w/scrubbers/hidden/layer2,
/obj/structure/cable,
/obj/machinery/atmospherics/pipe/smart/manifold4w/supply/hidden/layer4,
/turf/open/floor/plating,
/area/station/maintenance/department/science/west)
"T" = (
/obj/structure/cable,
/obj/machinery/atmospherics/pipe/smart/manifold4w/supply/hidden/layer4,
/obj/machinery/atmospherics/pipe/smart/manifold4w/scrubbers/hidden/layer2,
/turf/open/floor/plating,
/area/station/maintenance/department/science/west)
"U" = (
/obj/structure/disposalpipe/segment{
	dir = 5
	},
/obj/machinery/atmospherics/pipe/smart/manifold4w/scrubbers/hidden/layer2,
/obj/structure/cable,
/obj/machinery/atmospherics/pipe/smart/manifold4w/supply/hidden/layer4,
/turf/open/floor/plating,
/area/station/maintenance/department/science/west)
"V" = (
/obj/machinery/door/airlock/maintenance,
/obj/effect/mapping_helpers/airlock/access/any/science/maintenance,
/obj/structure/cable,
/obj/machinery/atmospherics/pipe/smart/manifold4w/supply/hidden/layer4,
/obj/machinery/atmospherics/pipe/smart/manifold4w/scrubbers/hidden/layer2,
/obj/effect/mapping_error,
/turf/open/floor/plating,
/area/station/science/walkway)
"W" = (
/obj/structure/disposalpipe/segment{
	dir = 5
	},
/obj/structure/cable,
/obj/machinery/atmospherics/pipe/smart/manifold4w/supply/hidden/layer4,
/obj/machinery/atmospherics/pipe/smart/manifold4w/scrubbers/hidden/layer2,
/turf/open/floor/plating,
/area/station/maintenance/department/science/west)
"X" = (
/turf/open/floor/plating,
/area/station/maintenance/department/science/west)

(1,1,1) = {"
D
D
D
D
D
D
D
D
D
D
D
D
D
D
D
D
D
D
D
D
D
D
D
D
D
D
D
D
D
D
D
D
D
D
D
D
D
D
D
D
D
D
D
D
D
D
"}
(2,1,1) = {"
D
D
z
D
D
D
D
D
D
D
D
D
D
D
D
D
D
D
D
D
D
D
D
D
D
D
D
D
D
D
D
D
D
D
D
D
D
D
D
d
d
d
D
D
D
D
"}
(3,1,1) = {"
D
X
S
X
D
D
D
D
D
D
D
D
D
D
D
D
D
D
D
D
D
D
D
D
D
D
D
D
D
D
D
D
D
D
D
d
d
d
d
d
d
d
d
d
d
D
"}
(4,1,1) = {"
D
X
A
U
D
D
D
D
D
D
D
D
D
D
D
D
D
D
D
D
D
D
D
D
D
D
D
D
d
d
d
d
d
d
a
a
a
a
a
d
d
d
d
d
d
D
"}
(5,1,1) = {"
D
D
X
O
X
D
D
D
D
D
D
D
D
D
D
D
D
D
D
D
d
d
d
d
a
a
d
d
d
a
a
a
a
a
a
a
a
a
a
a
d
d
d
d
d
d
"}
(6,1,1) = {"
D
D
D
j
L
W
D
D
D
D
D
D
f
D
D
D
D
D
D
d
d
d
d
a
a
a
a
a
a
a
a
a
a
a
a
a
a
a
a
a
a
d
d
d
d
d
"}
(7,1,1) = {"
D
D
D
D
X
O
N
D
D
D
f
f
f
D
D
f
f
a
a
a
a
a
a
a
a
v
v
v
v
v
v
v
v
a
a
a
a
a
a
a
a
a
d
d
d
d
"}
(8,1,1) = {"
D
D
D
D
X
k
v
v
a
D
D
f
f
D
f
f
a
a
a
v
v
v
v
v
X
X
X
X
X
X
X
X
v
v
a
a
a
a
a
a
a
a
a
d
d
d
"}
(9,1,1) = {"
D
D
D
D
C
O
X
v
v
a
D
f
a
D
f
a
v
v
v
v
X
X
X
X
X
X
X
X
X
X
X
X
X
v
v
a
a
a
a
a
a
a
a
d
d
d
"}
(10,1,1) = {"
D
D
D
G
X
O
X
X
v
v
D
v
v
n
v
v
v
X
X
X
X
X
X
X
X
X
X
X
X
X
X
X
X
X
v
v
v
v
v
v
a
a
a
d
d
d
"}
(11,1,1) = {"
D
D
D
D
D
j
L
s
p
v
n
v
X
Q
g
M
M
M
M
M
M
M
M
J
X
X
X
X
X
X
X
X
X
X
X
X
X
X
X
v
a
a
a
d
d
D
"}
(12,1,1) = {"
D
D
D
D
D
X
T
T
q
X
Q
X
X
Q
O
D
D
D
D
D
D
D
X
l
M
M
J
X
X
X
X
X
X
X
X
X
X
X
X
v
a
a
a
d
d
D
"}
(13,1,1) = {"
D
D
D
D
D
D
V
D
l
M
r
M
M
r
B
D
D
D
D
D
D
D
D
D
D
D
b
X
X
X
X
X
X
X
X
X
X
X
v
a
a
a
d
D
D
D
"}
(14,1,1) = {"
D
D
D
D
D
D
D
D
D
D
e
D
D
e
D
D
D
D
D
D
D
D
D
D
D
D
b
X
X
X
X
X
X
X
X
X
X
X
v
a
a
a
d
D
D
D
"}
(15,1,1) = {"
D
D
D
D
D
D
D
D
D
D
D
D
D
D
D
D
D
D
D
D
D
D
D
D
D
D
b
X
X
X
X
X
X
X
X
X
X
X
v
v
a
a
d
D
D
D
"}
(16,1,1) = {"
D
D
D
D
D
D
D
D
D
D
D
D
D
D
D
D
D
D
D
D
D
D
D
D
D
D
b
K
K
K
K
K
K
K
K
K
K
X
X
v
a
a
a
d
D
D
"}
(17,1,1) = {"
D
D
D
D
D
D
D
D
D
D
D
D
D
D
D
D
D
D
D
D
D
D
D
D
D
D
b
D
D
D
D
D
D
h
D
D
K
X
X
v
a
a
d
d
D
D
"}
(18,1,1) = {"
D
D
D
D
D
D
D
D
D
D
D
D
D
D
D
D
D
D
D
D
D
D
D
D
D
D
b
D
D
D
D
D
D
D
D
D
K
X
X
D
D
D
D
D
D
D
"}
(19,1,1) = {"
D
D
D
D
D
D
D
D
D
D
D
D
D
D
D
D
D
D
D
D
D
D
D
D
D
D
b
D
D
D
D
D
D
D
D
D
K
X
X
D
D
D
D
D
D
D
"}
(20,1,1) = {"
D
D
D
D
D
D
D
D
D
D
D
D
D
D
D
D
D
D
D
D
D
D
D
D
D
D
b
D
D
D
D
D
D
D
D
D
K
X
X
D
D
D
D
D
D
D
"}
(21,1,1) = {"
D
D
D
D
D
D
D
D
D
D
D
D
D
D
D
D
D
D
D
D
D
D
D
D
D
D
b
D
D
D
D
D
D
D
D
D
K
K
X
D
D
D
D
D
D
D
"}
(22,1,1) = {"
D
D
D
D
D
D
D
D
D
D
D
D
D
D
D
D
D
D
D
D
D
D
D
D
D
D
c
D
D
D
D
D
D
D
D
D
D
m
D
D
D
D
D
D
D
D
"}
