"aa" = (/obj/effect/turf_decal/stripes/line{dir = 1},/turf/open/floor/plasteel,/area/prophunt/mg2/november)
"ab" = (/obj/effect/turf_decal/stripes/line{dir = 1},/obj/machinery/atmospherics/pipe/simple/scrubbers/visible{dir = 4},/turf/open/floor/engine,/area/prophunt/mg2/november)
"ac" = (/obj/effect/turf_decal/stripes/line,/obj/machinery/light,/obj/machinery/atmospherics/pipe/simple/cyan/visible{dir = 4},/turf/open/floor/engine,/area/prophunt/mg2/november)
"ad" = (/obj/effect/turf_decal/stripes/line{dir = 1},/obj/machinery/light{dir = 1},/obj/machinery/atmospherics/pipe/simple/scrubbers/visible{dir = 4},/turf/open/floor/engine,/area/prophunt/mg2/november)
"ae" = (/obj/effect/turf_decal/stripes/line,/obj/machinery/meter,/obj/machinery/light,/obj/machinery/atmospherics/pipe/simple/cyan/visible{dir = 4},/turf/open/floor/engine,/area/prophunt/mg2/november)
"af" = (/obj/effect/turf_decal/stripes/line{dir = 1},/obj/item/radio/intercom{pixel_y = 21},/obj/machinery/atmospherics/pipe/simple/scrubbers/visible{dir = 4},/turf/open/floor/engine,/area/prophunt/mg2/november)
"ag" = (/obj/effect/turf_decal/stripes/line{dir = 5},/obj/machinery/meter,/obj/machinery/atmospherics/pipe/simple/scrubbers/visible{dir = 10},/turf/open/floor/engine,/area/prophunt/mg2/november)
"ah" = (/obj/effect/turf_decal/stripes/corner,/obj/machinery/atmospherics/pipe/simple/cyan/visible{dir = 6},/turf/open/floor/engine,/area/prophunt/mg2/november)
"ai" = (/obj/effect/turf_decal/stripes/line,/obj/machinery/atmospherics/pipe/simple/cyan/visible{dir = 4},/turf/open/floor/engine,/area/prophunt/mg2/november)
"aj" = (/obj/machinery/button/door{id = "engsm"; name = "Radiation Shutters Control"; pixel_x = 24; req_access_txt = "0"},/obj/effect/turf_decal/stripes/line{dir = 4},/obj/machinery/atmospherics/pipe/manifold/cyan/visible{dir = 8},/turf/open/floor/engine,/area/prophunt/mg2/november)
"ak" = (/obj/machinery/atmospherics/pipe/simple/scrubbers/visible{dir = 6},/obj/effect/turf_decal/stripes/line{dir = 5},/turf/open/floor/plasteel,/area/prophunt/mg2/november)
"al" = (/obj/effect/turf_decal/stripes/line{dir = 8},/turf/open/floor/plasteel,/area/prophunt/mg2/november)
"am" = (/obj/effect/turf_decal/stripes/corner{dir = 8},/obj/machinery/atmospherics/pipe/simple/cyan/visible{dir = 10},/turf/open/floor/engine,/area/prophunt/mg2/november)
"an" = (/obj/effect/turf_decal/stripes/line{dir = 4},/obj/machinery/atmospherics/pipe/manifold/cyan/visible{dir = 8},/turf/open/floor/engine,/area/prophunt/mg2/november)
"ao" = (/obj/effect/turf_decal/stripes/line{dir = 8},/obj/machinery/atmospherics/pipe/manifold/cyan/visible{dir = 8},/turf/open/floor/engine,/area/prophunt/mg2/november)
"ap" = (/obj/effect/turf_decal/delivery,/obj/machinery/atmospherics/components/binary/pump{dir = 8; name = "External Gas to Loop"},/turf/open/floor/plasteel/dark,/area/prophunt/mg2/november)
"aq" = (/obj/effect/turf_decal/bot{dir = 1},/obj/machinery/atmospherics/components/unary/portables_connector/visible{dir = 8},/obj/machinery/portable_atmospherics/canister/nitrogen{filled = 0},/turf/open/floor/plasteel/dark,/area/prophunt/mg2/november)
"ar" = (/obj/machinery/status_display/evac,/turf/closed/wall/r_wall,/area/prophunt/mg2/november)
"as" = (/obj/machinery/door/poddoor/shutters/preopen{id = "engsm"; name = "Radiation Chamber Shutters"},/turf/open/floor/plating,/area/prophunt/mg2/november)
"at" = (/obj/effect/turf_decal/stripes/line{dir = 4},/obj/machinery/meter,/obj/machinery/atmospherics/pipe/manifold/cyan/visible{dir = 8},/turf/open/floor/engine,/area/prophunt/mg2/november)
"au" = (/obj/effect/turf_decal/stripes/line{dir = 8},/obj/machinery/atmospherics/pipe/simple/cyan/visible,/turf/open/floor/engine,/area/prophunt/mg2/november)
"av" = (/obj/effect/turf_decal/stripes/line{dir = 4},/obj/machinery/atmospherics/components/trinary/filter/flipped/critical,/turf/open/floor/engine,/area/prophunt/mg2/november)
"aw" = (/obj/effect/turf_decal/stripes/line{dir = 4},/obj/machinery/atmospherics/pipe/simple/cyan/visible,/turf/open/floor/engine,/area/prophunt/mg2/november)
"ax" = (/obj/machinery/atmospherics/pipe/manifold/general/visible{dir = 1},/obj/machinery/power/rad_collector/anchored,/obj/structure/window/plasma/reinforced,/turf/open/floor/engine,/area/prophunt/mg2/november)
"ay" = (/obj/effect/turf_decal/stripes/line{dir = 4},/obj/machinery/atmospherics/pipe/simple/scrubbers/visible,/turf/open/floor/engine,/area/prophunt/mg2/november)
"az" = (/obj/machinery/atmospherics/pipe/simple/general/visible{dir = 10},/obj/machinery/power/rad_collector/anchored,/obj/structure/window/plasma/reinforced,/turf/open/floor/engine,/area/prophunt/mg2/november)
"aA" = (/obj/machinery/atmospherics/pipe/simple/general/visible{dir = 6},/turf/closed/wall/r_wall,/area/prophunt/mg2/november)
"aB" = (/obj/effect/turf_decal/stripes/line{dir = 10},/turf/open/floor/plasteel,/area/prophunt/mg2/november)
"aC" = (/obj/effect/turf_decal/stripes/line{dir = 10},/obj/machinery/camera{c_tag = "Engineering Supermatter Starboard"; dir = 4; network = list("ss13","engine")},/obj/machinery/atmospherics/pipe/simple/cyan/visible,/turf/open/floor/engine,/area/prophunt/mg2/november)
"aD" = (/turf/closed/wall/r_wall,/area/prophunt/mg2/november)
"aE" = (/obj/effect/spawner/structure/window/plasma/reinforced,/turf/open/floor/plating,/area/prophunt/mg2/november)
"aF" = (/obj/effect/turf_decal/stripes/line{dir = 4},/obj/machinery/light{dir = 4},/obj/machinery/atmospherics/components/trinary/filter/flipped/critical,/turf/open/floor/engine,/area/prophunt/mg2/november)
"aG" = (/obj/machinery/atmospherics/components/binary/pump/on{name = "Engine Coolant Bypass"},/obj/effect/turf_decal/stripes/line{dir = 4},/turf/open/floor/engine,/area/prophunt/mg2/november)
"aH" = (/obj/machinery/atmospherics/pipe/simple/cyan/visible{dir = 4},/turf/closed/wall/r_wall,/area/prophunt/mg2/november)
"aI" = (/obj/machinery/atmospherics/components/binary/pump{dir = 4; name = "Gas to Chamber"},/turf/open/floor/engine,/area/prophunt/mg2/november)
"aJ" = (/obj/machinery/atmospherics/pipe/simple/general/visible{dir = 9},/obj/machinery/meter,/turf/closed/wall/r_wall,/area/prophunt/mg2/november)
"aK" = (/turf/open/floor/engine,/area/prophunt/mg2/november)
"aL" = (/obj/machinery/atmospherics/components/unary/vent_pump/on{dir = 1},/turf/open/floor/engine,/area/prophunt/mg2/november)
"aM" = (/obj/structure/sign/warning/fire,/turf/closed/wall/r_wall,/area/prophunt/mg2/november)
"aN" = (/obj/effect/turf_decal/delivery,/obj/machinery/atmospherics/pipe/simple/cyan/visible,/turf/open/floor/plasteel/dark,/area/prophunt/mg2/november)
"aO" = (/obj/effect/turf_decal/stripes/line{dir = 6},/obj/machinery/atmospherics/pipe/simple/scrubbers/visible,/turf/open/floor/engine,/area/prophunt/mg2/november)
"aP" = (/obj/machinery/atmospherics/components/unary/outlet_injector/on{dir = 4},/obj/structure/window/plasma/reinforced{dir = 4},/obj/structure/window/plasma/reinforced{dir = 8},/obj/structure/window/plasma/reinforced{dir = 1},/turf/open/floor/plasteel,/area/prophunt/mg2/november)
"aQ" = (/obj/machinery/door/airlock/engineering/glass/critical{heat_proof = 1; name = "Supermatter Chamber"; req_access_txt = "0"},/obj/effect/mapping_helpers/airlock/cyclelink_helper{dir = 4},/turf/open/floor/engine,/area/prophunt/mg2/november)
"aR" = (/obj/machinery/atmospherics/pipe/simple/scrubbers/visible,/obj/effect/turf_decal/stripes/line{dir = 4},/turf/open/floor/plasteel,/area/prophunt/mg2/november)
"aS" = (/obj/effect/turf_decal/stripes/line{dir = 9},/obj/machinery/atmospherics/pipe/manifold/cyan/visible{dir = 8},/turf/open/floor/engine,/area/prophunt/mg2/november)
"aT" = (/obj/effect/turf_decal/delivery,/obj/machinery/atmospherics/pipe/simple/scrubbers/visible,/turf/open/floor/plasteel/dark,/area/prophunt/mg2/november)
"aU" = (/obj/effect/turf_decal/stripes/line{dir = 4},/obj/machinery/light{dir = 4},/obj/machinery/atmospherics/pipe/simple/green/visible,/turf/open/floor/engine,/area/prophunt/mg2/november)
"aV" = (/obj/machinery/atmospherics/pipe/manifold/general/visible,/obj/machinery/power/rad_collector/anchored,/obj/structure/window/plasma/reinforced{dir = 1},/turf/open/floor/engine,/area/prophunt/mg2/november)
"aW" = (/obj/machinery/atmospherics/pipe/simple/green/visible{dir = 4},/turf/closed/wall/r_wall,/area/prophunt/mg2/november)
"aX" = (/obj/machinery/atmospherics/pipe/simple/scrubbers/visible{dir = 4},/obj/effect/turf_decal/stripes/line{dir = 8},/turf/open/floor/plasteel,/area/prophunt/mg2/november)
"aY" = (/obj/machinery/atmospherics/components/binary/pump{dir = 8; name = "Gas to Filter"},/turf/open/floor/engine,/area/prophunt/mg2/november)
"aZ" = (/obj/machinery/atmospherics/components/unary/vent_scrubber/on,/turf/open/floor/engine,/area/prophunt/mg2/november)
"ba" = (/obj/structure/sign/warning/electricshock,/turf/closed/wall/r_wall,/area/prophunt/mg2/november)
"bb" = (/obj/machinery/atmospherics/pipe/simple/general/visible{dir = 9},/obj/machinery/power/rad_collector/anchored,/obj/structure/window/plasma/reinforced{dir = 1},/turf/open/floor/engine,/area/prophunt/mg2/november)
"bc" = (/obj/effect/turf_decal/stripes/line{dir = 5},/obj/machinery/atmospherics/components/trinary/filter/flipped/critical,/turf/open/floor/engine,/area/prophunt/mg2/november)
"bd" = (/obj/effect/turf_decal/stripes/line{dir = 4},/obj/machinery/atmospherics/components/trinary/filter/flipped/critical{dir = 1},/turf/open/floor/engine,/area/prophunt/mg2/november)
"be" = (/obj/effect/turf_decal/stripes/line{dir = 8},/obj/machinery/atmospherics/pipe/simple/cyan/visible{dir = 5},/turf/open/floor/engine,/area/prophunt/mg2/november)
"bf" = (/obj/effect/turf_decal/stripes/line{dir = 4},/obj/machinery/atmospherics/pipe/simple/green/visible,/turf/open/floor/engine,/area/prophunt/mg2/november)
"bg" = (/obj/effect/turf_decal/stripes/line{dir = 4},/obj/machinery/light{dir = 4},/obj/machinery/atmospherics/pipe/simple/scrubbers/visible,/turf/open/floor/engine,/area/prophunt/mg2/november)
"bh" = (/obj/machinery/atmospherics/components/unary/passive_vent{icon_state = "passive_vent_map-2"; dir = 4},/obj/structure/window/plasma/reinforced{dir = 4},/obj/structure/window/plasma/reinforced{dir = 8},/obj/structure/window/plasma/reinforced,/turf/open/floor/plasteel,/area/prophunt/mg2/november)
"bi" = (/obj/effect/turf_decal/delivery,/obj/machinery/atmospherics/pipe/manifold/scrubbers/visible{dir = 1},/turf/open/floor/plasteel/dark,/area/prophunt/mg2/november)
"bj" = (/obj/effect/turf_decal/bot{dir = 1},/obj/machinery/atmospherics/components/unary/portables_connector/visible{dir = 8},/obj/machinery/portable_atmospherics/canister,/turf/open/floor/plasteel/dark,/area/prophunt/mg2/november)
"bk" = (/obj/machinery/atmospherics/components/binary/valve/on,/obj/effect/turf_decal/stripes/line{dir = 4},/turf/open/floor/plasteel,/area/prophunt/mg2/november)
"bl" = (/obj/machinery/atmospherics/pipe/simple/general/visible{dir = 5},/turf/closed/wall/r_wall,/area/prophunt/mg2/november)
"bm" = (/obj/machinery/atmospherics/pipe/simple/general/visible{dir = 10},/obj/machinery/meter,/turf/closed/wall/r_wall,/area/prophunt/mg2/november)
"bn" = (/obj/effect/turf_decal/stripes/line{dir = 8},/turf/open/floor/engine,/area/prophunt/mg2/november)
"bo" = (/obj/effect/turf_decal/stripes/line{dir = 4},/obj/machinery/atmospherics/components/trinary/filter/flipped/critical{filter_type = "n2"},/turf/open/floor/engine,/area/prophunt/mg2/november)
"bp" = (/obj/effect/turf_decal/stripes/corner{dir = 4},/obj/machinery/atmospherics/pipe/simple/green/visible{dir = 5},/turf/open/floor/engine,/area/prophunt/mg2/november)
"bq" = (/obj/effect/turf_decal/delivery,/obj/machinery/atmospherics/pipe/simple/scrubbers/visible{dir = 5},/turf/open/floor/plasteel/dark,/area/prophunt/mg2/november)
"br" = (/obj/effect/turf_decal/stripes/line{dir = 1},/obj/machinery/atmospherics/pipe/simple/green/visible{dir = 4},/turf/open/floor/engine,/area/prophunt/mg2/november)
"bs" = (/obj/effect/turf_decal/stripes/line{dir = 1},/obj/machinery/light{dir = 1},/obj/machinery/atmospherics/pipe/manifold/green/visible{dir = 1},/turf/open/floor/engine,/area/prophunt/mg2/november)
"bt" = (/obj/effect/turf_decal/stripes/line{dir = 4},/obj/machinery/meter,/obj/machinery/atmospherics/pipe/simple/orange/visible,/turf/open/floor/engine,/area/prophunt/mg2/november)
"bu" = (/obj/effect/turf_decal/stripes/line{dir = 1},/obj/machinery/atmospherics/pipe/simple/green/visible{dir = 4},/obj/machinery/meter,/turf/open/floor/engine,/area/prophunt/mg2/november)
"bv" = (/obj/effect/turf_decal/stripes/corner{dir = 1},/obj/machinery/atmospherics/pipe/simple/orange/visible{dir = 4},/turf/open/floor/engine,/area/prophunt/mg2/november)
"bw" = (/obj/effect/turf_decal/stripes/line{dir = 4},/obj/machinery/atmospherics/pipe/manifold/orange/visible{dir = 4},/turf/open/floor/engine,/area/prophunt/mg2/november)
"bx" = (/obj/effect/turf_decal/stripes/corner{dir = 8},/turf/open/floor/plasteel,/area/prophunt/mg2/november)
"by" = (/obj/effect/turf_decal/stripes/line{dir = 4},/obj/machinery/atmospherics/pipe/manifold/green/visible{dir = 8},/turf/open/floor/engine,/area/prophunt/mg2/november)
"bz" = (/obj/effect/turf_decal/stripes/line{dir = 1},/obj/machinery/atmospherics/pipe/manifold/green/visible{dir = 1},/turf/open/floor/engine,/area/prophunt/mg2/november)
"bA" = (/obj/machinery/atmospherics/components/binary/pump{dir = 4; name = "Cooling Loop Bypass"},/obj/effect/turf_decal/stripes/line{dir = 1},/obj/machinery/light{dir = 1},/turf/open/floor/engine,/area/prophunt/mg2/november)
"bB" = (/obj/machinery/atmospherics/components/unary/thermomachine/freezer{dir = 1},/turf/open/floor/engine,/area/prophunt/mg2/november)
"bC" = (/obj/machinery/atmospherics/pipe/manifold/scrubbers/visible{dir = 4},/obj/machinery/meter,/obj/effect/turf_decal/stripes/line{dir = 4},/turf/open/floor/plasteel,/area/prophunt/mg2/november)
"bD" = (/obj/machinery/door/poddoor/shutters/preopen{id = "engsm"; name = "Radiation Chamber Shutters"},/obj/item/wrench,/turf/open/floor/plating,/area/prophunt/mg2/november)
"bE" = (/obj/machinery/atmospherics/pipe/simple/scrubbers/visible{dir = 9},/obj/effect/turf_decal/stripes/line{dir = 4},/turf/open/floor/plasteel,/area/prophunt/mg2/november)
"bF" = (/obj/structure/showcase{desc = "You quickly realize this supermatter crystal is a fake, but true to life metallic replica."; icon = 'icons/obj/supermatter.dmi'; icon_state = "darkmatter"; name = "supermatter crystal"},/turf/open/floor/engine,/area/prophunt/mg2/november)
"bG" = (/obj/machinery/atmospherics/components/unary/portables_connector/visible{dir = 1},/obj/machinery/portable_atmospherics/canister/nitrogen{filled = 0},/turf/open/floor/engine,/area/prophunt/mg2/november)
"bH" = (/obj/effect/turf_decal/stripes/line{dir = 9},/turf/open/floor/plasteel,/area/prophunt/mg2/november)
"bI" = (/obj/machinery/door/airlock/engineering/glass/critical{heat_proof = 1; name = "Supermatter Chamber"; req_access_txt = "0"},/obj/effect/mapping_helpers/airlock/cyclelink_helper{dir = 8},/turf/open/floor/engine,/area/prophunt/mg2/november)
"bJ" = (/obj/effect/turf_decal/stripes/corner{dir = 1},/turf/open/floor/plasteel,/area/prophunt/mg2/november)
"bK" = (/obj/effect/turf_decal/stripes/line{dir = 4},/turf/open/floor/plasteel,/area/prophunt/mg2/november)
"bL" = (/obj/machinery/atmospherics/components/unary/thermomachine/freezer{dir = 1},/obj/effect/turf_decal/stripes/corner{dir = 4},/turf/open/floor/engine,/area/prophunt/mg2/november)
"gA" = (/turf/open/floor/plasteel,/area/prophunt/mg2/november)

(1,1,1) = {"
bHaaakababadabababababafag
algAaRahaiaiacaiaiaiaeamay
algAaRanapaqarasasasaraoav
algAaRatapaqaDaKaKaKaDauay
aBbxbkawaDaDaAaxaxazaDaoaF
aPaXbCajaHaIaJaLaLaLaMaCaO
bhaXbEaGaQaKbIaKbFaKaEaNaT
bHbJbKbyaWaYbmaZaZaZbaaSbc
algAbKaUaDaDblaVaVbbaDaubg
algAbKbdbibjaDaKaKaKaDbebo
algAbKbfbqbjarasbDasarbnbt
algAbKbpbrbrbsbrbubzbAbvbw
bJgAbKaKaKaKbGaKaKbBaKaKbL
"}
