"aa" = (/obj/structure/girder/reinforced,/turf/open/floor/plating/airless,/area/prophunt/mg2/mike)
"ab" = (/turf/open/floor/fakespace,/area/prophunt/mg2/mike)
"ac" = (/obj/structure/fluff/broken_flooring{icon_state = "side"; dir = 8},/turf/open/floor/plating,/area/prophunt/mg2/mike)
"ad" = (/obj/structure/lattice,/turf/open/floor/fakespace,/area/prophunt/mg2/mike)
"ae" = (/obj/structure/disposalpipe/junction{dir = 1},/obj/item/shard,/turf/open/floor/plating/airless{icon_state = "platingdmg2"},/area/prophunt/mg2/mike)
"af" = (/turf/open/floor/plating/airless,/area/prophunt/mg2/mike)
"ag" = (/obj/item/stack/sheet/plasteel{amount = 10},/obj/structure/lattice,/turf/open/floor/fakespace,/area/prophunt/mg2/mike)
"ah" = (/obj/structure/lattice,/obj/item/shard{icon_state = "medium"},/turf/open/floor/fakespace,/area/prophunt/mg2/mike)
"ai" = (/obj/structure/disposalpipe/segment,/turf/open/floor/plasteel/airless{icon_state = "damaged5"},/area/prophunt/mg2/mike)
"aj" = (/obj/item/stack/tile/wood,/turf/open/floor/fakespace,/area/prophunt/mg2/mike)
"ak" = (/obj/structure/lattice,/obj/item/stack/cable_coil/cut,/turf/open/floor/fakespace,/area/prophunt/mg2/mike)
"al" = (/obj/structure/lattice,/obj/structure/disposalpipe/broken{dir = 8},/obj/structure/disposalpipe/broken{dir = 1},/turf/open/floor/fakespace,/area/prophunt/mg2/mike)
"am" = (/obj/structure/girder/reinforced,/turf/open/floor/fakespace,/area/prophunt/mg2/mike)
"an" = (/turf/open/floor/plating/airless{icon_state = "platingdmg2"},/area/prophunt/mg2/mike)
"ao" = (/obj/structure/lattice,/obj/structure/fluff/broken_flooring{icon_state = "plating"},/turf/open/floor/fakespace,/area/prophunt/mg2/mike)
"ap" = (/turf/open/floor/plasteel/airless{icon_state = "damaged3"},/area/prophunt/mg2/mike)
"aq" = (/turf/closed/wall/r_wall,/area/prophunt/mg2/mike)
"ar" = (/turf/open/floor/plasteel/airless{icon_state = "damaged5"},/area/prophunt/mg2/mike)
"as" = (/obj/structure/fluff/broken_flooring{icon_state = "singular"; dir = 8},/turf/open/floor/fakespace,/area/prophunt/mg2/mike)
"at" = (/obj/structure/grille/broken,/turf/open/floor/plating/airless{icon_state = "platingdmg1"},/area/prophunt/mg2/mike)
"au" = (/obj/structure/grille,/obj/item/shard,/turf/open/floor/plating/airless{icon_state = "platingdmg3"},/area/prophunt/mg2/mike)
"av" = (/obj/structure/closet/crate/secure,/turf/open/floor/plating/airless,/area/prophunt/mg2/mike)
"aw" = (/obj/item/shard{icon_state = "medium"},/obj/structure/lattice/catwalk,/turf/open/floor/fakespace,/area/prophunt/mg2/mike)
"ax" = (/obj/structure/closet/crate,/obj/effect/turf_decal/delivery,/obj/item/shard{icon_state = "small"},/obj/item/shard{icon_state = "small"},/obj/item/shard{icon_state = "small"},/obj/item/shard{icon_state = "medium"},/obj/item/shard,/turf/open/floor/plasteel,/area/prophunt/mg2/mike)
"ay" = (/obj/structure/lattice/catwalk,/turf/open/floor/fakespace,/area/prophunt/mg2/mike)
"az" = (/obj/structure/rack,/obj/item/clothing/gloves/color/fyellow/old,/turf/open/floor/plating/airless,/area/prophunt/mg2/mike)
"aA" = (/obj/structure/closet/crate,/obj/item/aicard,/obj/item/multitool,/obj/item/weldingtool,/obj/item/wrench,/turf/open/floor/plating/airless,/area/prophunt/mg2/mike)
"aB" = (/obj/structure/closet/crate,/obj/item/target/syndicate,/obj/item/target/clown,/obj/item/target/clown,/obj/item/target/alien,/obj/item/target,/obj/machinery/light{dir = 1},/obj/effect/turf_decal/delivery,/turf/open/floor/plasteel,/area/prophunt/mg2/mike)
"aC" = (/obj/item/shard{icon_state = "medium"},/turf/open/floor/plating/airless,/area/prophunt/mg2/mike)
"aD" = (/turf/open/floor/plating,/area/prophunt/mg2/mike)
"aE" = (/obj/item/stock_parts/cell,/turf/open/floor/plating/airless,/area/prophunt/mg2/mike)
"aF" = (/obj/effect/decal/cleanable/dirt,/turf/open/floor/plating/airless,/area/prophunt/mg2/mike)
"aG" = (/obj/effect/decal/cleanable/robot_debris/old,/turf/open/floor/plating/airless,/area/prophunt/mg2/mike)
"aI" = (/obj/effect/decal/cleanable/dirt,/obj/item/flashlight,/turf/open/floor/plating/airless,/area/prophunt/mg2/mike)
"aJ" = (/obj/effect/decal/cleanable/dirt,/obj/item/beacon,/turf/open/floor/plating/airless,/area/prophunt/mg2/mike)
"aK" = (/obj/machinery/portable_atmospherics/canister/air,/turf/open/floor/plating/airless,/area/prophunt/mg2/mike)
"aL" = (/obj/effect/decal/cleanable/blood/old,/turf/open/floor/plating/airless,/area/prophunt/mg2/mike)
"aM" = (/obj/effect/decal/cleanable/oil,/turf/open/floor/plating/airless,/area/prophunt/mg2/mike)
"aN" = (/obj/item/shard,/obj/item/electronics/apc,/turf/open/floor/plating/airless,/area/prophunt/mg2/mike)
"aO" = (/obj/structure/closet,/turf/open/floor/plating/airless,/area/prophunt/mg2/mike)
"aP" = (/obj/item/storage/toolbox/electrical{pixel_x = 1; pixel_y = -1},/turf/open/floor/plating/airless,/area/prophunt/mg2/mike)
"aQ" = (/obj/effect/decal/cleanable/blood/old{dir = 8; icon_state = "trails_1"; name = "dried blood trail"},/turf/open/floor/plating,/area/prophunt/mg2/mike)
"aR" = (/obj/structure/reagent_dispensers/fueltank,/turf/open/floor/plating/airless,/area/prophunt/mg2/mike)
"aS" = (/obj/structure/girder,/turf/open/floor/plating/airless,/area/prophunt/mg2/mike)
"aT" = (/obj/machinery/suit_storage_unit,/turf/open/floor/plasteel,/area/prophunt/mg2/mike)
"aU" = (/obj/machinery/light{dir = 1},/obj/machinery/suit_storage_unit,/turf/open/floor/plasteel,/area/prophunt/mg2/mike)
"aW" = (/obj/effect/turf_decal/delivery,/obj/structure/closet/crate/secure,/turf/open/floor/plasteel,/area/prophunt/mg2/mike)
"aX" = (/obj/structure/closet/crate{icon_state = "crateopen"},/obj/effect/turf_decal/delivery,/obj/item/pen,/obj/item/paper_bin,/turf/open/floor/plasteel,/area/prophunt/mg2/mike)
"aY" = (/obj/structure/extinguisher_cabinet{pixel_y = 32},/turf/open/floor/plasteel,/area/prophunt/mg2/mike)
"aZ" = (/obj/structure/closet/crate,/obj/item/storage/pill_bottle/stimulant,/obj/effect/turf_decal/delivery,/turf/open/floor/plasteel,/area/prophunt/mg2/mike)
"ba" = (/obj/effect/decal/cleanable/blood/old{dir = 5; icon_state = "trails_1"; name = "dried blood trail"},/turf/open/floor/plating{icon_state = "panelscorched"},/area/prophunt/mg2/mike)
"bb" = (/obj/structure/closet/crate/medical,/obj/item/storage/firstaid/regular{empty = 1; name = "First-Aid (empty)"},/obj/effect/turf_decal/delivery,/turf/open/floor/plasteel,/area/prophunt/mg2/mike)
"bc" = (/obj/structure/closet/crate/medical,/obj/item/storage/firstaid/regular{empty = 1; name = "First-Aid (empty)"},/obj/item/storage/firstaid/o2,/obj/effect/turf_decal/delivery,/turf/open/floor/plasteel,/area/prophunt/mg2/mike)
"bd" = (/obj/structure/closet/crate,/obj/item/stack/sheet/cloth/ten,/obj/item/stack/sheet/cloth/ten,/obj/effect/turf_decal/delivery,/turf/open/floor/plasteel,/area/prophunt/mg2/mike)
"be" = (/obj/structure/closet/crate{icon_state = "crateopen"},/obj/item/stack/sheet/cardboard/fifty,/obj/effect/turf_decal/delivery,/turf/open/floor/plasteel,/area/prophunt/mg2/mike)
"bf" = (/obj/structure/closet/crate{icon_state = "crateopen"},/obj/item/paicard,/obj/effect/turf_decal/delivery,/turf/open/floor/plasteel,/area/prophunt/mg2/mike)
"bg" = (/obj/structure/closet/crate/internals,/obj/item/storage/toolbox/emergency,/obj/item/clothing/mask/breath,/obj/effect/turf_decal/delivery,/turf/open/floor/plasteel,/area/prophunt/mg2/mike)
"bh" = (/obj/structure/closet/crate/engineering/electrical,/obj/item/storage/toolbox/electrical,/obj/item/stack/cable_coil,/obj/effect/turf_decal/delivery,/turf/open/floor/plasteel,/area/prophunt/mg2/mike)
"bi" = (/obj/structure/closet/crate{icon_state = "crateopen"},/obj/item/crowbar,/turf/open/floor/plasteel,/area/prophunt/mg2/mike)
"bj" = (/obj/structure/closet/crate/medical,/obj/item/storage/firstaid/regular,/obj/effect/turf_decal/delivery,/turf/open/floor/plasteel,/area/prophunt/mg2/mike)
"bk" = (/obj/structure/closet/crate/engineering,/obj/item/storage/toolbox/mechanical,/turf/open/floor/plasteel,/area/prophunt/mg2/mike)
"bl" = (/obj/structure/closet/crate/medical,/obj/item/storage/firstaid/brute,/obj/item/storage/firstaid/fire,/obj/effect/turf_decal/delivery,/turf/open/floor/plasteel,/area/prophunt/mg2/mike)
"bm" = (/obj/effect/decal/cleanable/blood/old{dir = 4; icon_state = "trails_1"; name = "dried blood trail"},/turf/open/floor/plasteel,/area/prophunt/mg2/mike)
"bn" = (/obj/effect/decal/cleanable/blood/old{dir = 8; icon_state = "trails_1"; name = "dried blood trail"},/turf/open/floor/plasteel,/area/prophunt/mg2/mike)
"bo" = (/obj/effect/decal/cleanable/blood/old{dir = 8; icon_state = "trails_1"; name = "dried blood trail"},/obj/effect/turf_decal/delivery,/turf/open/floor/plasteel,/area/prophunt/mg2/mike)
"bp" = (/obj/effect/decal/cleanable/blood/old{dir = 2; icon_state = "trails_1"; name = "dried blood trail"},/turf/open/floor/plating,/area/prophunt/mg2/mike)
"bq" = (/obj/structure/closet/crate,/obj/effect/turf_decal/delivery,/obj/item/lightreplacer,/turf/open/floor/plasteel,/area/prophunt/mg2/mike)
"br" = (/obj/item/light/tube/broken,/turf/open/floor/plating,/area/prophunt/mg2/mike)
"bs" = (/obj/structure/closet/crate,/obj/item/pda/clear,/obj/effect/turf_decal/delivery,/turf/open/floor/plasteel,/area/prophunt/mg2/mike)
"bt" = (/obj/effect/decal/cleanable/blood/old{dir = 10; icon_state = "trails_1"; name = "dried blood trail"},/turf/open/floor/plasteel,/area/prophunt/mg2/mike)
"bu" = (/obj/structure/closet/crate/internals,/obj/item/tank/internals/emergency_oxygen/engi,/obj/item/tank/internals/emergency_oxygen/engi,/obj/item/storage/firstaid/toxin,/obj/effect/turf_decal/delivery,/turf/open/floor/plasteel,/area/prophunt/mg2/mike)
"bv" = (/obj/structure/fluff/broken_flooring{icon_state = "pile"; dir = 4},/turf/open/floor/fakespace,/area/prophunt/mg2/mike)
"bw" = (/obj/machinery/light,/turf/open/floor/plasteel,/area/prophunt/mg2/mike)
"bx" = (/obj/structure/closet/crate/engineering,/obj/item/multitool,/obj/effect/turf_decal/delivery,/turf/open/floor/plasteel,/area/prophunt/mg2/mike)
"bz" = (/obj/structure/fluff/broken_flooring{icon_state = "singular"},/turf/open/floor/fakespace,/area/prophunt/mg2/mike)
"gA" = (/turf/open/floor/plasteel,/area/prophunt/mg2/mike)

(1,1,1) = {"
aTaUaxgAaWaWaXaYaZaDaBbbbc
bagAbdgAgAgAaDgAbegAgAgAgA
bpgAbgaDgAbhbigAbjgAbkblgA
btbnbnbnbnbobnaQbnbnbnbobm
bqbfbsgAgAbugAaWaWaWbwbxgA
aabradacadaoaeaqaqadaqaqaq
afagabadabahaiaCafafafazaq
abadajasabakalaEaFafaGaFav
abababadabakanaIaGaJafafaK
bzababajadakapaLafaMafaNaO
abadbvabaqararafafaFafaPaq
abamadanaaatauaqaAafaRaqaq
abababayawadayaqabadafaSaf
"}
